Date,Type,Details,Amount,Units / Contracts,Realized Equity Change,Realized Equity,Balance,Position ID,Asset type,NWA
01/07/2025 06:15:20,Open Position,NSDQ100/USD," 119,99 ",0.053022," 0,00 "," 1.889,49 "," 1.769,50 ",3055564089,CFD," 0,00 "
01/07/2025 08:09:07,Position closed,NSDQ100/USD," 119,28 ",0.053022,"(0,71)"," 1.888,78 "," 1.888,78 ",3055564089,CFD," 0,00 "
01/07/2025 08:09:46,Open Position,NSDQ100/USD," 119,99 ",0.053043," 0,00 "," 1.888,78 "," 1.768,79 ",3055659791,CFD," 0,00 "
01/07/2025 08:51:54,Open Position,VIX.JUL25/USD," 150,00 ",79.030558," 0,00 "," 1.888,78 "," 1.618,79 ",3055678832,CFD," 0,00 "
01/07/2025 08:53:04,Position closed,NSDQ100/USD," 120,47 ",0.053043," 0,48 "," 1.889,26 "," 1.739,26 ",3055659791,CFD," 0,00 "
01/07/2025 08:55:29,Open Position,NSDQ100/USD," 64,74 ",0.106026," 0,00 "," 1.889,26 "," 1.619,27 ",3055679902,CFD," 0,00 "
01/07/2025 10:55:17,Position closed,NSDQ100/USD," 58,03 ",0.052149,"(0,99)"," 1.888,27 "," 1.677,30 ",3055875853,CFD," 0,00 "
01/07/2025 12:27:16,Open Position,NSDQ100/USD," 119,98 ",0.106406," 0,00 "," 1.888,27 "," 1.557,32 ",3055902532,CFD," 0,00 "
01/07/2025 12:40:16,Position closed,NSDQ100/USD," 120,75 ",0.106406," 0,77 "," 1.889,04 "," 1.678,07 ",3055902532,CFD," 0,00 "
01/07/2025 13:35:19,Open Position,NSDQ100/USD," 119,99 ",0.106237," 0,00 "," 1.889,04 "," 1.558,08 ",3056075454,CFD," 0,00 "
01/07/2025 13:36:46,Position closed,NSDQ100/USD," 120,90 ",0.106237," 0,91 "," 1.889,95 "," 1.678,98 ",3056075454,CFD," 0,00 "
01/07/2025 13:37:16,Open Position,NSDQ100/USD," 101,98 ",0.090268," 0,00 "," 1.889,95 "," 1.577,00 ",3056083931,CFD," 0,00 "
01/07/2025 13:52:39,Position closed,NSDQ100/USD," 103,33 ",0.090268," 1,35 "," 1.891,30 "," 1.680,33 ",3056083931,CFD," 0,00 "
01/07/2025 13:54:03,Open Position,NSDQ100/USD," 70,04 ",0.106093," 0,00 "," 1.891,30 "," 1.560,34 ",3056388076,CFD," 0,00 "
01/07/2025 14:06:22,Open Position,NSDQ100/USD," 75,78 ",0.106183," 0,00 "," 1.891,30 "," 1.440,35 ",3056677856,CFD," 0,00 "
01/07/2025 14:51:33,Open Position,NSDQ100/USD," 119,99 ",0.106636," 0,00 "," 1.891,30 "," 1.320,36 ",3058003779,CFD," 0,00 "
01/07/2025 15:13:48,Edit Stop Loss,-,"(3,77)",-," 0,00 "," 1.891,30 "," 1.316,59 ",3055679902,-," 0,00 "
01/07/2025 15:14:04,Edit Stop Loss,-,"(5,85)",-," 0,00 "," 1.891,30 "," 1.310,74 ",3056388076,-," 0,00 "
01/07/2025 15:14:15,Edit Stop Loss,-,"(3,87)",-," 0,00 "," 1.891,30 "," 1.306,87 ",3056677856,-," 0,00 "
01/07/2025 15:15:41,Open Position,NSDQ100/USD," 99,99 ",0.089278," 0,00 "," 1.891,30 "," 1.206,88 ",3058503130,CFD," 0,00 "
01/07/2025 15:18:56,Position closed,NSDQ100/USD," 101,68 ",0.089278," 1,69 "," 1.892,99 "," 1.308,56 ",3058503130,CFD," 0,00 "
01/07/2025 15:19:24,Open Position,NSDQ100/USD," 104,98 ",0.093611," 0,00 "," 1.892,99 "," 1.203,58 ",3058520480,CFD," 0,00 "
01/07/2025 15:26:21,Position closed,NSDQ100/USD," 108,62 ",0.093611," 3,64 "," 1.896,63 "," 1.312,20 ",3058520480,CFD," 0,00 "
01/07/2025 17:08:04,Position closed,NSDQ100/USD," 121,97 ",0.106636," 1,98 "," 1.898,61 "," 1.434,17 ",3058003779,CFD," 0,00 "
01/07/2025 17:08:35,Open Position,NSDQ100/USD," 119,99 ",0.106546," 0,00 "," 1.898,61 "," 1.314,18 ",3058701013,CFD," 0,00 "
01/07/2025 17:23:56,Position closed,NSDQ100/USD," 120,26 ",0.106546," 0,27 "," 1.898,88 "," 1.434,44 ",3058701013,CFD," 0,00 "
01/07/2025 18:57:30,Position closed,NSDQ100/USD," 57,38 ",0.053877,"(7,36)"," 1.891,52 "," 1.491,82 ",3055679902,CFD," 0,00 "
01/07/2025 19:03:12,Open Position,NSDQ100/USD," 101,99 ",0.045436," 0,00 "," 1.891,52 "," 1.389,83 ",3058794805,CFD," 0,00 "
01/07/2025 19:03:44,Position closed,VIX.JUL25/USD," 130,24 ",79.030558,"(19,76)"," 1.871,76 "," 1.520,07 ",3055678832,CFD," 0,00 "
01/07/2025 19:07:21,Position closed,NSDQ100/USD," 102,71 ",0.045436," 0,72 "," 1.872,48 "," 1.622,78 ",3058794805,CFD," 0,00 "
01/07/2025 19:07:31,Open Position,NSDQ100/USD," 150,00 ",0.066764," 0,00 "," 1.872,48 "," 1.472,78 ",3058797369,CFD," 0,00 "
01/07/2025 19:20:57,Position closed,NSDQ100/USD," 151,49 ",0.066764," 1,49 "," 1.873,97 "," 1.624,27 ",3058797369,CFD," 0,00 "
01/07/2025 19:24:01,Open Position,NSDQ100/USD," 119,98 ",0.053323," 0,00 "," 1.873,97 "," 1.504,29 ",3058808466,CFD," 0,00 "
01/07/2025 19:31:58,Position closed,NSDQ100/USD," 119,41 ",0.053323,"(0,57)"," 1.873,40 "," 1.623,70 ",3058808466,CFD," 0,00 "
01/07/2025 19:51:04,Position closed,NSDQ100/USD," 54,49 ",0.05072,"(4,67)"," 1.868,73 "," 1.678,19 ",3058832283,CFD," 0,00 "
01/07/2025 22:23:11,Open Position,NSDQ100/USD," 129,99 ",0.057796," 0,00 "," 1.868,73 "," 1.548,20 ",3058853976,CFD," 0,00 "
01/07/2025 23:02:00,Position closed,NSDQ100/USD," 130,77 ",0.057796," 0,78 "," 1.869,51 "," 1.678,97 ",3058853976,CFD," 0,00 "
01/07/2025 23:04:13,Open Position,NSDQ100/USD," 199,99 ",0.088843," 0,00 "," 1.869,51 "," 1.478,98 ",3058855557,CFD," 0,00 "
01/07/2025 23:13:43,Overnight fee,Daily,"(0,30)",-,"(0,30)"," 1.869,21 "," 1.478,68 ",3056677856,CFD," 0,00 "
01/07/2025 23:13:43,Overnight fee,Daily,"(0,58)",-,"(0,58)"," 1.868,63 "," 1.478,10 ",3056388076,CFD," 0,00 "
02/07/2025 00:09:02,Index price adjustment,NSDQ100/USD," 0,17 ",-," 0,17 "," 1.868,80 "," 1.478,27 ",3056388076,CFD," 0,00 "
02/07/2025 00:09:02,Index price adjustment,NSDQ100/USD," 0,09 ",-," 0,09 "," 1.868,89 "," 1.478,36 ",3056677856,CFD," 0,00 "
02/07/2025 06:31:21,Position closed,NSDQ100/USD," 203,88 ",0.088843," 3,89 "," 1.872,78 "," 1.682,24 ",3058855557,CFD," 0,00 "
02/07/2025 07:18:15,Open Position,NSDQ100/USD," 66,87 ",0.106432," 0,00 "," 1.872,78 "," 1.562,25 ",3058961810,CFD," 0,00 "
02/07/2025 10:41:45,Open Position,NSDQ100/USD," 69,55 ",0.11561," 0,00 "," 1.872,78 "," 1.432,26 ",3059275103,CFD," 0,00 "
02/07/2025 12:57:52,Edit Stop Loss,-,"(14,69)",-," 0,00 "," 1.872,78 "," 1.417,57 ",3059275103,-," 0,00 "
02/07/2025 12:58:04,Edit Stop Loss,-,"(19,70)",-," 0,00 "," 1.872,78 "," 1.397,87 ",3058961810,-," 0,00 "
02/07/2025 12:58:19,Edit Stop Loss,-,"(11,08)",-," 0,00 "," 1.872,78 "," 1.386,79 ",3056677856,-," 0,00 "
02/07/2025 12:58:29,Edit Stop Loss,-,"(21,22)",-," 0,00 "," 1.872,78 "," 1.365,57 ",3056388076,-," 0,00 "
02/07/2025 12:59:37,Position closed,NSDQ100/USD," 70,02 ",0.060038,"(5,11)"," 1.867,67 "," 1.435,59 ",3059316676,CFD," 0,00 "
02/07/2025 12:59:47,Position closed,NSDQ100/USD," 64,78 ",0.05548,"(8,04)"," 1.859,63 "," 1.500,37 ",3059316697,CFD," 0,00 "
02/07/2025 13:00:34,Position closed,NSDQ100/USD," 65,15 ",0.055561,"(11,87)"," 1.847,76 "," 1.565,52 ",3059316902,CFD," 0,00 "
02/07/2025 13:36:24,Position closed,NSDQ100/USD," 68,73 ",0.055572,"(0,82)"," 1.846,94 "," 1.634,25 ",3059275103,CFD," 0,00 "
02/07/2025 13:49:04,Position closed,NSDQ100/USD," 65,02 ",0.050952,"(1,85)"," 1.845,09 "," 1.699,27 ",3058961810,CFD," 0,00 "
02/07/2025 14:41:24,Position closed,NSDQ100/USD," 75,80 ",0.055463," 0,02 "," 1.845,11 "," 1.775,07 ",3056677856,CFD," 0,00 "
02/07/2025 15:06:13,Position closed,NSDQ100/USD," 70,75 ",0.050532," 0,71 "," 1.845,82 "," 1.845,82 ",3056388076,CFD," 0,00 "
02/07/2025 15:06:41,Open Position,NSDQ100/USD," 101,98 ",0.090101," 0,00 "," 1.845,82 "," 1.743,84 ",3059957653,CFD," 0,00 "
02/07/2025 23:14:24,Overnight fee,Daily,"(0,49)",-,"(0,49)"," 1.845,33 "," 1.743,35 ",3059957653,CFD," 0,00 "
03/07/2025 00:06:26,Index price adjustment,NSDQ100/USD," 0,19 ",-," 0,19 "," 1.845,52 "," 1.743,54 ",3059957653,CFD," 0,00 "
03/07/2025 05:37:37,Position closed,NSDQ100/USD," 103,89 ",0.090101," 1,91 "," 1.847,43 "," 1.847,43 ",3059957653,CFD," 0,00 "
03/07/2025 05:38:38,Open Position,NSDQ100/USD," 119,99 ",0.052944," 0,00 "," 1.847,43 "," 1.727,44 ",3060294297,CFD," 0,00 "
03/07/2025 07:28:25,Position closed,NSDQ100/USD," 121,22 ",0.052944," 1,23 "," 1.848,66 "," 1.848,66 ",3060294297,CFD," 0,00 "
03/07/2025 11:44:15,Open Position,NSDQ100/USD," 119,99 ",0.105902," 0,00 "," 1.848,66 "," 1.728,67 ",3060552960,CFD," 0,00 "
03/07/2025 13:28:16,Position closed,NSDQ100/USD," 127,76 ",0.105902," 7,77 "," 1.856,43 "," 1.856,43 ",3060552960,CFD," 0,00 "
03/07/2025 13:46:46,Open Position,NSDQ100/USD," 69,99 ",0.061532," 0,00 "," 1.856,43 "," 1.786,44 ",3060831726,CFD," 0,00 "
03/07/2025 13:46:58,Position closed,NSDQ100/USD," 70,11 ",0.061532," 0,12 "," 1.856,55 "," 1.856,55 ",3060831726,CFD," 0,00 "
04/07/2025 09:54:22,Open Position,NSDQ100/USD," 101,99 ",0.044837," 0,00 "," 1.856,55 "," 1.754,56 ",3061574613,CFD," 0,00 "
04/07/2025 14:08:15,Position closed,NSDQ100/USD," 100,28 ",0.044837,"(1,71)"," 1.854,84 "," 1.854,84 ",3061574613,CFD," 0,00 "
04/07/2025 15:22:16,Open Position,NSDQ100/USD," 199,98 ",0.088044," 0,00 "," 1.854,84 "," 1.654,86 ",3061666047,CFD," 0,00 "
04/07/2025 16:19:24,Position closed,NSDQ100/USD," 200,12 ",0.088044," 0,14 "," 1.854,98 "," 1.854,98 ",3061666047,CFD," 0,00 "
06/07/2025 22:15:48,Open Position,NSDQ100/USD," 73,64 ",0.105236," 0,00 "," 1.854,98 "," 1.734,99 ",3061732659,CFD," 0,00 "
06/07/2025 23:13:50,Position closed,NSDQ100/USD," 57,91 ",0.05171,"(1,05)"," 1.853,93 "," 1.792,90 ",3061735947,CFD," 0,00 "
07/07/2025 08:44:27,Open Position,NSDQ100/USD," 119,99 ",0.105595," 0,00 "," 1.853,93 "," 1.672,91 ",3061927436,CFD," 0,00 "
07/07/2025 11:12:41,Position closed,NSDQ100/USD," 123,17 ",0.105595," 3,18 "," 1.857,11 "," 1.796,08 ",3061927436,CFD," 0,00 "
07/07/2025 11:13:02,Open Position,NSDQ100/USD," 128,70 ",0.096648," 0,00 "," 1.857,11 "," 1.686,09 ",3061970478,CFD," 0,00 "
07/07/2025 15:07:21,Open Position,NSDQ100/USD," 119,99 ",0.105668," 0,00 "," 1.857,11 "," 1.566,10 ",3064211717,CFD," 0,00 "
07/07/2025 16:05:23,Position closed,NSDQ100/USD," 124,03 ",0.105668," 4,04 "," 1.861,15 "," 1.690,13 ",3064211717,CFD," 0,00 "
07/07/2025 18:05:30,Open Position,NSDQ100/USD," 124,99 ",0.055107," 0,00 "," 1.861,15 "," 1.565,14 ",3064715593,CFD," 0,00 "
07/07/2025 18:05:37,Position closed,NSDQ100/USD," 124,43 ",0.055107,"(0,56)"," 1.860,59 "," 1.689,57 ",3064715593,CFD," 0,00 "
07/07/2025 18:05:53,Open Position,NSDQ100/USD," 124,99 ",0.110247," 0,00 "," 1.860,59 "," 1.564,58 ",3064715894,CFD," 0,00 "
07/07/2025 23:13:43,Overnight fee,Daily,"(0,29)",-,"(0,29)"," 1.860,30 "," 1.564,29 ",3061732659,CFD," 0,00 "
07/07/2025 23:13:43,Overnight fee,Daily,"(0,53)",-,"(0,53)"," 1.859,77 "," 1.563,76 ",3061970478,CFD," 0,00 "
07/07/2025 23:13:43,Overnight fee,Daily,"(0,61)",-,"(0,61)"," 1.859,16 "," 1.563,15 ",3064715894,CFD," 0,00 "
08/07/2025 01:08:16,Index price adjustment,NSDQ100/USD," 0,01 ",-," 0,01 "," 1.859,17 "," 1.563,16 ",3061732659,CFD," 0,00 "
08/07/2025 01:08:16,Index price adjustment,NSDQ100/USD," 0,01 ",-," 0,01 "," 1.859,18 "," 1.563,17 ",3061970478,CFD," 0,00 "
08/07/2025 01:08:16,Index price adjustment,NSDQ100/USD," 0,01 ",-," 0,01 "," 1.859,19 "," 1.563,18 ",3064715894,CFD," 0,00 "
08/07/2025 02:36:34,Position closed,NSDQ100/USD," 130,95 ",0.110247," 5,96 "," 1.865,15 "," 1.694,13 ",3064715894,CFD," 0,00 "
08/07/2025 04:58:38,Open Position,NSDQ100/USD," 119,99 ",0.10564," 0,00 "," 1.865,15 "," 1.574,14 ",3064933033,CFD," 0,00 "
08/07/2025 06:23:40,Position closed,NSDQ100/USD," 123,07 ",0.10564," 3,08 "," 1.868,23 "," 1.697,21 ",3064933033,CFD," 0,00 "
08/07/2025 06:26:26,Open Position,NSDQ100/USD," 119,99 ",0.105554," 0,00 "," 1.868,23 "," 1.577,22 ",3064939636,CFD," 0,00 "
08/07/2025 06:48:51,Position closed,NSDQ100/USD," 121,12 ",0.105554," 1,13 "," 1.869,36 "," 1.698,34 ",3064939636,CFD," 0,00 "
08/07/2025 06:49:00,Open Position,NSDQ100/USD," 124,99 ",0.109884," 0,00 "," 1.869,36 "," 1.573,35 ",3064942841,CFD," 0,00 "
08/07/2025 10:24:30,Open Position,NSDQ100/USD," 119,99 ",0.10558," 0,00 "," 1.869,36 "," 1.453,36 ",3065069921,CFD," 0,00 "
08/07/2025 10:31:18,Position closed,NSDQ100/USD," 119,77 ",0.10558,"(0,22)"," 1.869,14 "," 1.573,13 ",3065069921,CFD," 0,00 "
08/07/2025 12:19:17,Position closed,NSDQ100/USD," 125,39 ",0.109884," 0,40 "," 1.869,54 "," 1.698,52 ",3064942841,CFD," 0,00 "
08/07/2025 12:46:41,Open Position,NSDQ100/USD," 119,99 ",0.105557," 0,00 "," 1.869,54 "," 1.578,53 ",3065253123,CFD," 0,00 "
08/07/2025 13:22:43,Position closed,NSDQ100/USD," 120,93 ",0.105557," 0,94 "," 1.870,48 "," 1.699,46 ",3065253123,CFD," 0,00 "
08/07/2025 13:26:05,Open Position,NSDQ100/USD," 173,79 ",0.131872," 0,00 "," 1.870,48 "," 1.549,46 ",3065270199,CFD," 0,00 "
08/07/2025 13:40:16,Open Position,NSDQ100/USD," 170,00 ",0.149719," 0,00 "," 1.870,48 "," 1.379,46 ",3065401699,CFD," 0,00 "
08/07/2025 13:41:24,Position closed,NSDQ100/USD," 171,35 ",0.149719," 1,35 "," 1.871,83 "," 1.550,81 ",3065401699,CFD," 0,00 "
08/07/2025 13:41:33,Open Position,NSDQ100/USD," 119,98 ",0.105625," 0,00 "," 1.871,83 "," 1.430,83 ",3065406065,CFD," 0,00 "
08/07/2025 14:38:30,Position closed,NSDQ100/USD," 122,32 ",0.105625," 2,34 "," 1.874,17 "," 1.553,15 ",3065406065,CFD," 0,00 "
08/07/2025 17:02:38,Open Position,NSDQ100/USD," 129,99 ",0.11442," 0,00 "," 1.874,17 "," 1.423,16 ",3065890989,CFD," 0,00 "
08/07/2025 18:20:30,Position closed,NSDQ100/USD," 130,31 ",0.11442," 0,32 "," 1.874,49 "," 1.553,47 ",3065890989,CFD," 0,00 "
08/07/2025 18:48:08,Open Position,NSDQ100/USD," 76,77 ",0.132101," 0,00 "," 1.874,49 "," 1.403,47 ",3065963331,CFD," 0,00 "
08/07/2025 19:42:38,Position closed,NSDQ100/USD," 71,41 ",0.06449,"(1,82)"," 1.872,67 "," 1.474,88 ",3066085451,CFD," 0,00 "
08/07/2025 22:41:08,Position closed,NSDQ100/USD," 76,90 ",0.067611," 0,13 "," 1.872,80 "," 1.551,78 ",3065963331,CFD," 0,00 "
08/07/2025 23:08:44,Edit Stop Loss,-,"(23,79)",-," 0,00 "," 1.872,80 "," 1.527,99 ",3065270199,-," 0,00 "
08/07/2025 23:08:56,Edit Stop Loss,-,"(18,71)",-," 0,00 "," 1.872,80 "," 1.509,28 ",3061970478,-," 0,00 "
08/07/2025 23:09:08,Edit Stop Loss,-,"(12,61)",-," 0,00 "," 1.872,80 "," 1.496,67 ",3061732659,-," 0,00 "
08/07/2025 23:13:31,Overnight fee,Daily,"(0,29)",-,"(0,29)"," 1.872,51 "," 1.496,38 ",3061732659,CFD," 0,00 "
08/07/2025 23:13:31,Overnight fee,Daily,"(0,37)",-,"(0,37)"," 1.872,14 "," 1.496,01 ",3065963331,CFD," 0,00 "
08/07/2025 23:13:31,Overnight fee,Daily,"(0,53)",-,"(0,53)"," 1.871,61 "," 1.495,48 ",3061970478,CFD," 0,00 "
08/07/2025 23:13:31,Overnight fee,Daily,"(0,72)",-,"(0,72)"," 1.870,89 "," 1.494,76 ",3065270199,CFD," 0,00 "
09/07/2025 00:19:25,Open Position,NSDQ100/USD," 150,00 ",0.132226," 0,00 "," 1.870,89 "," 1.344,76 ",3066152222,CFD," 0,00 "
09/07/2025 07:56:41,Position closed,NSDQ100/USD," 151,73 ",0.132226," 1,73 "," 1.872,62 "," 1.496,49 ",3066152222,CFD," 0,00 "
09/07/2025 10:14:11,Open Position,NSDQ100/USD," 101,99 ",0.089771," 0,00 "," 1.872,62 "," 1.394,50 ",3066295383,CFD," 0,00 "
09/07/2025 11:48:49,Position closed,NSDQ100/USD," 104,16 ",0.089771," 2,17 "," 1.874,79 "," 1.498,66 ",3066295383,CFD," 0,00 "
09/07/2025 11:49:40,Position closed,NSDQ100/USD," 174,26 ",0.131872," 0,47 "," 1.875,26 "," 1.672,92 ",3065270199,CFD," 0,00 "
09/07/2025 13:30:21,Position closed,NSDQ100/USD," 132,18 ",0.096648," 3,48 "," 1.878,74 "," 1.805,10 ",3061970478,CFD," 0,00 "
09/07/2025 13:39:04,Position closed,NSDQ100/USD," 76,06 ",0.053526," 2,42 "," 1.881,16 "," 1.881,16 ",3061732659,CFD," 0,00 "
09/07/2025 16:06:48,Open Position,NSDQ100/USD," 199,98 ",0.175651," 0,00 "," 1.881,16 "," 1.681,18 ",3067522389,CFD," 0,00 "
09/07/2025 16:39:17,Position closed,NSDQ100/USD," 201,89 ",0.175651," 1,91 "," 1.883,07 "," 1.883,07 ",3067522389,CFD," 0,00 "
09/07/2025 16:39:42,Open Position,NSDQ100/USD," 119,99 ",0.105338," 0,00 "," 1.883,07 "," 1.763,08 ",3067549907,CFD," 0,00 "
09/07/2025 17:19:12,Position closed,NSDQ100/USD," 120,75 ",0.105338," 0,76 "," 1.883,83 "," 1.883,83 ",3067549907,CFD," 0,00 "
09/07/2025 20:02:03,Open Position,NSDQ100/USD," 74,99 ",0.065633," 0,00 "," 1.883,83 "," 1.808,84 ",3067705930,CFD," 0,00 "
09/07/2025 22:09:53,Position closed,NSDQ100/USD," 75,20 ",0.065633," 0,21 "," 1.884,04 "," 1.884,04 ",3067705930,CFD," 0,00 "
09/07/2025 22:23:32,Open Position,NSDQ100/USD," 64,34 ",0.088318," 0,00 "," 1.884,04 "," 1.783,05 ",3067717299,CFD," 0,00 "
09/07/2025 23:05:16,Position closed,NSDQ100/USD," 49,61 ",0.043768,"(0,44)"," 1.883,60 "," 1.832,66 ",3067720258,CFD," 0,00 "
09/07/2025 23:15:22,Overnight fee,Daily,"(0,36)",-,"(0,36)"," 1.883,24 "," 1.832,30 ",3067705930,CFD," 0,00 "
10/07/2025 06:59:41,Open Position,NSDQ100/USD," 119,99 ",0.105234," 0,00 "," 1.883,24 "," 1.712,31 ",3067758282,CFD," 0,00 "
10/07/2025 07:45:19,Position closed,NSDQ100/USD," 121,75 ",0.105234," 1,76 "," 1.885,00 "," 1.834,06 ",3067758282,CFD," 0,00 "
10/07/2025 13:49:16,Open Position,NSDQ100/USD," 140,00 ",0.122738," 0,00 "," 1.885,00 "," 1.694,06 ",3068981736,CFD," 0,00 "
10/07/2025 14:51:33,Open Position,NSDQ100/USD," 101,99 ",0.08948," 0,00 "," 1.885,00 "," 1.592,07 ",3069345920,CFD," 0,00 "
10/07/2025 17:05:56,Position closed,NSDQ100/USD," 103,79 ",0.08948," 1,80 "," 1.886,80 "," 1.695,86 ",3069345920,CFD," 0,00 "
10/07/2025 17:06:14,Open Position,NSDQ100/USD," 100,99 ",0.088513," 0,00 "," 1.886,80 "," 1.594,87 ",3069473302,CFD," 0,00 "
10/07/2025 17:37:20,Position closed,NSDQ100/USD," 142,28 ",0.122738," 2,28 "," 1.889,08 "," 1.737,15 ",3068981736,CFD," 0,00 "
10/07/2025 17:59:36,Position closed,NSDQ100/USD," 103,51 ",0.088513," 2,52 "," 1.891,60 "," 1.840,66 ",3069473302,CFD," 0,00 "
10/07/2025 19:06:23,Open Position,NSDQ100/USD," 100,99 ",0.088408," 0,00 "," 1.891,60 "," 1.739,67 ",3069614365,CFD," 0,00 "
10/07/2025 22:28:34,Position closed,NSDQ100/USD," 101,07 ",0.088408," 0,08 "," 1.891,68 "," 1.840,74 ",3069614365,CFD," 0,00 "
10/07/2025 22:30:51,Open Position,NSDQ100/USD," 126,78 ",0.089282," 0,00 "," 1.891,68 "," 1.738,75 ",3069684575,CFD," 0,00 "
10/07/2025 23:13:44,Overnight fee,Daily,"(0,24)",-,"(0,24)"," 1.891,44 "," 1.738,51 ",3067717299,CFD," 0,00 "
10/07/2025 23:13:44,Overnight fee,Daily,"(0,49)",-,"(0,49)"," 1.890,95 "," 1.738,02 ",3069614365,CFD," 0,00 "
11/07/2025 08:56:39,Open Position,NSDQ100/USD," 148,06 ",0.114405," 0,00 "," 1.890,95 "," 1.608,03 ",3069866408,CFD," 0,00 "
11/07/2025 10:00:10,Open Position,NSDQ100/USD," 165,47 ",0.132242," 0,00 "," 1.890,95 "," 1.458,04 ",3069886452,CFD," 0,00 "
11/07/2025 10:00:57,Edit Stop Loss,-,"(13,40)",-," 0,00 "," 1.890,95 "," 1.444,64 ",3067717299,-," 0,00 "
11/07/2025 10:01:09,Edit Stop Loss,-,"(24,79)",-," 0,00 "," 1.890,95 "," 1.419,85 ",3069684575,-," 0,00 "
11/07/2025 10:01:20,Edit Stop Loss,-,"(18,07)",-," 0,00 "," 1.890,95 "," 1.401,78 ",3069866408,-," 0,00 "
11/07/2025 10:01:34,Edit Stop Loss,-,"(15,48)",-," 0,00 "," 1.890,95 "," 1.386,30 ",3069886452,-," 0,00 "
11/07/2025 10:08:34,Position closed,NSDQ100/USD," 167,11 ",0.132242," 1,64 "," 1.892,59 "," 1.553,41 ",3069886452,CFD," 0,00 "
11/07/2025 11:59:32,Position closed,NSDQ100/USD," 148,18 ",0.114405," 0,12 "," 1.892,71 "," 1.701,59 ",3069866408,CFD," 0,00 "
11/07/2025 12:19:07,Open Position,NSDQ100/USD," 119,99 ",0.105578," 0,00 "," 1.892,71 "," 1.581,60 ",3069949350,CFD," 0,00 "
11/07/2025 13:50:56,Position closed,NSDQ100/USD," 123,35 ",0.105578," 3,36 "," 1.896,07 "," 1.704,95 ",3069949350,CFD," 0,00 "
11/07/2025 17:15:01,Position closed,NSDQ100/USD," 124,69 ",0.089282,"(2,09)"," 1.893,98 "," 1.829,64 ",3069684575,CFD," 0,00 "
11/07/2025 19:14:57,Open Position,NSDQ100/USD," 143,80 ",0.105281," 0,00 "," 1.893,98 "," 1.709,65 ",3070694600,CFD," 0,00 "
11/07/2025 19:15:13,Edit Stop Loss,-,"(23,81)",-," 0,00 "," 1.893,98 "," 1.685,84 ",3070694600,-," 0,00 "
11/07/2025 19:27:36,Position closed,NSDQ100/USD," 145,11 ",0.105281," 1,31 "," 1.895,29 "," 1.830,95 ",3070694600,CFD," 0,00 "
11/07/2025 23:13:48,Overnight fee,Weekend Fee,"(0,73)",-,"(0,73)"," 1.894,56 "," 1.830,22 ",3067717299,CFD," 0,00 "
12/07/2025 01:02:51,Index price adjustment,NSDQ100/USD," 0,01 ",-," 0,01 "," 1.894,57 "," 1.830,23 ",3069614365,CFD," 0,00 "
13/07/2025 23:25:57,Open Position,NSDQ100/USD," 199,99 ",0.176378," 0,00 "," 1.894,57 "," 1.630,24 ",3071115405,CFD," 0,00 "
14/07/2025 04:21:20,Position closed,NSDQ100/USD," 203,57 ",0.176378," 3,58 "," 1.898,15 "," 1.833,81 ",3071115405,CFD," 0,00 "
14/07/2025 04:22:10,Open Position,NSDQ100/USD," 199,99 ",0.176194," 0,00 "," 1.898,15 "," 1.633,82 ",3071161869,CFD," 0,00 "
14/07/2025 07:08:10,Open Position,NSDQ100/USD," 119,99 ",0.10593," 0,00 "," 1.898,15 "," 1.513,83 ",3071258096,CFD," 0,00 "
14/07/2025 07:34:55,Position closed,NSDQ100/USD," 120,33 ",0.10593," 0,34 "," 1.898,49 "," 1.634,16 ",3071258096,CFD," 0,00 "
14/07/2025 07:37:21,Open Position,NSDQ100/USD," 119,99 ",0.10589," 0,00 "," 1.898,49 "," 1.514,17 ",3071332183,CFD," 0,00 "
14/07/2025 07:46:02,Position closed,NSDQ100/USD," 121,27 ",0.10589," 1,28 "," 1.899,77 "," 1.635,44 ",3071332183,CFD," 0,00 "
14/07/2025 07:46:37,Open Position,NSDQ100/USD," 150,00 ",0.13227," 0,00 "," 1.899,77 "," 1.485,44 ",3071336515,CFD," 0,00 "
14/07/2025 08:09:57,Position closed,NSDQ100/USD," 151,67 ",0.13227," 1,67 "," 1.901,44 "," 1.637,11 ",3071336515,CFD," 0,00 "
14/07/2025 08:10:29,Open Position,NSDQ100/USD," 140,00 ",0.123364," 0,00 "," 1.901,44 "," 1.497,11 ",3071347166,CFD," 0,00 "
14/07/2025 09:16:26,Position closed,NSDQ100/USD," 141,04 ",0.123364," 1,04 "," 1.902,48 "," 1.638,15 ",3071347166,CFD," 0,00 "
14/07/2025 09:21:19,Position closed,NSDQ100/USD," 201,56 ",0.176194," 1,57 "," 1.904,05 "," 1.839,71 ",3071161869,CFD," 0,00 "
14/07/2025 09:21:37,Open Position,NSDQ100/USD," 150,00 ",0.132094," 0,00 "," 1.904,05 "," 1.689,71 ",3071370190,CFD," 0,00 "
14/07/2025 10:00:23,Position closed,NSDQ100/USD," 151,19 ",0.132094," 1,19 "," 1.905,24 "," 1.840,90 ",3071370190,CFD," 0,00 "
14/07/2025 10:01:09,Open Position,NSDQ100/USD," 50,00 ",0.044004," 0,00 "," 1.905,24 "," 1.790,90 ",3071384489,CFD," 0,00 "
14/07/2025 12:26:24,Position closed,NSDQ100/USD," 50,19 ",0.044004," 0,19 "," 1.905,43 "," 1.841,09 ",3071384489,CFD," 0,00 "
14/07/2025 12:27:22,Open Position,NSDQ100/USD," 60,75 ",0.105582," 0,00 "," 1.905,43 "," 1.721,10 ",3071435223,CFD," 0,00 "
14/07/2025 12:35:19,Position closed,NSDQ100/USD," 58,48 ",0.052123,"(0,76)"," 1.904,67 "," 1.779,58 ",3071438098,CFD," 0,00 "
14/07/2025 13:27:35,Position closed,NSDQ100/USD," 61,84 ",0.053459," 1,09 "," 1.905,76 "," 1.841,42 ",3071435223,CFD," 0,00 "
14/07/2025 13:30:31,Open Position,NSDQ100/USD," 101,99 ",0.089607," 0,00 "," 1.905,76 "," 1.739,43 ",3071482652,CFD," 0,00 "
14/07/2025 13:31:31,Position closed,NSDQ100/USD," 102,53 ",0.089607," 0,54 "," 1.906,30 "," 1.841,96 ",3071482652,CFD," 0,00 "
14/07/2025 13:32:58,Open Position,NSDQ100/USD," 129,98 ",0.114155," 0,00 "," 1.906,30 "," 1.711,98 ",3071623567,CFD," 0,00 "
14/07/2025 14:13:17,Open Position,NSDQ100/USD," 101,99 ",0.089653," 0,00 "," 1.906,30 "," 1.609,99 ",3072110960,CFD," 0,00 "
14/07/2025 14:13:32,Position closed,NSDQ100/USD," 102,69 ",0.089653," 0,70 "," 1.907,00 "," 1.712,68 ",3072110960,CFD," 0,00 "
14/07/2025 14:45:58,Position closed,NSDQ100/USD," 131,74 ",0.114155," 1,76 "," 1.908,76 "," 1.844,42 ",3071623567,CFD," 0,00 "
14/07/2025 14:47:12,Open Position,NSDQ100/USD," 101,98 ",0.089487," 0,00 "," 1.908,76 "," 1.742,44 ",3072240849,CFD," 0,00 "
14/07/2025 14:54:23,Position closed,NSDQ100/USD," 102,26 ",0.089487," 0,28 "," 1.909,04 "," 1.844,70 ",3072240849,CFD," 0,00 "
14/07/2025 16:12:52,Position closed,NSDQ100/USD," 63,06 ",0.04455,"(1,28)"," 1.907,76 "," 1.907,76 ",3067717299,CFD," 0,00 "
14/07/2025 17:04:02,Open Position,NSDQ100/USD," 119,99 ",0.104969," 0,00 "," 1.907,76 "," 1.787,77 ",3072567517,CFD," 0,00 "
14/07/2025 17:13:18,Position closed,NSDQ100/USD," 120,50 ",0.104969," 0,51 "," 1.908,27 "," 1.908,27 ",3072567517,CFD," 0,00 "
14/07/2025 22:45:57,Open Position,NSDQ100/USD," 119,99 ",0.105123," 0,00 "," 1.908,27 "," 1.788,28 ",3072727546,CFD," 0,00 "
15/07/2025 04:39:33,Position closed,NSDQ100/USD," 131,39 ",0.105123," 11,40 "," 1.919,67 "," 1.919,67 ",3072727546,CFD," 0,00 "
15/07/2025 06:10:59,Open Position,NSDQ100/USD," 149,99 ",0.130631," 0,00 "," 1.919,67 "," 1.769,68 ",3072773201,CFD," 0,00 "
15/07/2025 09:38:45,Open Position,NSDQ100/USD," 149,99 ",0.130431," 0,00 "," 1.919,67 "," 1.619,69 ",3072964092,CFD," 0,00 "
15/07/2025 09:49:04,Position closed,NSDQ100/USD," 150,74 ",0.130431," 0,75 "," 1.920,42 "," 1.770,43 ",3072964092,CFD," 0,00 "
15/07/2025 09:49:16,Open Position,NSDQ100/USD," 51,41 ",0.088728," 0,00 "," 1.920,42 "," 1.668,43 ",3072967387,CFD," 0,00 "
15/07/2025 10:46:56,Position closed,NSDQ100/USD," 50,32 ",0.044008,"(0,27)"," 1.920,15 "," 1.718,75 ",3072981704,CFD," 0,00 "
15/07/2025 11:45:28,Position closed,NSDQ100/USD," 51,31 ",0.04472,"(0,10)"," 1.920,05 "," 1.770,06 ",3072967387,CFD," 0,00 "
15/07/2025 12:22:55,Position closed,NSDQ100/USD," 150,24 ",0.130631," 0,25 "," 1.920,30 "," 1.920,30 ",3072773201,CFD," 0,00 "
15/07/2025 12:30:23,Open Position,NSDQ100/USD," 120,00 ",0.104295," 0,00 "," 1.920,30 "," 1.800,30 ",3073012261,CFD," 0,00 "
15/07/2025 12:42:20,Position closed,NSDQ100/USD," 121,10 ",0.104295," 1,10 "," 1.921,40 "," 1.921,40 ",3073012261,CFD," 0,00 "
15/07/2025 12:44:03,Open Position,NSDQ100/USD," 129,99 ",0.113073," 0,00 "," 1.921,40 "," 1.791,41 ",3073018557,CFD," 0,00 "
15/07/2025 13:39:56,Position closed,NSDQ100/USD," 131,19 ",0.113073," 1,20 "," 1.922,60 "," 1.922,60 ",3073018557,CFD," 0,00 "
15/07/2025 13:52:42,Open Position,NSDQ100/USD," 130,00 ",0.113135," 0,00 "," 1.922,60 "," 1.792,60 ",3073409856,CFD," 0,00 "
15/07/2025 14:02:30,Position closed,NSDQ100/USD," 132,18 ",0.113135," 2,18 "," 1.924,78 "," 1.924,78 ",3073409856,CFD," 0,00 "
15/07/2025 14:05:16,Open Position,NSDQ100/USD," 101,98 ",0.088799," 0,00 "," 1.924,78 "," 1.822,80 ",3073445713,CFD," 0,00 "
15/07/2025 14:05:34,Position closed,NSDQ100/USD," 102,14 ",0.088799," 0,16 "," 1.924,94 "," 1.924,94 ",3073445713,CFD," 0,00 "
15/07/2025 15:20:02,Open Position,NSDQ100/USD," 101,99 ",0.08883," 0,00 "," 1.924,94 "," 1.822,95 ",3073612547,CFD," 0,00 "
15/07/2025 15:28:52,Position closed,NSDQ100/USD," 103,92 ",0.08883," 1,93 "," 1.926,87 "," 1.926,87 ",3073612547,CFD," 0,00 "
15/07/2025 16:58:14,Open Position,NSDQ100/USD," 119,99 ",0.104706," 0,00 "," 1.926,87 "," 1.806,88 ",3073723048,CFD," 0,00 "
15/07/2025 18:30:05,Position closed,NSDQ100/USD," 127,17 ",0.104706," 7,18 "," 1.934,05 "," 1.934,05 ",3073723048,CFD," 0,00 "
15/07/2025 18:59:27,Open Position,NSDQ100/USD," 101,99 ",0.088962," 0,00 "," 1.934,05 "," 1.832,06 ",3073885794,CFD," 0,00 "
15/07/2025 19:06:00,Position closed,NSDQ100/USD," 101,78 ",0.088962,"(0,21)"," 1.933,84 "," 1.933,84 ",3073885794,CFD," 0,00 "
15/07/2025 19:50:46,Open Position,SPX500/USD," 79,88 ",0.479642," 0,00 "," 1.933,84 "," 1.783,84 ",3073939807,CFD," 0,00 "
15/07/2025 20:57:56,Position closed,SPX500/USD," 65,29 ",0.224217,"(4,83)"," 1.929,01 "," 1.849,13 ",3073955566,CFD," 0,00 "
15/07/2025 20:58:30,Open Position,NSDQ100/USD," 129,98 ",0.113802," 0,00 "," 1.929,01 "," 1.719,15 ",3073955597,CFD," 0,00 "
15/07/2025 23:13:36,Overnight fee,Daily,"(0,39)",-,"(0,39)"," 1.928,62 "," 1.718,76 ",3073939807,CFD," 0,00 "
15/07/2025 23:13:36,Overnight fee,Daily,"(0,63)",-,"(0,63)"," 1.927,99 "," 1.718,13 ",3073955597,CFD," 0,00 "
16/07/2025 04:33:18,Position closed,NSDQ100/USD," 131,08 ",0.113802," 1,10 "," 1.929,09 "," 1.849,21 ",3073955597,CFD," 0,00 "
16/07/2025 05:12:33,Open Position,NSDQ100/USD," 119,99 ",0.105047," 0,00 "," 1.929,09 "," 1.729,22 ",3073990873,CFD," 0,00 "
16/07/2025 07:35:08,Open Position,NSDQ100/USD," 129,99 ",0.113956," 0,00 "," 1.929,09 "," 1.599,23 ",3074084413,CFD," 0,00 "
16/07/2025 10:39:00,Position closed,NSDQ100/USD," 132,05 ",0.113956," 2,06 "," 1.931,15 "," 1.731,28 ",3074084413,CFD," 0,00 "
16/07/2025 10:39:26,Open Position,NSDQ100/USD," 119,99 ",0.105088," 0,00 "," 1.931,15 "," 1.611,29 ",3074144266,CFD," 0,00 "
16/07/2025 11:51:08,Position closed,NSDQ100/USD," 120,40 ",0.105088," 0,41 "," 1.931,56 "," 1.731,69 ",3074144266,CFD," 0,00 "
16/07/2025 11:51:17,Position closed,NSDQ100/USD," 119,11 ",0.105047,"(0,88)"," 1.930,68 "," 1.850,80 ",3073990873,CFD," 0,00 "
16/07/2025 12:03:16,Open Position,NSDQ100/USD," 119,99 ",0.105065," 0,00 "," 1.930,68 "," 1.730,81 ",3074164598,CFD," 0,00 "
16/07/2025 12:21:09,Position closed,NSDQ100/USD," 121,57 ",0.105065," 1,58 "," 1.932,26 "," 1.852,38 ",3074164598,CFD," 0,00 "
16/07/2025 12:37:23,Position closed,SPX500/USD," 80,38 ",0.255425," 0,50 "," 1.932,76 "," 1.932,76 ",3073939807,CFD," 0,00 "
16/07/2025 13:50:37,Open Position,NSDQ100/USD," 75,97 ",0.131486," 0,00 "," 1.932,76 "," 1.782,76 ",3074340361,CFD," 0,00 "
16/07/2025 13:51:48,Position closed,NSDQ100/USD," 73,09 ",0.064893,"(0,94)"," 1.931,82 "," 1.855,85 ",3074391933,CFD," 0,00 "
16/07/2025 13:52:57,Open Position,NSDQ100/USD," 150,00 ",0.131481," 0,00 "," 1.931,82 "," 1.705,85 ",3074453243,CFD," 0,00 "
16/07/2025 14:21:09,Position closed,NSDQ100/USD," 76,14 ",0.066593," 0,17 "," 1.931,99 "," 1.781,99 ",3074340361,CFD," 0,00 "
16/07/2025 14:31:39,Position closed,NSDQ100/USD," 153,82 ",0.131481," 3,82 "," 1.935,81 "," 1.935,81 ",3074453243,CFD," 0,00 "
16/07/2025 14:32:01,Open Position,NSDQ100/USD," 119,98 ",0.105035," 0,00 "," 1.935,81 "," 1.815,83 ",3074562064,CFD," 0,00 "
16/07/2025 15:21:24,Open Position,NSDQ100/USD," 170,00 ",0.149347," 0,00 "," 1.935,81 "," 1.645,83 ",3074683658,CFD," 0,00 "
16/07/2025 16:12:24,Position closed,NSDQ100/USD," 177,22 ",0.149347," 7,22 "," 1.943,03 "," 1.823,05 ",3074683658,CFD," 0,00 "
16/07/2025 16:12:47,Open Position,NSDQ100/USD," 101,99 ",0.089452," 0,00 "," 1.943,03 "," 1.721,06 ",3074775309,CFD," 0,00 "
16/07/2025 16:18:15,Position closed,NSDQ100/USD," 103,33 ",0.089452," 1,34 "," 1.944,37 "," 1.824,39 ",3074775309,CFD," 0,00 "
16/07/2025 16:31:57,Open Position,NSDQ100/USD," 119,99 ",0.105201," 0,00 "," 1.944,37 "," 1.704,40 ",3074793083,CFD," 0,00 "
16/07/2025 17:38:51,Position closed,NSDQ100/USD," 125,95 ",0.105201," 5,96 "," 1.950,33 "," 1.830,35 ",3074793083,CFD," 0,00 "
16/07/2025 17:38:59,Position closed,NSDQ100/USD," 122,28 ",0.105035," 2,30 "," 1.952,63 "," 1.952,63 ",3074562064,CFD," 0,00 "
16/07/2025 17:39:43,Open Position,NSDQ100/USD," 149,99 ",0.13118," 0,00 "," 1.952,63 "," 1.802,64 ",3074851177,CFD," 0,00 "
16/07/2025 19:48:40,Position closed,NSDQ100/USD," 156,78 ",0.13118," 6,79 "," 1.959,42 "," 1.959,42 ",3074851177,CFD," 0,00 "
16/07/2025 20:08:08,Open Position,NSDQ100/USD," 101,99 ",0.089113," 0,00 "," 1.959,42 "," 1.857,43 ",3075000309,CFD," 0,00 "
16/07/2025 20:26:56,Position closed,NSDQ100/USD," 101,56 ",0.089113,"(0,43)"," 1.958,99 "," 1.958,99 ",3075000309,CFD," 0,00 "
16/07/2025 22:56:13,Open Position,NSDQ100/USD," 80,41 ",0.139922," 0,00 "," 1.958,99 "," 1.798,99 ",3075021532,CFD," 0,00 "
16/07/2025 23:33:56,Position closed,NSDQ100/USD," 79,18 ",0.069602,"(0,41)"," 1.958,58 "," 1.878,17 ",3075023184,CFD," 0,00 "
17/07/2025 05:28:40,Position closed,NSDQ100/USD," 81,57 ",0.07032," 1,16 "," 1.959,74 "," 1.959,74 ",3075021532,CFD," 0,00 "
17/07/2025 06:05:25,Open Position,NSDQ100/USD," 119,98 ",0.104637," 0,00 "," 1.959,74 "," 1.839,76 ",3075059743,CFD," 0,00 "
17/07/2025 06:06:51,Position closed,NSDQ100/USD," 121,40 ",0.104637," 1,42 "," 1.961,16 "," 1.961,16 ",3075059743,CFD," 0,00 "
17/07/2025 06:27:18,Open Position,NSDQ100/USD," 169,99 ",0.148009," 0,00 "," 1.961,16 "," 1.791,17 ",3075063727,CFD," 0,00 "
17/07/2025 06:43:17,Position closed,NSDQ100/USD," 171,36 ",0.148009," 1,37 "," 1.962,53 "," 1.962,53 ",3075063727,CFD," 0,00 "
17/07/2025 07:33:36,Open Position,NSDQ100/USD," 100,47 ",0.174208," 0,00 "," 1.962,53 "," 1.762,54 ",3075144495,CFD," 0,00 "
17/07/2025 07:34:13,Position closed,NSDQ100/USD," 99,02 ",0.086694,"(0,50)"," 1.962,03 "," 1.861,56 ",3075144782,CFD," 0,00 "
17/07/2025 08:34:30,Open Position,NSDQ100/USD," 150,00 ",0.130792," 0,00 "," 1.962,03 "," 1.711,56 ",3075169998,CFD," 0,00 "
17/07/2025 09:48:34,Position closed,NSDQ100/USD," 150,82 ",0.130792," 0,82 "," 1.962,85 "," 1.862,38 ",3075169998,CFD," 0,00 "
17/07/2025 09:48:42,Open Position,NSDQ100/USD," 61,52 ",0.104589," 0,00 "," 1.962,85 "," 1.742,39 ",3075194794,CFD," 0,00 "
17/07/2025 11:36:29,Position closed,NSDQ100/USD," 56,93 ",0.050968,"(1,54)"," 1.961,31 "," 1.799,32 ",3075228405,CFD," 0,00 "
17/07/2025 12:31:03,Position closed,NSDQ100/USD," 61,13 ",0.053621,"(0,39)"," 1.960,92 "," 1.860,45 ",3075194794,CFD," 0,00 "
17/07/2025 12:54:28,Position closed,NSDQ100/USD," 101,42 ",0.087514," 0,95 "," 1.961,87 "," 1.961,87 ",3075144495,CFD," 0,00 "
17/07/2025 13:22:04,Open Position,NSDQ100/USD," 119,99 ",0.104606," 0,00 "," 1.961,87 "," 1.841,88 ",3075277317,CFD," 0,00 "
17/07/2025 13:45:17,Position closed,NSDQ100/USD," 121,64 ",0.104606," 1,65 "," 1.963,52 "," 1.963,52 ",3075277317,CFD," 0,00 "
17/07/2025 13:45:26,Open Position,NSDQ100/USD," 119,99 ",0.104535," 0,00 "," 1.963,52 "," 1.843,53 ",3075426221,CFD," 0,00 "
17/07/2025 14:28:24,Position closed,NSDQ100/USD," 122,08 ",0.104535," 2,09 "," 1.965,61 "," 1.965,61 ",3075426221,CFD," 0,00 "
17/07/2025 20:31:35,Open Position,NSDQ100/USD," 149,99 ",0.129912," 0,00 "," 1.965,61 "," 1.815,62 ",3076185411,CFD," 0,00 "
17/07/2025 23:12:47,Overnight fee,Daily,"(0,05)",-,"(0,05)"," 1.965,56 "," 1.815,57 ",3076185411,CFD," 0,00 "
18/07/2025 05:05:51,Open Position,NSDQ100/USD," 120,00 ",0.103815," 0,00 "," 1.965,56 "," 1.695,57 ",3076254555,CFD," 0,00 "
18/07/2025 07:36:05,Position closed,NSDQ100/USD," 121,27 ",0.103815," 1,27 "," 1.966,83 "," 1.816,84 ",3076254555,CFD," 0,00 "
18/07/2025 07:36:19,Open Position,NSDQ100/USD," 120,00 ",0.103892," 0,00 "," 1.966,83 "," 1.696,84 ",3076388094,CFD," 0,00 "
18/07/2025 09:36:09,Open Position,NSDQ100/USD," 61,39 ",0.103788," 0,00 "," 1.966,83 "," 1.576,85 ",3076445545,CFD," 0,00 "
18/07/2025 10:39:12,Position closed,NSDQ100/USD," 57,17 ",0.050685,"(1,43)"," 1.965,40 "," 1.634,02 ",3076466599,CFD," 0,00 "
18/07/2025 14:09:25,Position closed,NSDQ100/USD," 59,11 ",0.053103,"(2,28)"," 1.963,12 "," 1.693,13 ",3076445545,CFD," 0,00 "
18/07/2025 14:09:25,Position closed,NSDQ100/USD," 121,64 ",0.103892," 1,64 "," 1.964,76 "," 1.814,77 ",3076388094,CFD," 0,00 "
18/07/2025 14:09:25,Position closed,NSDQ100/USD," 150,90 ",0.129912," 0,91 "," 1.965,67 "," 1.965,67 ",3076185411,CFD," 0,00 "
18/07/2025 14:11:30,Open Position,NSDQ100/USD," 199,98 ",0.173306," 0,00 "," 1.965,67 "," 1.765,69 ",3076903479,CFD," 0,00 "
18/07/2025 14:11:47,Position closed,NSDQ100/USD," 199,34 ",0.173306,"(0,64)"," 1.965,03 "," 1.965,03 ",3076903479,CFD," 0,00 "
18/07/2025 14:12:20,Open Position,NSDQ100/USD," 119,99 ",0.103989," 0,00 "," 1.965,03 "," 1.845,04 ",3076906350,CFD," 0,00 "
18/07/2025 15:10:37,Position closed,NSDQ100/USD," 122,47 ",0.103989," 2,48 "," 1.967,51 "," 1.967,51 ",3076906350,CFD," 0,00 "