Date,Type,Details,Amount,Units / Contracts,Realized Equity Change,Realized Equity,Balance,Position ID,Asset type,NWA
03/03/2025 08:20:03,Open Position,NSDQ100/USD," 149,98 ",0.143628," 0,00 "," 2.073,96 "," 222,83 ",2956045741,CFD," 0,00 "
03/03/2025 08:46:00,Position closed,NSDQ100/USD," 153,08 ",0.143628," 3,10 "," 2.077,06 "," 375,91 ",2956045741,CFD," 0,00 "
03/03/2025 09:53:28,Position closed,NSDQ100/USD," 50,05 ",0.042296,"(3,19)"," 2.073,87 "," 425,96 ",2956124153,CFD," 0,00 "
03/03/2025 12:15:14,Position closed,NSDQ100/USD," 127,60 ",0.100333," 1,32 "," 2.075,19 "," 553,56 ",2954013747,CFD," 0,00 "
03/03/2025 13:22:44,Position closed,NSDQ100/USD," 50,03 ",0.040442,"(4,90)"," 2.070,29 "," 603,59 ",2956288490,CFD," 0,00 "
03/03/2025 15:01:26,Open Position,NSDQ100/USD," 50,00 ",0.048137," 0,00 "," 2.070,29 "," 553,59 ",2957033196,CFD," 0,00 "
03/03/2025 15:01:54,Open Position,NSDQ100/USD," 99,98 ",0.096204," 0,00 "," 2.070,29 "," 453,61 ",2957034165,CFD," 0,00 "
03/03/2025 15:04:24,Position closed,NSDQ100/USD," 50,70 ",0.048137," 0,70 "," 2.070,99 "," 504,31 ",2957033196,CFD," 0,00 "
03/03/2025 15:07:52,Position closed,NSDQ100/USD," 103,20 ",0.096204," 3,22 "," 2.074,21 "," 607,51 ",2957034165,CFD," 0,00 "
03/03/2025 15:08:07,Open Position,NSDQ100/USD," 150,00 ",0.144167," 0,00 "," 2.074,21 "," 457,51 ",2957067003,CFD," 0,00 "
03/03/2025 15:08:25,Position closed,NSDQ100/USD," 148,34 ",0.144167,"(1,66)"," 2.072,55 "," 605,85 ",2957067003,CFD," 0,00 "
03/03/2025 15:08:45,Open Position,NSDQ100/USD," 49,99 ",0.048079," 0,00 "," 2.072,55 "," 555,86 ",2957069685,CFD," 0,00 "
03/03/2025 15:49:04,Position closed,NSDQ100/USD," 52,33 ",0.048079," 2,34 "," 2.074,89 "," 608,19 ",2957069685,CFD," 0,00 "
03/03/2025 15:49:51,Open Position,NSDQ100/USD," 122,65 ",0.095876," 0,00 "," 2.074,89 "," 508,21 ",2957218309,CFD," 0,00 "
03/03/2025 18:13:44,Position closed,NVDA.EXT/USD," 124,60 ",9.82546,"(125,40)"," 1.949,49 "," 632,81 ",2954268275,CFD," 0,00 "
03/03/2025 18:26:52,Open Position,NSDQ100/USD," 160,28 ",0.144999," 0,00 "," 1.949,49 "," 482,82 ",2957626688,CFD," 0,00 "
03/03/2025 18:29:14,Edit Stop Loss,-,"(3,49)",-," 0,00 "," 1.949,49 "," 479,33 ",2957218309,-," 0,00 "
03/03/2025 20:14:04,Edit Stop Loss,-,"(23,45)",-," 0,00 "," 1.949,49 "," 455,88 ",2953185617,-," 0,00 "
03/03/2025 20:14:13,Edit Stop Loss,-,"(28,16)",-," 0,00 "," 1.949,49 "," 427,72 ",2953659689,-," 0,00 "
03/03/2025 20:14:19,Edit Stop Loss,-,"(14,09)",-," 0,00 "," 1.949,49 "," 413,63 ",2953660033,-," 0,00 "
03/03/2025 20:14:25,Edit Stop Loss,-,"(14,88)",-," 0,00 "," 1.949,49 "," 398,75 ",2953826706,-," 0,00 "
03/03/2025 20:14:32,Edit Stop Loss,-,"(9,59)",-," 0,00 "," 1.949,49 "," 389,16 ",2957218309,-," 0,00 "
03/03/2025 20:15:01,Open Position,NSDQ100/USD," 249,99 ",0.244825," 0,00 "," 1.949,49 "," 139,17 ",2957780223,CFD," 0,00 "
03/03/2025 20:18:06,Position closed,NSDQ100/USD," 253,23 ",0.244825," 3,24 "," 1.952,73 "," 392,40 ",2957780223,CFD," 0,00 "
03/03/2025 20:18:18,Open Position,NSDQ100/USD," 299,93 ",0.293647," 0,00 "," 1.952,73 "," 92,47 ",2957791892,CFD," 0,00 "
03/03/2025 21:17:24,Position closed,NSDQ100/USD," 312,52 ",0.293647," 12,59 "," 1.965,32 "," 404,99 ",2957791892,CFD," 0,00 "
03/03/2025 23:09:59,Open Position,NSDQ100/USD," 99,99 ",0.048867," 0,00 "," 1.965,32 "," 305,00 ",2958653226,CFD," 0,00 "
03/03/2025 23:17:36,Overnight fee,Daily,"(0,48)",-,"(0,48)"," 1.964,84 "," 304,52 ",2957218309,CFD," 0,00 "
03/03/2025 23:17:36,Overnight fee,Daily,"(0,71)",-,"(0,71)"," 1.964,13 "," 303,81 ",2953660033,CFD," 0,00 "
03/03/2025 23:17:36,Overnight fee,Daily,"(0,73)",-,"(0,73)"," 1.963,40 "," 303,08 ",2957626688,CFD," 0,00 "
03/03/2025 23:17:36,Overnight fee,Daily,"(0,75)",-,"(0,75)"," 1.962,65 "," 302,33 ",2953826706,CFD," 0,00 "
03/03/2025 23:17:36,Overnight fee,Daily,"(1,19)",-,"(1,19)"," 1.961,46 "," 301,14 ",2953185617,CFD," 0,00 "
03/03/2025 23:17:36,Overnight fee,Daily,"(1,42)",-,"(1,42)"," 1.960,04 "," 299,72 ",2953659689,CFD," 0,00 "
04/03/2025 00:41:28,Index price adjustment,NSDQ100/USD," 0,15 ",-," 0,15 "," 1.960,19 "," 299,87 ",2953185617,CFD," 0,00 "
04/03/2025 00:41:28,Index price adjustment,NSDQ100/USD," 0,18 ",-," 0,18 "," 1.960,37 "," 300,05 ",2953659689,CFD," 0,00 "
04/03/2025 00:41:28,Index price adjustment,NSDQ100/USD," 0,09 ",-," 0,09 "," 1.960,46 "," 300,14 ",2953660033,CFD," 0,00 "
04/03/2025 00:41:28,Index price adjustment,NSDQ100/USD," 0,10 ",-," 0,10 "," 1.960,56 "," 300,24 ",2953826706,CFD," 0,00 "
04/03/2025 00:41:28,Index price adjustment,NSDQ100/USD," 0,06 ",-," 0,06 "," 1.960,62 "," 300,30 ",2957218309,CFD," 0,00 "
04/03/2025 00:41:28,Index price adjustment,NSDQ100/USD," 0,10 ",-," 0,10 "," 1.960,72 "," 300,40 ",2957626688,CFD," 0,00 "
04/03/2025 00:41:28,Index price adjustment,NSDQ100/USD," 0,19 ",-," 0,19 "," 1.960,91 "," 300,59 ",2957791892,CFD," 0,00 "
04/03/2025 12:13:19,Open Position,NSDQ100/USD," 99,99 ",0.098137," 0,00 "," 1.960,91 "," 200,60 ",2959070561,CFD," 0,00 "
04/03/2025 13:28:41,Edit Stop Loss,-,"(23,44)",-," 0,00 "," 1.960,91 "," 177,16 ",2953185617,-," 0,00 "
04/03/2025 13:28:47,Edit Stop Loss,-,"(28,17)",-," 0,00 "," 1.960,91 "," 148,99 ",2953659689,-," 0,00 "
04/03/2025 13:29:00,Edit Stop Loss,-,"(14,08)",-," 0,00 "," 1.960,91 "," 134,91 ",2953660033,-," 0,00 "
04/03/2025 13:29:06,Edit Stop Loss,-,"(14,89)",-," 0,00 "," 1.960,91 "," 120,02 ",2953826706,-," 0,00 "
04/03/2025 13:29:14,Edit Stop Loss,-,"(9,59)",-," 0,00 "," 1.960,91 "," 110,43 ",2957218309,-," 0,00 "
04/03/2025 13:29:22,Edit Stop Loss,-,"(10,29)",-," 0,00 "," 1.960,91 "," 100,14 ",2957626688,-," 0,00 "
04/03/2025 13:52:34,Open Position,NSDQ100/USD," 79,99 ",0.0789," 0,00 "," 1.960,91 "," 20,15 ",2959130295,CFD," 0,00 "
04/03/2025 14:32:11,Position closed,NSDQ100/USD," 82,38 ",0.0789," 2,39 "," 1.963,30 "," 102,53 ",2959130295,CFD," 0,00 "
04/03/2025 14:35:30,Open Position,NSDQ100/USD," 99,98 ",0.098695," 0,00 "," 1.963,30 "," 2,55 ",2959301405,CFD," 0,00 "
04/03/2025 15:16:33,Position closed,NSDQ100/USD," 49,70 ",0.095876,"(72,95)"," 1.890,35 "," 52,25 ",2957218309,CFD," 0,00 "
04/03/2025 15:16:33,Position closed,NSDQ100/USD," 149,26 ",0.281653,"(339,47)"," 1.550,88 "," 201,51 ",2953659689,CFD," 0,00 "
04/03/2025 15:16:33,Position closed,NSDQ100/USD," 78,08 ",0.148854,"(153,87)"," 1.397,01 "," 279,59 ",2953826706,CFD," 0,00 "
04/03/2025 15:16:33,Position closed,NSDQ100/USD," 74,61 ",0.140839,"(169,51)"," 1.227,50 "," 354,20 ",2953660033,CFD," 0,00 "
04/03/2025 15:16:33,Position closed,NSDQ100/USD," 124,03 ",0.23441,"(289,03)"," 938,47 "," 478,23 ",2953185617,CFD," 0,00 "
04/03/2025 15:16:34,Position closed,NSDQ100/USD," 74,36 ",0.144999,"(85,92)"," 852,55 "," 552,59 ",2957626688,CFD," 0,00 "
04/03/2025 15:38:19,Position closed,NSDQ100/USD," 110,18 ",0.098695," 10,20 "," 862,75 "," 662,77 ",2959301405,CFD," 0,00 "
04/03/2025 15:41:00,Open Position,NSDQ100/USD," 300,00 ",0.14897," 0,00 "," 862,75 "," 362,77 ",2959776095,CFD," 0,00 "
04/03/2025 15:41:25,Open Position,NSDQ100/USD," 149,99 ",0.14866," 0,00 "," 862,75 "," 212,78 ",2959777520,CFD," 0,00 "
04/03/2025 16:32:51,Position closed,NSDQ100/USD," 154,03 ",0.14866," 4,04 "," 866,79 "," 366,81 ",2959777520,CFD," 0,00 "
04/03/2025 16:33:00,Position closed,NSDQ100/USD," 301,25 ",0.14897," 1,25 "," 868,04 "," 668,06 ",2959776095,CFD," 0,00 "
04/03/2025 16:33:45,Open Position,NSDQ100/USD," 299,99 ",0.14892," 0,00 "," 868,04 "," 368,07 ",2959885097,CFD," 0,00 "
04/03/2025 16:34:13,Open Position,NSDQ100/USD," 116,88 ",0.099361," 0,00 "," 868,04 "," 268,08 ",2959885697,CFD," 0,00 "
04/03/2025 16:48:41,Position closed,NSDQ100/USD," 306,95 ",0.14892," 6,96 "," 875,00 "," 575,03 ",2959885097,CFD," 0,00 "
04/03/2025 16:48:54,Open Position,NSDQ100/USD," 349,98 ",0.173226," 0,00 "," 875,00 "," 225,05 ",2959921042,CFD," 0,00 "
04/03/2025 17:42:40,Position closed,NSDQ100/USD," 365,39 ",0.173226," 15,41 "," 890,41 "," 590,44 ",2959921042,CFD," 0,00 "
04/03/2025 17:43:00,Open Position,NSDQ100/USD," 249,98 ",0.123126," 0,00 "," 890,41 "," 340,46 ",2960016466,CFD," 0,00 "
04/03/2025 17:48:57,Position closed,NSDQ100/USD," 254,10 ",0.123126," 4,12 "," 894,53 "," 594,56 ",2960016466,CFD," 0,00 "
04/03/2025 17:49:19,Open Position,NSDQ100/USD," 299,99 ",0.147583," 0,00 "," 894,53 "," 294,57 ",2960022755,CFD," 0,00 "
04/03/2025 19:31:47,Position closed,NSDQ100/USD," 102,27 ",0.048867," 2,28 "," 896,81 "," 396,84 ",2958653226,CFD," 0,00 "
04/03/2025 19:32:06,Position closed,NSDQ100/USD," 326,49 ",0.147583," 26,50 "," 923,31 "," 723,33 ",2960022755,CFD," 0,00 "
04/03/2025 19:32:14,Position closed,NSDQ100/USD," 113,03 ",0.098137," 13,04 "," 936,35 "," 836,36 ",2959070561,CFD," 0,00 "
04/03/2025 19:35:12,Open Position,NSDQ100/USD," 199,98 ",0.097519," 0,00 "," 936,35 "," 636,38 ",2960232264,CFD," 0,00 "
04/03/2025 19:58:51,Position closed,NSDQ100/USD," 205,97 ",0.097519," 5,99 "," 942,34 "," 842,35 ",2960232264,CFD," 0,00 "
04/03/2025 19:59:09,Edit Stop Loss,-,"(11,92)",-," 0,00 "," 942,34 "," 830,43 ",2959885697,-," 0,00 "
04/03/2025 19:59:26,Open Position,NSDQ100/USD," 299,98 ",0.145797," 0,00 "," 942,34 "," 530,45 ",2960255273,CFD," 0,00 "
04/03/2025 20:19:59,Position closed,NSDQ100/USD," 308,58 ",0.145797," 8,60 "," 950,94 "," 839,03 ",2960255273,CFD," 0,00 "
04/03/2025 20:20:23,Edit Stop Loss,-,"(4,97)",-," 0,00 "," 950,94 "," 834,06 ",2959885697,-," 0,00 "
04/03/2025 20:20:46,Open Position,NSDQ100/USD," 349,98 ",0.169605," 0,00 "," 950,94 "," 484,08 ",2960278437,CFD," 0,00 "
04/03/2025 20:26:03,Position closed,NSDQ100/USD," 353,30 ",0.169605," 3,32 "," 954,26 "," 837,38 ",2960278437,CFD," 0,00 "
04/03/2025 20:26:45,Open Position,NSDQ100/USD," 199,89 ",0.193526," 0,00 "," 954,26 "," 437,40 ",2960284737,CFD," 0,00 "
04/03/2025 20:40:56,Open Position,NSDQ100/USD," 99,99 ",0.048884," 0,00 "," 954,26 "," 337,41 ",2960313831,CFD," 0,00 "
04/03/2025 20:53:44,Open Position,NSDQ100/USD," 199,98 ",0.196881," 0,00 "," 954,26 "," 137,43 ",2960340878,CFD," 0,00 "
04/03/2025 21:04:55,Position closed,NSDQ100/USD," 213,08 ",0.196881," 13,10 "," 967,36 "," 350,51 ",2960340878,CFD," 0,00 "
04/03/2025 21:51:58,Position closed,NSDQ100/USD," 101,20 ",0.048884," 1,21 "," 968,57 "," 451,71 ",2960313831,CFD," 0,00 "
04/03/2025 21:52:13,Open Position,NSDQ100/USD," 249,99 ",0.12206," 0,00 "," 968,57 "," 201,72 ",2960365507,CFD," 0,00 "
04/03/2025 23:17:29,Overnight fee,Daily,"(0,03)",-,"(0,03)"," 968,54 "," 201,69 ",2959885697,CFD," 0,00 "
04/03/2025 23:17:29,Overnight fee,Daily,"(0,62)",-,"(0,62)"," 967,92 "," 201,07 ",2960365507,CFD," 0,00 "
04/03/2025 23:17:29,Overnight fee,Daily,"(0,98)",-,"(0,98)"," 966,94 "," 200,09 ",2960284737,CFD," 0,00 "
04/03/2025 23:53:35,Position closed,NSDQ100/USD," 254,46 ",0.12206," 4,47 "," 971,41 "," 454,55 ",2960365507,CFD," 0,00 "
04/03/2025 23:53:58,Open Position,NSDQ100/USD," 99,99 ",0.048722," 0,00 "," 971,41 "," 354,56 ",2960465954,CFD," 0,00 "
04/03/2025 23:56:18,Position closed,NSDQ100/USD," 99,79 ",0.048722,"(0,20)"," 971,21 "," 454,35 ",2960465954,CFD," 0,00 "
05/03/2025 00:39:57,Index price adjustment,NSDQ100/USD,"(0,05)",-,"(0,05)"," 971,16 "," 454,30 ",2959885697,CFD," 0,00 "
05/03/2025 00:39:57,Index price adjustment,NSDQ100/USD," 0,09 ",-," 0,09 "," 971,25 "," 454,39 ",2960284737,CFD," 0,00 "
05/03/2025 00:39:57,Index price adjustment,NSDQ100/USD," 0,02 ",-," 0,02 "," 971,27 "," 454,41 ",2960313831,CFD," 0,00 "
05/03/2025 00:39:57,Index price adjustment,NSDQ100/USD," 0,09 ",-," 0,09 "," 971,36 "," 454,50 ",2960340878,CFD," 0,00 "
05/03/2025 06:46:48,Open Position,NSDQ100/USD," 149,99 ",0.073167," 0,00 "," 971,36 "," 304,51 ",2960517958,CFD," 0,00 "
05/03/2025 14:33:53,Open Position,NSDQ100/USD," 199,98 ",0.196342," 0,00 "," 971,36 "," 104,53 ",2960870479,CFD," 0,00 "
05/03/2025 16:23:39,Open Position,NSDQ100/USD," 99,98 ",0.098829," 0,00 "," 971,36 "," 4,55 ",2961169381,CFD," 0,00 "
05/03/2025 17:10:21,Position closed,NSDQ100/USD," 109,54 ",0.098829," 9,56 "," 980,92 "," 114,09 ",2961169381,CFD," 0,00 "
05/03/2025 17:10:42,Position closed,NSDQ100/USD," 97,18 ",0.099361,"(19,70)"," 961,22 "," 211,27 ",2959885697,CFD," 0,00 "
05/03/2025 17:10:54,Open Position,NSDQ100/USD," 150,00 ",0.147635," 0,00 "," 961,22 "," 61,27 ",2961259798,CFD," 0,00 "
05/03/2025 17:43:13,Position closed,NSDQ100/USD," 170,64 ",0.147635," 20,64 "," 981,86 "," 231,91 ",2961259798,CFD," 0,00 "
05/03/2025 17:43:34,Position closed,NSDQ100/USD," 214,90 ",0.196342," 14,92 "," 996,78 "," 446,81 ",2960870479,CFD," 0,00 "
05/03/2025 17:58:09,Position closed,NSDQ100/USD," 150,79 ",0.073167," 0,80 "," 997,58 "," 597,60 ",2960517958,CFD," 0,00 "
05/03/2025 17:58:21,Open Position,NSDQ100/USD," 349,98 ",0.170587," 0,00 "," 997,58 "," 247,62 ",2961321941,CFD," 0,00 "
05/03/2025 18:59:09,Position closed,NSDQ100/USD," 354,26 ",0.170587," 4,28 "," 1.001,86 "," 601,88 ",2961321941,CFD," 0,00 "
05/03/2025 18:59:43,Open Position,NSDQ100/USD," 199,97 ",0.097318," 0,00 "," 1.001,86 "," 401,91 ",2961371370,CFD," 0,00 "
05/03/2025 19:21:36,Position closed,NSDQ100/USD," 207,51 ",0.097318," 7,54 "," 1.009,40 "," 609,42 ",2961371370,CFD," 0,00 "
05/03/2025 19:22:04,Position closed,NSDQ100/USD," 196,36 ",0.096812,"(3,73)"," 1.005,67 "," 805,78 ",2961393425,CFD," 0,00 "
05/03/2025 19:24:45,Position closed,NSDQ100/USD," 197,66 ",0.096714,"(2,23)"," 1.003,44 "," 1.003,44 ",2960284737,CFD," 0,00 "
05/03/2025 19:25:11,Open Position,NSDQ100/USD," 249,97 ",0.121123," 0,00 "," 1.003,44 "," 753,47 ",2961395864,CFD," 0,00 "
05/03/2025 23:17:00,Overnight fee,Daily,"(0,61)",-,"(0,61)"," 1.002,83 "," 752,86 ",2961395864,CFD," 0,00 "
06/03/2025 00:17:50,Index price adjustment,NSDQ100/USD," 0,20 ",-," 0,20 "," 1.003,03 "," 753,06 ",2961395864,CFD," 0,00 "
06/03/2025 08:38:34,Open Position,NSDQ100/USD," 114,55 ",0.09775," 0,00 "," 1.003,03 "," 653,07 ",2961639905,CFD," 0,00 "
06/03/2025 08:39:17,Open Position,NSDQ100/USD," 49,98 ",0.048865," 0,00 "," 1.003,03 "," 603,09 ",2961640296,CFD," 0,00 "
06/03/2025 08:48:44,Position closed,NSDQ100/USD," 50,67 ",0.048865," 0,69 "," 1.003,72 "," 653,76 ",2961640296,CFD," 0,00 "
06/03/2025 09:48:08,Open Position,NSDQ100/USD," 400,00 ",0.196249," 0,00 "," 1.003,72 "," 253,76 ",2961674273,CFD," 0,00 "
06/03/2025 14:09:34,Open Position,NSDQ100/USD," 49,99 ",0.049215," 0,00 "," 1.003,72 "," 203,77 ",2961781230,CFD," 0,00 "
06/03/2025 14:49:19,Open Position,NSDQ100/USD," 99,99 ",0.098776," 0,00 "," 1.003,72 "," 103,78 ",2961924549,CFD," 0,00 "
06/03/2025 16:19:37,Position closed,NSDQ100/USD," 115,41 ",0.098776," 15,42 "," 1.019,14 "," 219,19 ",2961924549,CFD," 0,00 "
06/03/2025 16:19:44,Position closed,NSDQ100/USD," 54,51 ",0.049215," 4,52 "," 1.023,66 "," 273,70 ",2961781230,CFD," 0,00 "
06/03/2025 16:19:53,Position closed,NSDQ100/USD," 403,32 ",0.196249," 3,32 "," 1.026,98 "," 677,02 ",2961674273,CFD," 0,00 "
06/03/2025 16:20:05,Open Position,NSDQ100/USD," 157,60 ",0.098043," 0,00 "," 1.026,98 "," 577,04 ",2962324179,CFD," 0,00 "
06/03/2025 17:08:03,Open Position,NSDQ100/USD," 399,97 ",0.396873," 0,00 "," 1.026,98 "," 177,07 ",2962371565,CFD," 0,00 "
06/03/2025 19:38:10,Edit Stop Loss,-,"(8,59)",-," 0,00 "," 1.026,98 "," 168,48 ",2962324179,-," 0,00 "
06/03/2025 19:38:18,Edit Stop Loss,-,"(14,56)",-," 0,00 "," 1.026,98 "," 153,92 ",2961639905,-," 0,00 "
06/03/2025 19:41:33,Open Position,NSDQ100/USD," 99,99 ",0.099995," 0,00 "," 1.026,98 "," 53,93 ",2963073298,CFD," 0,00 "
06/03/2025 20:05:12,Position closed,NSDQ100/USD," 104,53 ",0.099995," 4,54 "," 1.031,52 "," 158,46 ",2963073298,CFD," 0,00 "
06/03/2025 20:05:36,Open Position,NSDQ100/USD," 99,99 ",0.099727," 0,00 "," 1.031,52 "," 58,47 ",2963290183,CFD," 0,00 "
06/03/2025 21:12:10,Position closed,NSDQ100/USD," 103,37 ",0.099727," 3,38 "," 1.034,90 "," 161,84 ",2963290183,CFD," 0,00 "
06/03/2025 23:17:00,Overnight fee,Daily,"(0,49)",-,"(0,49)"," 1.034,41 "," 161,35 ",2961639905,CFD," 0,00 "
06/03/2025 23:17:00,Overnight fee,Daily,"(0,50)",-,"(0,50)"," 1.033,91 "," 160,85 ",2962324179,CFD," 0,00 "
06/03/2025 23:17:00,Overnight fee,Daily,"(0,61)",-,"(0,61)"," 1.033,30 "," 160,24 ",2961395864,CFD," 0,00 "
06/03/2025 23:17:00,Overnight fee,Daily,"(2,01)",-,"(2,01)"," 1.031,29 "," 158,23 ",2962371565,CFD," 0,00 "
07/03/2025 00:39:45,Index price adjustment,NSDQ100/USD," 0,45 ",-," 0,45 "," 1.031,74 "," 158,68 ",2961395864,CFD," 0,00 "
07/03/2025 00:39:45,Index price adjustment,NSDQ100/USD," 0,36 ",-," 0,36 "," 1.032,10 "," 159,04 ",2961639905,CFD," 0,00 "
07/03/2025 00:39:45,Index price adjustment,NSDQ100/USD," 0,36 ",-," 0,36 "," 1.032,46 "," 159,40 ",2962324179,CFD," 0,00 "
07/03/2025 00:39:45,Index price adjustment,NSDQ100/USD," 1,47 ",-," 1,47 "," 1.033,93 "," 160,87 ",2962371565,CFD," 0,00 "
07/03/2025 00:39:45,Index price adjustment,NSDQ100/USD," 0,37 ",-," 0,37 "," 1.034,30 "," 161,24 ",2963290183,CFD," 0,00 "
07/03/2025 01:16:04,Position closed,NSDQ100/USD," 403,90 ",0.396873," 3,93 "," 1.038,23 "," 565,14 ",2962371565,CFD," 0,00 "
07/03/2025 01:16:17,Open Position,NSDQ100/USD," 199,99 ",0.198321," 0,00 "," 1.038,23 "," 365,15 ",2963746500,CFD," 0,00 "
07/03/2025 09:14:03,Position closed,NSDQ100/USD," 200,62 ",0.198321," 0,63 "," 1.038,86 "," 565,77 ",2963746500,CFD," 0,00 "
07/03/2025 09:14:19,Open Position,NSDQ100/USD," 206,91 ",0.148601," 0,00 "," 1.038,86 "," 415,77 ",2963859629,CFD," 0,00 "
07/03/2025 12:24:11,Open Position,NSDQ100/USD," 149,99 ",0.149198," 0,00 "," 1.038,86 "," 265,78 ",2963934333,CFD," 0,00 "
07/03/2025 12:31:34,Open Position,NSDQ100/USD," 199,99 ",0.099561," 0,00 "," 1.038,86 "," 65,79 ",2963937337,CFD," 0,00 "
07/03/2025 13:45:52,Position closed,NSDQ100/USD," 203,32 ",0.099561," 3,33 "," 1.042,19 "," 269,11 ",2963937337,CFD," 0,00 "
07/03/2025 13:46:00,Position closed,NSDQ100/USD," 152,45 ",0.149198," 2,46 "," 1.044,65 "," 421,56 ",2963934333,CFD," 0,00 "
07/03/2025 13:46:15,Open Position,NSDQ100/USD," 300,00 ",0.149014," 0,00 "," 1.044,65 "," 121,56 ",2963966153,CFD," 0,00 "
07/03/2025 14:38:11,Open Position,NSDQ100/USD," 99,99 ",0.099924," 0,00 "," 1.044,65 "," 21,57 ",2964086769,CFD," 0,00 "
07/03/2025 14:57:36,Position closed,NSDQ100/USD," 111,49 ",0.099924," 11,50 "," 1.056,15 "," 133,06 ",2964086769,CFD," 0,00 "
07/03/2025 15:50:54,Edit Stop Loss,-,"(19,61)",-," 0,00 "," 1.056,15 "," 113,45 ",2962324179,-," 0,00 "
07/03/2025 15:51:30,Open Position,NSDQ100/USD," 99,97 ",0.100159," 0,00 "," 1.056,15 "," 13,48 ",2964403674,CFD," 0,00 "
07/03/2025 16:36:56,Position closed,NSDQ100/USD," 49,95 ",0.09775,"(64,60)"," 991,55 "," 63,43 ",2961639905,CFD," 0,00 "
07/03/2025 16:38:41,Open Position,NSDQ100/USD," 50,00 ",0.050521," 0,00 "," 991,55 "," 13,43 ",2964504399,CFD," 0,00 "
07/03/2025 17:03:52,Position closed,NSDQ100/USD," 51,67 ",0.050521," 1,67 "," 993,22 "," 65,10 ",2964504399,CFD," 0,00 "
07/03/2025 17:04:06,Open Position,NSDQ100/USD," 50,00 ",0.050382," 0,00 "," 993,22 "," 15,10 ",2964568701,CFD," 0,00 "
07/03/2025 17:45:02,Position closed,NSDQ100/USD," 55,72 ",0.050382," 5,72 "," 998,94 "," 70,82 ",2964568701,CFD," 0,00 "
07/03/2025 17:45:31,Position closed,NSDQ100/USD," 101,01 ",0.100159," 1,04 "," 999,98 "," 171,83 ",2964403674,CFD," 0,00 "
07/03/2025 17:45:46,Open Position,NSDQ100/USD," 99,98 ",0.100042," 0,00 "," 999,98 "," 71,85 ",2964615919,CFD," 0,00 "
07/03/2025 18:04:53,Position closed,NSDQ100/USD," 102,96 ",0.100042," 2,98 "," 1.002,96 "," 174,81 ",2964615919,CFD," 0,00 "
07/03/2025 18:05:05,Open Position,NSDQ100/USD," 99,99 ",0.099884," 0,00 "," 1.002,96 "," 74,82 ",2964633591,CFD," 0,00 "
07/03/2025 18:49:23,Position closed,NSDQ100/USD," 107,95 ",0.099884," 7,96 "," 1.010,92 "," 182,77 ",2964633591,CFD," 0,00 "
07/03/2025 19:04:04,Position closed,NSDQ100/USD," 301,13 ",0.149014," 1,13 "," 1.012,05 "," 483,90 ",2963966153,CFD," 0,00 "
07/03/2025 19:05:07,Open Position,NSDQ100/USD," 99,99 ",0.09929," 0,00 "," 1.012,05 "," 383,91 ",2964676530,CFD," 0,00 "
07/03/2025 19:45:05,Position closed,NSDQ100/USD," 100,73 ",0.09929," 0,74 "," 1.012,79 "," 484,64 ",2964676530,CFD," 0,00 "
07/03/2025 23:17:11,Overnight fee,Weekend Fee,"(1,49)",-,"(1,49)"," 1.011,30 "," 483,15 ",2962324179,CFD," 0,00 "
07/03/2025 23:17:11,Overnight fee,Weekend Fee,"(1,84)",-,"(1,84)"," 1.009,46 "," 481,31 ",2961395864,CFD," 0,00 "
07/03/2025 23:17:11,Overnight fee,Weekend Fee,"(2,25)",-,"(2,25)"," 1.007,21 "," 479,06 ",2963859629,CFD," 0,00 "
08/03/2025 00:23:07,Index price adjustment,NSDQ100/USD," 0,15 ",-," 0,15 "," 1.007,36 "," 479,21 ",2961395864,CFD," 0,00 "
08/03/2025 00:23:07,Index price adjustment,NSDQ100/USD," 0,12 ",-," 0,12 "," 1.007,48 "," 479,33 ",2962324179,CFD," 0,00 "
08/03/2025 00:23:07,Index price adjustment,NSDQ100/USD," 0,18 ",-," 0,18 "," 1.007,66 "," 479,51 ",2963859629,CFD," 0,00 "
09/03/2025 23:31:42,Open Position,NSDQ100/USD," 199,98 ",0.199974," 0,00 "," 1.007,66 "," 279,53 ",2965415653,CFD," 0,00 "
10/03/2025 01:19:24,Position closed,NSDQ100/USD," 207,12 ",0.199974," 7,14 "," 1.014,80 "," 486,65 ",2965415653,CFD," 0,00 "
10/03/2025 01:19:37,Open Position,NSDQ100/USD," 150,00 ",0.149676," 0,00 "," 1.014,80 "," 336,65 ",2965424356,CFD," 0,00 "
10/03/2025 08:19:47,Open Position,NSDQ100/USD," 119,20 ",0.100037," 0,00 "," 1.014,80 "," 236,66 ",2965550829,CFD," 0,00 "
10/03/2025 08:51:38,Open Position,NSDQ100/USD," 49,99 ",0.050104," 0,00 "," 1.014,80 "," 186,67 ",2965598127,CFD," 0,00 "
10/03/2025 08:58:55,Position closed,NSDQ100/USD," 51,83 ",0.050104," 1,84 "," 1.016,64 "," 238,50 ",2965598127,CFD," 0,00 "
10/03/2025 08:59:50,Open Position,NSDQ100/USD," 50,00 ",0.050184," 0,00 "," 1.016,64 "," 188,50 ",2965602106,CFD," 0,00 "
10/03/2025 12:19:40,Open Position,NSDQ100/USD," 99,99 ",0.100708," 0,00 "," 1.016,64 "," 88,51 ",2965779765,CFD," 0,00 "
10/03/2025 13:57:21,Edit Stop Loss,-,"(12,33)",-," 0,00 "," 1.016,64 "," 76,18 ",2963859629,-," 0,00 "
10/03/2025 14:30:26,Position closed,NSDQ100/USD," 124,70 ",0.121123,"(125,27)"," 891,37 "," 200,88 ",2961395864,CFD," 0,00 "
10/03/2025 14:30:57,Edit Stop Loss,-,"(14,86)",-," 0,00 "," 891,37 "," 186,02 ",2963859629,-," 0,00 "
10/03/2025 14:31:14,Edit Stop Loss,-,"(9,81)",-," 0,00 "," 891,37 "," 176,21 ",2962324179,-," 0,00 "
10/03/2025 14:32:38,Open Position,NSDQ100/USD," 112,89 ",0.101939," 0,00 "," 891,37 "," 76,23 ",2966623219,CFD," 0,00 "
10/03/2025 14:52:16,Position closed,NSDQ100/USD," 74,83 ",0.149676,"(75,17)"," 816,20 "," 151,06 ",2965424356,CFD," 0,00 "
10/03/2025 14:53:00,Edit Stop Loss,-,"(9,80)",-," 0,00 "," 816,20 "," 141,26 ",2962324179,-," 0,00 "
10/03/2025 14:53:06,Edit Stop Loss,-,"(14,86)",-," 0,00 "," 816,20 "," 126,40 ",2963859629,-," 0,00 "
10/03/2025 14:53:14,Edit Stop Loss,-,"(9,20)",-," 0,00 "," 816,20 "," 117,20 ",2965550829,-," 0,00 "
10/03/2025 14:56:06,Open Position,NSDQ100/USD," 76,00 ",0.077952," 0,00 "," 816,20 "," 41,20 ",2966737524,CFD," 0,00 "
10/03/2025 17:11:27,Position closed,NSDQ100/USD," 25,11 ",0.050184,"(24,89)"," 791,31 "," 66,31 ",2965602106,CFD," 0,00 "
10/03/2025 17:13:38,Edit Stop Loss,-,"(10,01)",-," 0,00 "," 791,31 "," 56,30 ",2965550829,-," 0,00 "
10/03/2025 17:13:49,Edit Stop Loss,-,"(14,86)",-," 0,00 "," 791,31 "," 41,44 ",2963859629,-," 0,00 "
10/03/2025 17:13:58,Edit Stop Loss,-,"(9,81)",-," 0,00 "," 791,31 "," 31,63 ",2962324179,-," 0,00 "
10/03/2025 17:14:02,Position closed,NSDQ100/USD," 80,14 ",0.077952," 4,14 "," 795,45 "," 111,77 ",2966737524,CFD," 0,00 "
10/03/2025 17:15:38,Open Position,NSDQ100/USD," 50,00 ",0.051377," 0,00 "," 795,45 "," 61,77 ",2967036991,CFD," 0,00 "
10/03/2025 17:22:02,Open Position,USD/JPY," 50,00 ",1500," 0,00 "," 795,45 "," 11,77 ",2967047357,CFD," 0,00 "
10/03/2025 18:06:27,Position closed,NSDQ100/USD," 49,95 ",0.100708,"(50,04)"," 745,41 "," 61,72 ",2965779765,CFD," 0,00 "
10/03/2025 18:17:01,Position closed,USD/JPY," 51,26 ",1500," 1,26 "," 746,67 "," 112,98 ",2967047357,CFD," 0,00 "
10/03/2025 18:17:26,Open Position,USD/JPY," 50,00 ",1500," 0,00 "," 746,67 "," 62,98 ",2967170293,CFD," 0,00 "
10/03/2025 18:59:44,Position closed,NSDQ100/USD," 49,54 ",0.100037,"(69,66)"," 677,01 "," 112,52 ",2965550829,CFD," 0,00 "
10/03/2025 18:59:44,Position closed,NSDQ100/USD," 49,52 ",0.098043,"(108,08)"," 568,93 "," 162,04 ",2962324179,CFD," 0,00 "
10/03/2025 18:59:44,Position closed,NSDQ100/USD," 74,56 ",0.148601,"(132,35)"," 436,58 "," 236,60 ",2963859629,CFD," 0,00 "
10/03/2025 19:27:21,Open Position,NSDQ100/USD," 49,98 ",0.051453," 0,00 "," 436,58 "," 186,62 ",2967312878,CFD," 0,00 "
10/03/2025 19:29:18,Open Position,NSDQ100/USD," 99,98 ",0.102845," 0,00 "," 436,58 "," 86,64 ",2967317675,CFD," 0,00 "
10/03/2025 20:41:45,Open Position,USD/JPY," 50,00 ",1500," 0,00 "," 436,58 "," 36,64 ",2967527096,CFD," 0,00 "
10/03/2025 22:37:49,Position closed,NSDQ100/USD," 52,08 ",0.051453," 2,10 "," 438,68 "," 88,72 ",2967312878,CFD," 0,00 "
10/03/2025 22:38:08,Open Position,USD/JPY," 70,00 ",2100," 0,00 "," 438,68 "," 18,72 ",2967540571,CFD," 0,00 "
10/03/2025 23:16:54,Overnight refund,Daily," 0,11 ",-," 0,11 "," 438,79 "," 18,83 ",2967527096,CFD," 0,00 "
10/03/2025 23:16:54,Overnight refund,Daily," 0,11 ",-," 0,11 "," 438,90 "," 18,94 ",2967170293,CFD," 0,00 "
10/03/2025 23:16:54,Overnight fee,Daily,"(0,02)",-,"(0,02)"," 438,88 "," 18,92 ",2967312878,CFD," 0,00 "
10/03/2025 23:16:54,Overnight fee,Daily,"(0,25)",-,"(0,25)"," 438,63 "," 18,67 ",2967036991,CFD," 0,00 "
10/03/2025 23:16:54,Overnight fee,Daily,"(0,49)",-,"(0,49)"," 438,14 "," 18,18 ",2966623219,CFD," 0,00 "
10/03/2025 23:16:54,Overnight fee,Daily,"(0,50)",-,"(0,50)"," 437,64 "," 17,68 ",2967317675,CFD," 0,00 "
10/03/2025 23:32:43,Edit Stop Loss,-,"(12,91)",-," 0,00 "," 437,64 "," 4,77 ",2966623219,-," 0,00 "
11/03/2025 08:37:32,Position closed,NSDQ100/USD," 52,65 ",0.051377," 2,65 "," 440,29 "," 57,42 ",2967036991,CFD," 0,00 "
11/03/2025 08:37:40,Position closed,NSDQ100/USD," 107,52 ",0.102845," 7,54 "," 447,83 "," 164,94 ",2967317675,CFD," 0,00 "
11/03/2025 08:37:56,Position closed,USD/JPY," 71,10 ",2100," 1,10 "," 448,93 "," 236,04 ",2967540571,CFD," 0,00 "
11/03/2025 08:38:13,Open Position,NSDQ100/USD," 150,00 ",0.153649," 0,00 "," 448,93 "," 86,04 ",2967731080,CFD," 0,00 "
11/03/2025 09:30:29,Position closed,USD/JPY," 51,29 ",1500," 1,29 "," 450,22 "," 137,33 ",2967527096,CFD," 0,00 "
11/03/2025 09:30:36,Position closed,USD/JPY," 50,94 ",1500," 0,94 "," 451,16 "," 188,27 ",2967170293,CFD," 0,00 "
11/03/2025 09:30:56,Open Position,USD/JPY," 100,00 ",3000," 0,00 "," 451,16 "," 88,27 ",2967753994,CFD," 0,00 "
11/03/2025 10:59:29,Position closed,USD/JPY," 101,87 ",3000," 1,87 "," 453,03 "," 190,14 ",2967753994,CFD," 0,00 "
11/03/2025 13:35:28,Open Position,NSDQ100/USD," 49,98 ",0.051574," 0,00 "," 453,03 "," 140,16 ",2967955634,CFD," 0,00 "
11/03/2025 13:48:44,Position closed,NSDQ100/USD," 151,03 ",0.153649," 1,03 "," 454,06 "," 291,19 ",2967731080,CFD," 0,00 "
11/03/2025 13:48:56,Open Position,NSDQ100/USD," 99,98 ",0.102344," 0,00 "," 454,06 "," 191,21 ",2968017254,CFD," 0,00 "
11/03/2025 16:06:59,Open Position,NSDQ100/USD," 99,99 ",0.103293," 0,00 "," 454,06 "," 91,22 ",2968430344,CFD," 0,00 "
11/03/2025 16:07:05,Position closed,NSDQ100/USD," 51,53 ",0.051574," 1,55 "," 455,61 "," 142,75 ",2967955634,CFD," 0,00 "
11/03/2025 19:33:26,Position closed,NSDQ100/USD," 115,41 ",0.103293," 15,42 "," 471,03 "," 258,16 ",2968430344,CFD," 0,00 "
11/03/2025 19:49:28,Open Position,NSDQ100/USD," 50,00 ",0.051246," 0,00 "," 471,03 "," 208,16 ",2968669456,CFD," 0,00 "
11/03/2025 20:06:09,Open Position,NSDQ100/USD," 149,99 ",0.154831," 0,00 "," 471,03 "," 58,17 ",2968684748,CFD," 0,00 "
11/03/2025 23:16:51,Overnight fee,Daily,"(0,25)",-,"(0,25)"," 470,78 "," 57,92 ",2968669456,CFD," 0,00 "
11/03/2025 23:16:51,Overnight fee,Daily,"(0,49)",-,"(0,49)"," 470,29 "," 57,43 ",2966623219,CFD," 0,00 "
11/03/2025 23:16:51,Overnight fee,Daily,"(0,49)",-,"(0,49)"," 469,80 "," 56,94 ",2968017254,CFD," 0,00 "
11/03/2025 23:16:51,Overnight fee,Daily,"(0,75)",-,"(0,75)"," 469,05 "," 56,19 ",2968684748,CFD," 0,00 "
12/03/2025 00:55:33,Index price adjustment,NSDQ100/USD," 0,01 ",-," 0,01 "," 469,06 "," 56,20 ",2966623219,CFD," 0,00 "
12/03/2025 00:55:33,Index price adjustment,NSDQ100/USD," 0,01 ",-," 0,01 "," 469,07 "," 56,21 ",2968017254,CFD," 0,00 "
12/03/2025 00:55:33,Index price adjustment,NSDQ100/USD," 0,01 ",-," 0,01 "," 469,08 "," 56,22 ",2968669456,CFD," 0,00 "
12/03/2025 01:01:19,Position closed,NSDQ100/USD," 160,05 ",0.154831," 10,06 "," 479,14 "," 216,27 ",2968684748,CFD," 0,00 "
12/03/2025 01:01:31,Open Position,NSDQ100/USD," 50,00 ",0.051433," 0,00 "," 479,14 "," 166,27 ",2968704743,CFD," 0,00 "
12/03/2025 08:48:40,Position closed,NSDQ100/USD," 52,92 ",0.051433," 2,92 "," 482,06 "," 219,19 ",2968704743,CFD," 0,00 "
12/03/2025 08:48:53,Open Position,NSDQ100/USD," 99,99 ",0.102551," 0,00 "," 482,06 "," 119,20 ",2968866889,CFD," 0,00 "
12/03/2025 10:22:12,Position closed,NSDQ100/USD," 99,24 ",0.102551,"(0,75)"," 481,31 "," 218,44 ",2968866889,CFD," 0,00 "
12/03/2025 10:22:24,Open Position,NSDQ100/USD," 149,99 ",0.153869," 0,00 "," 481,31 "," 68,45 ",2968905003,CFD," 0,00 "
12/03/2025 11:55:04,Position closed,NSDQ100/USD," 143,29 ",0.153869,"(6,70)"," 474,61 "," 211,74 ",2968905003,CFD," 0,00 "
12/03/2025 11:55:11,Position closed,NSDQ100/USD," 51,24 ",0.051246," 1,24 "," 475,85 "," 262,98 ",2968669456,CFD," 0,00 "
12/03/2025 11:55:44,Open Position,NSDQ100/USD," 100,00 ",0.102364," 0,00 "," 475,85 "," 162,98 ",2968929375,CFD," 0,00 "
12/03/2025 12:59:53,Position closed,NSDQ100/USD," 115,22 ",0.102344," 15,24 "," 491,09 "," 278,20 ",2968017254,CFD," 0,00 "
12/03/2025 13:00:04,Position closed,NSDQ100/USD," 119,01 ",0.101939," 6,12 "," 497,21 "," 397,21 ",2966623219,CFD," 0,00 "
12/03/2025 13:00:58,Open Position,NSDQ100/USD," 199,95 ",0.203272," 0,00 "," 497,21 "," 197,26 ",2968960373,CFD," 0,00 "
12/03/2025 13:21:10,Open Position,NSDQ100/USD," 49,99 ",0.050908," 0,00 "," 497,21 "," 147,27 ",2968968122,CFD," 0,00 "
12/03/2025 14:30:20,Position closed,NSDQ100/USD," 52,11 ",0.050908," 2,12 "," 499,33 "," 199,38 ",2968968122,CFD," 0,00 "
12/03/2025 14:30:34,Open Position,NSDQ100/USD," 100,00 ",0.102059," 0,00 "," 499,33 "," 99,38 ",2969230007,CFD," 0,00 "
12/03/2025 14:48:18,Position closed,NSDQ100/USD," 110,75 ",0.102059," 10,75 "," 510,08 "," 210,13 ",2969230007,CFD," 0,00 "
12/03/2025 14:48:28,Position closed,NSDQ100/USD," 104,78 ",0.102364," 4,78 "," 514,86 "," 314,91 ",2968929375,CFD," 0,00 "
12/03/2025 14:48:42,Open Position,NSDQ100/USD," 149,98 ",0.153947," 0,00 "," 514,86 "," 164,93 ",2969261402,CFD," 0,00 "
12/03/2025 15:18:38,Position closed,NSDQ100/USD," 154,91 ",0.153947," 4,93 "," 519,79 "," 319,84 ",2969261402,CFD," 0,00 "
12/03/2025 15:18:49,Open Position,NSDQ100/USD," 99,99 ",0.102796," 0,00 "," 519,79 "," 219,85 ",2969306993,CFD," 0,00 "
12/03/2025 16:37:43,Position closed,NSDQ100/USD," 201,10 ",0.203272," 1,15 "," 520,94 "," 420,95 ",2968960373,CFD," 0,00 "
12/03/2025 16:37:51,Position closed,NSDQ100/USD," 123,07 ",0.102796," 23,08 "," 544,02 "," 544,02 ",2969306993,CFD," 0,00 "
12/03/2025 16:38:42,Open Position,NSDQ100/USD," 60,00 ",0.050788," 0,00 "," 544,02 "," 494,02 ",2969403276,CFD," 0,00 "
12/03/2025 16:38:52,Open Position,NSDQ100/USD," 69,99 ",0.071108," 0,00 "," 544,02 "," 424,03 ",2969403332,CFD," 0,00 "
12/03/2025 16:39:33,Open Position,NSDQ100/USD," 100,00 ",0.101713," 0,00 "," 544,02 "," 324,03 ",2969403898,CFD," 0,00 "
12/03/2025 17:02:32,Position closed,NSDQ100/USD," 75,94 ",0.071108," 5,95 "," 549,97 "," 399,97 ",2969403332,CFD," 0,00 "
12/03/2025 17:02:39,Position closed,NSDQ100/USD," 106,19 ",0.101713," 6,19 "," 556,16 "," 506,16 ",2969403898,CFD," 0,00 "
12/03/2025 17:02:52,Open Position,NSDQ100/USD," 149,98 ",0.153077," 0,00 "," 556,16 "," 356,18 ",2969455415,CFD," 0,00 "
12/03/2025 17:03:00,Open Position,NSDQ100/USD," 59,98 ",0.061218," 0,00 "," 556,16 "," 296,20 ",2969455526,CFD," 0,00 "
12/03/2025 17:23:49,Open Position,NSDQ100/USD," 70,37 ",0.061032," 0,00 "," 556,16 "," 236,20 ",2969470983,CFD," 0,00 "
12/03/2025 18:21:50,Position closed,NSDQ100/USD," 61,24 ",0.061218," 1,26 "," 557,42 "," 297,44 ",2969455526,CFD," 0,00 "
12/03/2025 18:21:57,Position closed,NSDQ100/USD," 152,65 ",0.153077," 2,67 "," 560,09 "," 450,09 ",2969455415,CFD," 0,00 "
12/03/2025 18:22:10,Open Position,NSDQ100/USD," 200,00 ",0.204349," 0,00 "," 560,09 "," 250,09 ",2969521549,CFD," 0,00 "
12/03/2025 20:38:24,Position closed,NSDQ100/USD," 204,80 ",0.204349," 4,80 "," 564,89 "," 454,89 ",2969521549,CFD," 0,00 "
12/03/2025 20:38:36,Open Position,NSDQ100/USD," 100,00 ",0.10231," 0,00 "," 564,89 "," 354,89 ",2969597380,CFD," 0,00 "
12/03/2025 20:47:17,Open Position,NSDQ100/USD," 59,99 ",0.061418," 0,00 "," 564,89 "," 294,90 ",2969597978,CFD," 0,00 "
12/03/2025 23:17:01,Overnight fee,Daily,"(0,02)",-,"(0,02)"," 564,87 "," 294,88 ",2969597978,CFD," 0,00 "
12/03/2025 23:17:01,Overnight fee,Daily,"(0,03)",-,"(0,03)"," 564,84 "," 294,85 ",2969597380,CFD," 0,00 "
12/03/2025 23:17:01,Overnight fee,Daily,"(0,25)",-,"(0,25)"," 564,59 "," 294,60 ",2969403276,CFD," 0,00 "
12/03/2025 23:17:01,Overnight fee,Daily,"(0,29)",-,"(0,29)"," 564,30 "," 294,31 ",2969470983,CFD," 0,00 "
13/03/2025 00:23:24,Open Position,NSDQ100/USD," 92,37 ",0.081451," 0,00 "," 564,30 "," 214,32 ",2969610978,CFD," 0,00 "
13/03/2025 00:27:19,Index price adjustment,NSDQ100/USD," 0,05 ",-," 0,05 "," 564,35 "," 214,37 ",2969403276,CFD," 0,00 "
13/03/2025 00:27:19,Index price adjustment,NSDQ100/USD," 0,06 ",-," 0,06 "," 564,41 "," 214,43 ",2969470983,CFD," 0,00 "
13/03/2025 00:27:19,Index price adjustment,NSDQ100/USD,"(0,19)",-,"(0,19)"," 564,22 "," 214,24 ",2969521549,CFD," 0,00 "
13/03/2025 08:07:01,Position closed,NSDQ100/USD," 114,26 ",0.10231," 14,26 "," 578,48 "," 328,50 ",2969597380,CFD," 0,00 "
13/03/2025 08:07:08,Position closed,NSDQ100/USD," 68,13 ",0.061418," 8,14 "," 586,62 "," 396,63 ",2969597978,CFD," 0,00 "
13/03/2025 08:10:11,Open Position,NSDQ100/USD," 149,97 ",0.154435," 0,00 "," 586,62 "," 246,66 ",2969710413,CFD," 0,00 "
13/03/2025 08:10:22,Open Position,NSDQ100/USD," 59,99 ",0.061754," 0,00 "," 586,62 "," 186,67 ",2969710464,CFD," 0,00 "
13/03/2025 09:41:33,Position closed,NSDQ100/USD," 66,62 ",0.061754," 6,63 "," 593,25 "," 253,29 ",2969710464,CFD," 0,00 "
13/03/2025 09:41:48,Open Position,NSDQ100/USD," 59,99 ",0.061412," 0,00 "," 593,25 "," 193,30 ",2969761002,CFD," 0,00 "
13/03/2025 09:42:04,Open Position,NSDQ100/USD," 49,99 ",0.051192," 0,00 "," 593,25 "," 143,31 ",2969761097,CFD," 0,00 "
13/03/2025 10:25:34,Position closed,NSDQ100/USD," 62,25 ",0.061412," 2,26 "," 595,51 "," 205,56 ",2969761002,CFD," 0,00 "
13/03/2025 10:25:49,Open Position,NSDQ100/USD," 76,48 ",0.071486," 0,00 "," 595,51 "," 135,58 ",2969773398,CFD," 0,00 "
13/03/2025 12:05:03,Position closed,NSDQ100/USD," 52,59 ",0.051192," 2,60 "," 598,11 "," 188,17 ",2969761097,CFD," 0,00 "
13/03/2025 12:05:14,Open Position,NSDQ100/USD," 59,99 ",0.061587," 0,00 "," 598,11 "," 128,18 ",2969798387,CFD," 0,00 "
13/03/2025 14:11:44,Position closed,NSDQ100/USD," 158,18 ",0.154435," 8,21 "," 606,32 "," 286,36 ",2969710413,CFD," 0,00 "
13/03/2025 14:11:51,Position closed,NSDQ100/USD," 67,09 ",0.061587," 7,10 "," 613,42 "," 353,45 ",2969798387,CFD," 0,00 "
13/03/2025 14:13:11,Open Position,NSDQ100/USD," 49,99 ",0.051483," 0,00 "," 613,42 "," 303,46 ",2970012796,CFD," 0,00 "
13/03/2025 14:13:17,Open Position,NSDQ100/USD," 59,99 ",0.061799," 0,00 "," 613,42 "," 243,47 ",2970012939,CFD," 0,00 "
13/03/2025 14:34:55,Position closed,NSDQ100/USD," 51,36 ",0.051483," 1,37 "," 614,79 "," 294,83 ",2970012796,CFD," 0,00 "
13/03/2025 14:35:08,Open Position,NSDQ100/USD," 59,98 ",0.06164," 0,00 "," 614,79 "," 234,85 ",2970048451,CFD," 0,00 "
13/03/2025 16:13:39,Edit Stop Loss,-,"(10,00)",-," 0,00 "," 614,79 "," 224,85 ",2969403276,-," 0,00 "
13/03/2025 16:13:54,Edit Stop Loss,-,"(5,00)",-," 0,00 "," 614,79 "," 219,85 ",2969470983,-," 0,00 "
13/03/2025 16:14:04,Position closed,NSDQ100/USD," 67,71 ",0.061799," 7,72 "," 622,51 "," 287,56 ",2970012939,CFD," 0,00 "
13/03/2025 16:17:08,Edit Stop Loss,-,"(6,50)",-," 0,00 "," 622,51 "," 281,06 ",2969773398,-," 0,00 "
13/03/2025 16:17:20,Edit Stop Loss,-,"(4,24)",-," 0,00 "," 622,51 "," 276,82 ",2969610978,-," 0,00 "
13/03/2025 16:17:27,Edit Stop Loss,-,"(5,37)",-," 0,00 "," 622,51 "," 271,45 ",2969470983,-," 0,00 "
13/03/2025 16:17:54,Open Position,NSDQ100/USD," 70,00 ",0.072611," 0,00 "," 622,51 "," 201,45 ",2970205950,CFD," 0,00 "
13/03/2025 16:18:01,Open Position,NSDQ100/USD," 119,99 ",0.12449," 0,00 "," 622,51 "," 81,46 ",2970205998,CFD," 0,00 "
13/03/2025 16:31:09,Position closed,NSDQ100/USD," 121,50 ",0.12449," 1,51 "," 624,02 "," 202,96 ",2970205998,CFD," 0,00 "
13/03/2025 16:31:21,Open Position,NSDQ100/USD," 99,98 ",0.103583," 0,00 "," 624,02 "," 102,98 ",2970219591,CFD," 0,00 "
13/03/2025 18:02:06,Edit Stop Loss,-,"(8,14)",-," 0,00 "," 624,02 "," 94,84 ",2969610978,-," 0,00 "
13/03/2025 18:02:12,Position closed,NSDQ100/USD," 74,62 ",0.072611," 4,62 "," 628,64 "," 169,46 ",2970205950,CFD," 0,00 "
13/03/2025 18:02:50,Open Position,NSDQ100/USD," 49,99 ",0.052029," 0,00 "," 628,64 "," 119,47 ",2970304515,CFD," 0,00 "
13/03/2025 18:02:54,Open Position,NSDQ100/USD," 49,99 ",0.052042," 0,00 "," 628,64 "," 69,48 ",2970304604,CFD," 0,00 "
13/03/2025 18:41:26,Position closed,NSDQ100/USD," 54,82 ",0.052029," 4,83 "," 633,47 "," 124,30 ",2970304515,CFD," 0,00 "
13/03/2025 19:46:06,Position closed,NSDQ100/USD," 51,79 ",0.052042," 1,80 "," 635,27 "," 176,09 ",2970304604,CFD," 0,00 "
13/03/2025 19:46:22,Open Position,NSDQ100/USD," 74,98 ",0.078154," 0,00 "," 635,27 "," 101,11 ",2970374967,CFD," 0,00 "
13/03/2025 19:47:49,Open Position,NSDQ100/USD," 49,99 ",0.052097," 0,00 "," 635,27 "," 51,12 ",2970375873,CFD," 0,00 "
13/03/2025 22:00:40,Position closed,NSDQ100/USD," 81,54 ",0.078154," 6,56 "," 641,83 "," 132,66 ",2970374967,CFD," 0,00 "
13/03/2025 22:27:46,Open Position,NSDQ100/USD," 99,99 ",0.103679," 0,00 "," 641,83 "," 32,67 ",2970401255,CFD," 0,00 "
13/03/2025 23:17:35,Overnight fee,Daily,"(0,02)",-,"(0,02)"," 641,81 "," 32,65 ",2970375873,CFD," 0,00 "
13/03/2025 23:17:35,Overnight fee,Daily,"(0,25)",-,"(0,25)"," 641,56 "," 32,40 ",2969403276,CFD," 0,00 "
13/03/2025 23:17:35,Overnight fee,Daily,"(0,29)",-,"(0,29)"," 641,27 "," 32,11 ",2969470983,CFD," 0,00 "
13/03/2025 23:17:35,Overnight fee,Daily,"(0,30)",-,"(0,30)"," 640,97 "," 31,81 ",2970048451,CFD," 0,00 "
13/03/2025 23:17:35,Overnight fee,Daily,"(0,35)",-,"(0,35)"," 640,62 "," 31,46 ",2969773398,CFD," 0,00 "
13/03/2025 23:17:35,Overnight fee,Daily,"(0,38)",-,"(0,38)"," 640,24 "," 31,08 ",2970374967,CFD," 0,00 "
13/03/2025 23:17:35,Overnight fee,Daily,"(0,39)",-,"(0,39)"," 639,85 "," 30,69 ",2969610978,CFD," 0,00 "
13/03/2025 23:17:35,Overnight fee,Daily,"(0,50)",-,"(0,50)"," 639,35 "," 30,19 ",2970219591,CFD," 0,00 "
13/03/2025 23:56:17,Position closed,NSDQ100/USD," 103,63 ",0.103583," 3,65 "," 643,00 "," 133,82 ",2970219591,CFD," 0,00 "
13/03/2025 23:56:24,Position closed,NSDQ100/USD," 105,16 ",0.103679," 5,17 "," 648,17 "," 238,98 ",2970401255,CFD," 0,00 "
13/03/2025 23:56:44,Open Position,NSDQ100/USD," 119,99 ",0.124068," 0,00 "," 648,17 "," 118,99 ",2970407509,CFD," 0,00 "
14/03/2025 00:55:16,Index price adjustment,NSDQ100/USD," 0,17 ",-," 0,17 "," 648,34 "," 119,16 ",2969403276,CFD," 0,00 "
14/03/2025 00:55:16,Index price adjustment,NSDQ100/USD," 0,20 ",-," 0,20 "," 648,54 "," 119,36 ",2969470983,CFD," 0,00 "
14/03/2025 00:55:16,Index price adjustment,NSDQ100/USD," 0,27 ",-," 0,27 "," 648,81 "," 119,63 ",2969610978,CFD," 0,00 "
14/03/2025 00:55:16,Index price adjustment,NSDQ100/USD," 0,24 ",-," 0,24 "," 649,05 "," 119,87 ",2969773398,CFD," 0,00 "
14/03/2025 00:55:16,Index price adjustment,NSDQ100/USD," 0,20 ",-," 0,20 "," 649,25 "," 120,07 ",2970048451,CFD," 0,00 "
14/03/2025 00:55:16,Index price adjustment,NSDQ100/USD," 0,34 ",-," 0,34 "," 649,59 "," 120,41 ",2970219591,CFD," 0,00 "
14/03/2025 00:55:16,Index price adjustment,NSDQ100/USD," 0,26 ",-," 0,26 "," 649,85 "," 120,67 ",2970374967,CFD," 0,00 "
14/03/2025 00:55:16,Index price adjustment,NSDQ100/USD,"(0,17)",-,"(0,17)"," 649,68 "," 120,50 ",2970375873,CFD," 0,00 "
14/03/2025 00:59:36,Position closed,NSDQ100/USD," 123,24 ",0.124068," 3,25 "," 652,93 "," 243,74 ",2970407509,CFD," 0,00 "
14/03/2025 00:59:47,Open Position,NSDQ100/USD," 79,99 ",0.082586," 0,00 "," 652,93 "," 163,75 ",2970410402,CFD," 0,00 "
14/03/2025 08:54:11,Position closed,NSDQ100/USD," 82,27 ",0.082586," 2,28 "," 655,21 "," 246,02 ",2970410402,CFD," 0,00 "
14/03/2025 09:31:19,Open Position,SPX500/USD," 99,99 ",0.359436," 0,00 "," 655,21 "," 146,03 ",2970509898,CFD," 0,00 "
14/03/2025 11:59:10,Position closed,SPX500/USD," 102,02 ",0.359436," 2,03 "," 657,24 "," 248,05 ",2970509898,CFD," 0,00 "
14/03/2025 11:59:25,Open Position,NSDQ100/USD," 49,99 ",0.051431," 0,00 "," 657,24 "," 198,06 ",2970564395,CFD," 0,00 "
14/03/2025 11:59:43,Open Position,SPX500/USD," 119,99 ",0.43081," 0,00 "," 657,24 "," 78,07 ",2970564475,CFD," 0,00 "
14/03/2025 12:53:02,Position closed,SPX500/USD," 122,69 ",0.43081," 2,70 "," 659,94 "," 200,76 ",2970564475,CFD," 0,00 "
14/03/2025 12:53:23,Position closed,NSDQ100/USD," 60,79 ",0.06164," 0,81 "," 660,75 "," 261,55 ",2970048451,CFD," 0,00 "
14/03/2025 12:53:58,Open Position,SPX500/USD," 99,99 ",0.358558," 0,00 "," 660,75 "," 161,56 ",2970589422,CFD," 0,00 "
14/03/2025 14:42:48,Position closed,SPX500/USD," 102,98 ",0.358558," 2,99 "," 663,74 "," 264,54 ",2970589422,CFD," 0,00 "
14/03/2025 14:43:20,Open Position,SPX500/USD," 99,98 ",0.357966," 0,00 "," 663,74 "," 164,56 ",2970947768,CFD," 0,00 "
14/03/2025 15:41:21,Position closed,NSDQ100/USD," 25,36 ",0.052097,"(24,63)"," 639,11 "," 189,92 ",2970375873,CFD," 0,00 "
14/03/2025 15:50:38,Position closed,SPX500/USD," 111,90 ",0.357966," 11,92 "," 651,03 "," 301,82 ",2970947768,CFD," 0,00 "
14/03/2025 15:51:51,Position closed,NSDQ100/USD," 79,73 ",0.071486," 3,25 "," 654,28 "," 381,55 ",2969773398,CFD," 0,00 "
14/03/2025 15:52:16,Open Position,NSDQ100/USD," 69,99 ",0.071325," 0,00 "," 654,28 "," 311,56 ",2971142578,CFD," 0,00 "
14/03/2025 16:36:25,Open Position,NSDQ100/USD," 49,99 ",0.050937," 0,00 "," 654,28 "," 261,57 ",2971226363,CFD," 0,00 "
14/03/2025 17:04:04,Position closed,NSDQ100/USD," 92,58 ",0.081451," 0,21 "," 654,49 "," 354,15 ",2969610978,CFD," 0,00 "
14/03/2025 17:04:27,Position closed,NSDQ100/USD," 71,44 ",0.071325," 1,45 "," 655,94 "," 425,59 ",2971142578,CFD," 0,00 "
14/03/2025 17:05:12,Position closed,NSDQ100/USD," 48,83 ",0.050937,"(1,16)"," 654,78 "," 474,42 ",2971226363,CFD," 0,00 "
14/03/2025 17:05:27,Open Position,NSDQ100/USD," 49,99 ",0.050879," 0,00 "," 654,78 "," 424,43 ",2971245534,CFD," 0,00 "
14/03/2025 20:02:55,Position closed,NSDQ100/USD," 49,64 ",0.050879,"(0,35)"," 654,43 "," 474,07 ",2971245534,CFD," 0,00 "
14/03/2025 20:03:14,Position closed,NSDQ100/USD," 69,22 ",0.061032,"(1,15)"," 653,28 "," 543,29 ",2969470983,CFD," 0,00 "
14/03/2025 23:17:42,Overnight fee,Weekend Fee,"(0,05)",-,"(0,05)"," 653,23 "," 543,24 ",2970564395,CFD," 0,00 "
14/03/2025 23:17:42,Overnight fee,Weekend Fee,"(0,74)",-,"(0,74)"," 652,49 "," 542,50 ",2969403276,CFD," 0,00 "
16/03/2025 22:02:16,Open Position,XAU/USD," 199,99 ",1.340307," 0,00 "," 652,49 "," 342,51 ",2971404430,CFD," 0,00 "
17/03/2025 00:22:53,Open Position,NSDQ100/USD," 99,99 ",0.102262," 0,00 "," 652,49 "," 242,52 ",2971415643,CFD," 0,00 "
17/03/2025 00:23:00,Open Position,NSDQ100/USD," 52,96 ",0.051139," 0,00 "," 652,49 "," 192,53 ",2971415651,CFD," 0,00 "
17/03/2025 09:12:43,Position closed,NSDQ100/USD," 102,98 ",0.102262," 2,99 "," 655,48 "," 295,51 ",2971415643,CFD," 0,00 "
17/03/2025 09:13:26,Open Position,NSDQ100/USD," 99,99 ",0.102075," 0,00 "," 655,48 "," 195,52 ",2971553938,CFD," 0,00 "
17/03/2025 09:14:46,Open Position,USD/JPY," 50,00 ",1500," 0,00 "," 655,48 "," 145,52 ",2971554337,CFD," 0,00 "
17/03/2025 09:31:23,Position closed,NSDQ100/USD," 100,70 ",0.102075," 0,71 "," 656,19 "," 246,22 ",2971553938,CFD," 0,00 "
17/03/2025 09:31:32,Open Position,NSDQ100/USD," 150,00 ",0.153027," 0,00 "," 656,19 "," 96,22 ",2971557917,CFD," 0,00 "
17/03/2025 09:32:30,Open Position,XAU/USD," 70,00 ",0.467831," 0,00 "," 656,19 "," 26,22 ",2971558073,CFD," 0,00 "
17/03/2025 11:50:20,Position closed,NSDQ100/USD," 159,16 ",0.153027," 9,16 "," 665,35 "," 185,38 ",2971557917,CFD," 0,00 "
17/03/2025 11:50:33,Open Position,NSDQ100/USD," 99,99 ",0.101715," 0,00 "," 665,35 "," 85,39 ",2971594010,CFD," 0,00 "
17/03/2025 13:19:37,Position closed,XAU/USD," 71,63 ",0.467831," 1,63 "," 666,98 "," 157,02 ",2971558073,CFD," 0,00 "
17/03/2025 13:19:49,Position closed,NSDQ100/USD," 103,47 ",0.101715," 3,48 "," 670,46 "," 260,49 ",2971594010,CFD," 0,00 "
17/03/2025 13:20:05,Position closed,NSDQ100/USD," 60,15 ",0.050788," 0,15 "," 670,61 "," 320,64 ",2969403276,CFD," 0,00 "
17/03/2025 13:20:16,Open Position,NSDQ100/USD," 119,99 ",0.121844," 0,00 "," 670,61 "," 200,65 ",2971623348,CFD," 0,00 "
17/03/2025 14:48:46,Position closed,NSDQ100/USD," 121,65 ",0.121844," 1,66 "," 672,27 "," 322,30 ",2971623348,CFD," 0,00 "
17/03/2025 14:48:58,Open Position,NSDQ100/USD," 150,00 ",0.152069," 0,00 "," 672,27 "," 172,30 ",2972034619,CFD," 0,00 "
17/03/2025 14:49:25,Open Position,XAU/USD," 70,00 ",0.466781," 0,00 "," 672,27 "," 102,30 ",2972035027,CFD," 0,00 "
17/03/2025 18:48:24,Position closed,NSDQ100/USD," 24,93 ",0.051431,"(25,06)"," 647,21 "," 127,23 ",2970564395,CFD," 0,00 "
17/03/2025 19:04:59,Position closed,NSDQ100/USD," 176,16 ",0.152069," 26,16 "," 673,37 "," 303,39 ",2972034619,CFD," 0,00 "
17/03/2025 19:05:12,Position closed,USD/JPY," 52,75 ",1500," 2,75 "," 676,12 "," 356,14 ",2971554337,CFD," 0,00 "
17/03/2025 19:06:25,Edit Stop Loss,-,"(2,97)",-," 0,00 "," 676,12 "," 353,17 ",2971415651,-," 0,00 "
17/03/2025 19:06:39,Open Position,NSDQ100/USD," 119,99 ",0.120504," 0,00 "," 676,12 "," 233,18 ",2972291087,CFD," 0,00 "
17/03/2025 19:25:04,Open Position,XAU/USD," 50,00 ",0.333395," 0,00 "," 676,12 "," 183,18 ",2972305232,CFD," 0,00 "
17/03/2025 19:44:26,Open Position,NSDQ100/USD," 49,99 ",0.050266," 0,00 "," 676,12 "," 133,19 ",2972314456,CFD," 0,00 "
17/03/2025 20:20:04,Position closed,NSDQ100/USD," 54,74 ",0.050266," 4,75 "," 680,87 "," 187,93 ",2972314456,CFD," 0,00 "
17/03/2025 20:20:17,Open Position,NSDQ100/USD," 54,99 ",0.055567," 0,00 "," 680,87 "," 132,94 ",2972329358,CFD," 0,00 "
17/03/2025 20:22:11,Open Position,NSDQ100/USD," 50,00 ",0.050507," 0,00 "," 680,87 "," 82,94 ",2972329528,CFD," 0,00 "
17/03/2025 23:16:54,Overnight refund,Daily," 0,03 ",-," 0,03 "," 680,90 "," 82,97 ",2971404430,CFD," 0,00 "
17/03/2025 23:16:54,Overnight refund,Daily," 0,01 ",-," 0,01 "," 680,91 "," 82,98 ",2972305232,CFD," 0,00 "
17/03/2025 23:16:54,Overnight refund,Daily," 0,01 ",-," 0,01 "," 680,92 "," 82,99 ",2972035027,CFD," 0,00 "
17/03/2025 23:16:54,Overnight fee,Daily,"(0,02)",-,"(0,02)"," 680,90 "," 82,97 ",2971415651,CFD," 0,00 "
17/03/2025 23:16:54,Overnight fee,Daily,"(0,02)",-,"(0,02)"," 680,88 "," 82,95 ",2972329358,CFD," 0,00 "
17/03/2025 23:16:54,Overnight fee,Daily,"(0,24)",-,"(0,24)"," 680,64 "," 82,71 ",2972329528,CFD," 0,00 "
17/03/2025 23:16:54,Overnight fee,Daily,"(0,57)",-,"(0,57)"," 680,07 "," 82,14 ",2972291087,CFD," 0,00 "
18/03/2025 00:17:15,Index price adjustment,NSDQ100/USD,"(0,01)",-,"(0,01)"," 680,06 "," 82,13 ",2971415651,CFD," 0,00 "
18/03/2025 00:17:15,Index price adjustment,NSDQ100/USD," 0,02 ",-," 0,02 "," 680,08 "," 82,15 ",2972291087,CFD," 0,00 "
18/03/2025 00:17:15,Index price adjustment,NSDQ100/USD,"(0,01)",-,"(0,01)"," 680,07 "," 82,14 ",2972314456,CFD," 0,00 "
18/03/2025 03:02:51,Position closed,NSDQ100/USD," 57,74 ",0.055567," 2,75 "," 682,82 "," 139,88 ",2972329358,CFD," 0,00 "
18/03/2025 03:08:40,Open Position,NSDQ100/USD," 50,00 ",0.050685," 0,00 "," 682,82 "," 89,88 ",2972359893,CFD," 0,00 "
18/03/2025 04:13:39,Open Position,NSDQ100/USD," 59,98 ",0.06083," 0,00 "," 682,82 "," 29,90 ",2972362531,CFD," 0,00 "
18/03/2025 08:52:20,Position closed,NSDQ100/USD," 52,73 ",0.050685," 2,73 "," 685,55 "," 82,63 ",2972359893,CFD," 0,00 "
18/03/2025 08:52:32,Open Position,NSDQ100/USD," 60,00 ",0.060647," 0,00 "," 685,55 "," 22,63 ",2972451600,CFD," 0,00 "
18/03/2025 13:30:54,Position closed,NSDQ100/USD," 64,87 ",0.06083," 4,89 "," 690,44 "," 87,50 ",2972362531,CFD," 0,00 "
18/03/2025 13:32:58,Open Position,NSDQ100/USD," 50,00 ",0.050902," 0,00 "," 690,44 "," 37,50 ",2972614122,CFD," 0,00 "
18/03/2025 14:00:08,Position closed,NSDQ100/USD," 59,60 ",0.120504,"(60,39)"," 630,05 "," 97,10 ",2972291087,CFD," 0,00 "
18/03/2025 17:46:57,Position closed,NSDQ100/USD," 55,60 ",0.051139," 2,64 "," 632,69 "," 152,70 ",2971415651,CFD," 0,00 "
18/03/2025 17:51:14,Open Position,NSDQ100/USD," 99,99 ",0.10249," 0,00 "," 632,69 "," 52,71 ",2972979204,CFD," 0,00 "
18/03/2025 18:05:52,Open Position,NSDQ100/USD," 49,99 ",0.051423," 0,00 "," 632,69 "," 2,72 ",2972985994,CFD," 0,00 "
18/03/2025 23:16:56,Overnight fee,Daily,"(0,24)",-,"(0,24)"," 632,45 "," 2,48 ",2972329528,CFD," 0,00 "
18/03/2025 23:16:56,Overnight fee,Daily,"(0,29)",-,"(0,29)"," 632,16 "," 2,19 ",2972451600,CFD," 0,00 "
18/03/2025 23:16:56,Overnight fee,Daily,"(0,48)",-,"(0,48)"," 631,68 "," 1,71 ",2972979204,CFD," 0,00 "
18/03/2025 23:16:56,Overnight refund,Daily," 0,03 ",-," 0,03 "," 631,71 "," 1,74 ",2971404430,CFD," 0,00 "
18/03/2025 23:16:56,Overnight refund,Daily," 0,01 ",-," 0,01 "," 631,72 "," 1,75 ",2972305232,CFD," 0,00 "
18/03/2025 23:16:56,Overnight refund,Daily," 0,01 ",-," 0,01 "," 631,73 "," 1,76 ",2972035027,CFD," 0,00 "
18/03/2025 23:16:56,Overnight fee,Daily,"(0,02)",-,"(0,02)"," 631,71 "," 1,74 ",2972985994,CFD," 0,00 "
18/03/2025 23:16:56,Overnight fee,Daily,"(0,24)",-,"(0,24)"," 631,47 "," 1,50 ",2972614122,CFD," 0,00 "
19/03/2025 01:00:22,Index price adjustment,NSDQ100/USD," 0,02 ",-," 0,02 "," 631,49 "," 1,52 ",2972329528,CFD," 0,00 "
19/03/2025 01:00:22,Index price adjustment,NSDQ100/USD," 0,02 ",-," 0,02 "," 631,51 "," 1,54 ",2972451600,CFD," 0,00 "
19/03/2025 01:00:22,Index price adjustment,NSDQ100/USD," 0,02 ",-," 0,02 "," 631,53 "," 1,56 ",2972614122,CFD," 0,00 "
19/03/2025 01:00:22,Index price adjustment,NSDQ100/USD," 0,04 ",-," 0,04 "," 631,57 "," 1,60 ",2972979204,CFD," 0,00 "
19/03/2025 01:00:22,Index price adjustment,NSDQ100/USD,"(0,02)",-,"(0,02)"," 631,55 "," 1,58 ",2972985994,CFD," 0,00 "
19/03/2025 08:35:59,Position closed,NSDQ100/USD," 100,31 ",0.10249," 0,32 "," 631,87 "," 101,89 ",2972979204,CFD," 0,00 "
19/03/2025 08:41:25,Open Position,XAU/USD," 49,99 ",0.330041," 0,00 "," 631,87 "," 51,90 ",2973271796,CFD," 0,00 "
19/03/2025 09:25:57,Open Position,NSDQ100/USD," 49,99 ",0.051255," 0,00 "," 631,87 "," 1,91 ",2973285051,CFD," 0,00 "
19/03/2025 11:02:33,Position closed,XAU/USD," 51,33 ",0.330041," 1,34 "," 633,21 "," 53,24 ",2973271796,CFD," 0,00 "
19/03/2025 11:02:42,Open Position,XAU/USD," 49,99 ",0.329504," 0,00 "," 633,21 "," 3,25 ",2973309936,CFD," 0,00 "
19/03/2025 16:02:03,Position closed,NSDQ100/USD," 52,08 ",0.050902," 2,08 "," 635,29 "," 55,33 ",2972614122,CFD," 0,00 "
19/03/2025 16:55:44,Open Position,NSDQ100/USD," 49,99 ",0.050873," 0,00 "," 635,29 "," 5,34 ",2973655066,CFD," 0,00 "
19/03/2025 18:00:06,Position closed,XAU/USD," 48,55 ",0.329504,"(1,44)"," 633,85 "," 53,89 ",2973309936,CFD," 0,00 "
19/03/2025 18:01:37,Open Position,NSDQ100/USD," 49,99 ",0.050922," 0,00 "," 633,85 "," 3,90 ",2973685259,CFD," 0,00 "
19/03/2025 18:02:50,Position closed,NSDQ100/USD," 51,44 ",0.050873," 1,45 "," 635,30 "," 55,34 ",2973655066,CFD," 0,00 "
19/03/2025 18:05:41,Position closed,NSDQ100/USD," 51,45 ",0.050922," 1,46 "," 636,76 "," 106,79 ",2973685259,CFD," 0,00 "
19/03/2025 18:06:25,Open Position,NSDQ100/USD," 50,00 ",0.051001," 0,00 "," 636,76 "," 56,79 ",2973688526,CFD," 0,00 "
19/03/2025 18:06:39,Open Position,NSDQ100/USD," 49,99 ",0.051014," 0,00 "," 636,76 "," 6,80 ",2973688639,CFD," 0,00 "
19/03/2025 18:09:17,Position closed,NSDQ100/USD," 51,41 ",0.051001," 1,41 "," 638,17 "," 58,21 ",2973688526,CFD," 0,00 "
19/03/2025 18:09:42,Open Position,NSDQ100/USD," 49,99 ",0.05091," 0,00 "," 638,17 "," 8,22 ",2973690574,CFD," 0,00 "
19/03/2025 18:14:05,Position closed,NSDQ100/USD," 51,21 ",0.05091," 1,22 "," 639,39 "," 59,43 ",2973690574,CFD," 0,00 "
19/03/2025 18:15:01,Open Position,XAU/USD," 50,00 ",0.329144," 0,00 "," 639,39 "," 9,43 ",2973694200,CFD," 0,00 "
19/03/2025 18:34:05,Position closed,XAU/USD," 49,48 ",0.329144,"(0,52)"," 638,87 "," 58,91 ",2973694200,CFD," 0,00 "
19/03/2025 18:34:16,Open Position,NSDQ100/USD," 49,98 ",0.050727," 0,00 "," 638,87 "," 8,93 ",2973706981,CFD," 0,00 "
19/03/2025 18:57:39,Position closed,NSDQ100/USD," 60,76 ",0.060647," 0,76 "," 639,63 "," 69,69 ",2972451600,CFD," 0,00 "
19/03/2025 18:58:30,Position closed,NSDQ100/USD," 49,94 ",0.050507,"(0,06)"," 639,57 "," 119,63 ",2972329528,CFD," 0,00 "
19/03/2025 18:58:51,Open Position,NSDQ100/USD," 49,99 ",0.050518," 0,00 "," 639,57 "," 69,64 ",2973725160,CFD," 0,00 "
19/03/2025 18:59:22,Open Position,XAU/USD," 49,99 ",0.328285," 0,00 "," 639,57 "," 19,65 ",2973725729,CFD," 0,00 "
19/03/2025 19:15:24,Position closed,XAU/USD," 49,52 ",0.328285,"(0,47)"," 639,10 "," 69,17 ",2973725729,CFD," 0,00 "
19/03/2025 19:15:39,Open Position,NSDQ100/USD," 65,49 ",0.060338," 0,00 "," 639,10 "," 9,17 ",2973774058,CFD," 0,00 "
19/03/2025 20:10:15,Position closed,NSDQ100/USD," 51,79 ",0.050518," 1,80 "," 640,90 "," 60,96 ",2973725160,CFD," 0,00 "
19/03/2025 20:12:03,Open Position,NSDQ100/USD," 50,00 ",0.050608," 0,00 "," 640,90 "," 10,96 ",2973825440,CFD," 0,00 "
19/03/2025 23:02:18,Position closed,NSDQ100/USD," 51,66 ",0.050608," 1,66 "," 642,56 "," 62,62 ",2973825440,CFD," 0,00 "
19/03/2025 23:02:48,Open Position,NSDQ100/USD," 59,98 ",0.060613," 0,00 "," 642,56 "," 2,64 ",2973837125,CFD," 0,00 "
19/03/2025 23:18:03,Weekend refund,Weekend Fee," 0,08 ",-," 0,08 "," 642,64 "," 2,72 ",2971404430,CFD," 0,00 "
19/03/2025 23:18:03,Weekend refund,Weekend Fee," 0,03 ",-," 0,03 "," 642,67 "," 2,75 ",2972035027,CFD," 0,00 "
19/03/2025 23:18:03,Weekend refund,Weekend Fee," 0,02 ",-," 0,02 "," 642,69 "," 2,77 ",2972305232,CFD," 0,00 "
19/03/2025 23:18:03,Overnight fee,Daily,"(0,02)",-,"(0,02)"," 642,67 "," 2,75 ",2973706981,CFD," 0,00 "
19/03/2025 23:18:03,Overnight fee,Daily,"(0,02)",-,"(0,02)"," 642,65 "," 2,73 ",2972985994,CFD," 0,00 "
19/03/2025 23:18:03,Overnight fee,Daily,"(0,02)",-,"(0,02)"," 642,63 "," 2,71 ",2973688639,CFD," 0,00 "
19/03/2025 23:18:03,Overnight fee,Daily,"(0,02)",-,"(0,02)"," 642,61 "," 2,69 ",2973285051,CFD," 0,00 "
19/03/2025 23:18:03,Overnight fee,Daily,"(0,24)",-,"(0,24)"," 642,37 "," 2,45 ",2973825440,CFD," 0,00 "
19/03/2025 23:18:03,Overnight fee,Daily,"(0,28)",-,"(0,28)"," 642,09 "," 2,17 ",2973774058,CFD," 0,00 "
20/03/2025 00:19:33,Index price adjustment,NSDQ100/USD,"(0,13)",-,"(0,13)"," 641,96 "," 2,04 ",2972985994,CFD," 0,00 "
20/03/2025 00:19:33,Index price adjustment,NSDQ100/USD,"(0,13)",-,"(0,13)"," 641,83 "," 1,91 ",2973285051,CFD," 0,00 "
20/03/2025 00:19:33,Index price adjustment,NSDQ100/USD,"(0,13)",-,"(0,13)"," 641,70 "," 1,78 ",2973688639,CFD," 0,00 "
20/03/2025 00:19:33,Index price adjustment,NSDQ100/USD,"(0,13)",-,"(0,13)"," 641,57 "," 1,65 ",2973706981,CFD," 0,00 "
20/03/2025 00:19:33,Index price adjustment,NSDQ100/USD,"(0,12)",-,"(0,12)"," 641,45 "," 1,53 ",2973725160,CFD," 0,00 "
20/03/2025 00:19:33,Index price adjustment,NSDQ100/USD," 0,15 ",-," 0,15 "," 641,60 "," 1,68 ",2973774058,CFD," 0,00 "
20/03/2025 07:02:12,Position closed,NSDQ100/USD," 63,05 ",0.060613," 3,07 "," 644,67 "," 64,73 ",2973837125,CFD," 0,00 "
20/03/2025 07:06:32,Open Position,NSDQ100/USD," 62,90 ",0.060471," 0,00 "," 644,67 "," 4,73 ",2973896732,CFD," 0,00 "
20/03/2025 07:10:35,Position closed,XAU/USD," 115,46 ",1.340307,"(84,53)"," 560,14 "," 120,19 ",2971404430,CFD," 0,00 "
20/03/2025 07:10:49,Open Position,NSDQ100/USD," 106,01 ",0.100717," 0,00 "," 560,14 "," 20,20 ",2973897258,CFD," 0,00 "
20/03/2025 10:30:41,Position closed,NSDQ100/USD," 57,68 ",0.050727," 7,70 "," 567,84 "," 77,88 ",2973706981,CFD," 0,00 "
20/03/2025 10:30:51,Position closed,NSDQ100/USD," 52,45 ",0.051014," 2,46 "," 570,30 "," 130,33 ",2973688639,CFD," 0,00 "
20/03/2025 10:32:04,Open Position,XAU/USD," 49,99 ",0.33031," 0,00 "," 570,30 "," 80,34 ",2974000668,CFD," 0,00 "
20/03/2025 10:32:32,Open Position,NSDQ100/USD," 49,99 ",0.051089," 0,00 "," 570,30 "," 30,35 ",2974000887,CFD," 0,00 "
20/03/2025 10:40:31,Edit Stop Loss,-,"(5,49)",-," 0,00 "," 570,30 "," 24,86 ",2973774058,-," 0,00 "
20/03/2025 10:40:41,Edit Stop Loss,-,"(6,02)",-," 0,00 "," 570,30 "," 18,84 ",2973897258,-," 0,00 "
20/03/2025 10:40:58,Edit Stop Loss,-,"(2,90)",-," 0,00 "," 570,30 "," 15,94 ",2973896732,-," 0,00 "
20/03/2025 11:14:32,Position closed,NSDQ100/USD," 51,85 ",0.051089," 1,86 "," 572,16 "," 67,79 ",2974000887,CFD," 0,00 "
20/03/2025 11:14:40,Open Position,NSDQ100/USD," 50,00 ",0.050994," 0,00 "," 572,16 "," 17,79 ",2974016621,CFD," 0,00 "
20/03/2025 11:14:50,Position closed,XAU/USD," 51,19 ",0.33031," 1,20 "," 573,36 "," 68,98 ",2974000668,CFD," 0,00 "
20/03/2025 11:14:55,Open Position,XAU/USD," 49,99 ",0.329828," 0,00 "," 573,36 "," 18,99 ",2974016688,CFD," 0,00 "
20/03/2025 11:57:06,Position closed,NSDQ100/USD," 50,92 ",0.050994," 0,92 "," 574,28 "," 69,91 ",2974016621,CFD," 0,00 "
20/03/2025 11:57:12,Open Position,NSDQ100/USD," 50,00 ",0.05094," 0,00 "," 574,28 "," 19,91 ",2974032000,CFD," 0,00 "
20/03/2025 12:10:07,Position closed,XAU/USD," 51,12 ",0.329828," 1,13 "," 575,41 "," 71,03 ",2974016688,CFD," 0,00 "
20/03/2025 15:05:01,Position closed,NSDQ100/USD," 58,95 ",0.05094," 8,95 "," 584,36 "," 129,98 ",2974032000,CFD," 0,00 "
20/03/2025 15:29:43,Open Position,NSDQ100/USD," 59,99 ",0.060534," 0,00 "," 584,36 "," 69,99 ",2974381538,CFD," 0,00 "
20/03/2025 16:31:22,Open Position,NSDQ100/USD," 50,00 ",0.050824," 0,00 "," 584,36 "," 19,99 ",2974426030,CFD," 0,00 "
20/03/2025 20:45:20,Position closed,NSDQ100/USD," 50,51 ",0.050824," 0,51 "," 584,87 "," 70,50 ",2974426030,CFD," 0,00 "
20/03/2025 22:40:55,Open Position,NSDQ100/USD," 50,00 ",0.050757," 0,00 "," 584,87 "," 20,50 ",2974535456,CFD," 0,00 "
20/03/2025 23:17:01,Overnight refund,Daily," 0,01 ",-," 0,01 "," 584,88 "," 20,51 ",2972035027,CFD," 0,00 "
20/03/2025 23:17:01,Overnight refund,Daily," 0,01 ",-," 0,01 "," 584,89 "," 20,52 ",2972305232,CFD," 0,00 "
20/03/2025 23:17:01,Overnight fee,Daily,"(0,02)",-,"(0,02)"," 584,87 "," 20,50 ",2972985994,CFD," 0,00 "
20/03/2025 23:17:01,Overnight fee,Daily,"(0,02)",-,"(0,02)"," 584,85 "," 20,48 ",2973285051,CFD," 0,00 "
20/03/2025 23:17:01,Overnight fee,Daily,"(0,28)",-,"(0,28)"," 584,57 "," 20,20 ",2973774058,CFD," 0,00 "
20/03/2025 23:17:01,Overnight fee,Daily,"(0,29)",-,"(0,29)"," 584,28 "," 19,91 ",2974381538,CFD," 0,00 "
20/03/2025 23:17:01,Overnight fee,Daily,"(0,29)",-,"(0,29)"," 583,99 "," 19,62 ",2973896732,CFD," 0,00 "
20/03/2025 23:17:01,Overnight fee,Daily,"(0,48)",-,"(0,48)"," 583,51 "," 19,14 ",2973897258,CFD," 0,00 "
21/03/2025 13:37:58,Position closed,NSDQ100/USD," 50,71 ",0.051423," 0,72 "," 584,23 "," 69,85 ",2972985994,CFD," 0,00 "
21/03/2025 13:38:38,Position closed,NSDQ100/USD," 53,55 ",0.051255," 3,56 "," 587,79 "," 123,40 ",2973285051,CFD," 0,00 "
21/03/2025 13:41:12,Open Position,XAU/USD," 49,99 ",0.331169," 0,00 "," 587,79 "," 73,41 ",2974801058,CFD," 0,00 "
21/03/2025 13:41:25,Open Position,NSDQ100/USD," 49,99 ",0.051363," 0,00 "," 587,79 "," 23,42 ",2974801512,CFD," 0,00 "
21/03/2025 13:43:26,Position closed,XAU/USD," 48,90 ",0.331169,"(1,09)"," 586,70 "," 72,32 ",2974801058,CFD," 0,00 "
21/03/2025 13:43:39,Position closed,NSDQ100/USD," 50,91 ",0.051363," 0,92 "," 587,62 "," 123,23 ",2974801512,CFD," 0,00 "
21/03/2025 13:43:49,Open Position,NSDQ100/USD," 50,00 ",0.051322," 0,00 "," 587,62 "," 73,23 ",2974809726,CFD," 0,00 "
21/03/2025 13:57:41,Position closed,XAU/USD," 47,18 ",0.333395,"(2,82)"," 584,80 "," 120,41 ",2972305232,CFD," 0,00 "
21/03/2025 13:57:49,Position closed,NSDQ100/USD," 52,34 ",0.051322," 2,34 "," 587,14 "," 172,75 ",2974809726,CFD," 0,00 "
21/03/2025 13:58:04,Open Position,NSDQ100/USD," 69,98 ",0.071646," 0,00 "," 587,14 "," 102,77 ",2974931664,CFD," 0,00 "
21/03/2025 13:58:18,Position closed,XAU/USD," 66,91 ",0.466781,"(3,09)"," 584,05 "," 169,68 ",2972035027,CFD," 0,00 "
21/03/2025 13:58:33,Open Position,NSDQ100/USD," 50,00 ",0.051153," 0,00 "," 584,05 "," 119,68 ",2974932012,CFD," 0,00 "
21/03/2025 16:53:14,Position closed,NSDQ100/USD," 55,34 ",0.051153," 5,34 "," 589,39 "," 175,02 ",2974932012,CFD," 0,00 "
21/03/2025 16:53:26,Position closed,NSDQ100/USD," 78,22 ",0.071646," 8,24 "," 597,63 "," 253,24 ",2974931664,CFD," 0,00 "
21/03/2025 16:53:44,Open Position,NSDQ100/USD," 49,99 ",0.050874," 0,00 "," 597,63 "," 203,25 ",2975111383,CFD," 0,00 "
21/03/2025 19:47:58,Position closed,NSDQ100/USD," 49,93 ",0.050874,"(0,06)"," 597,57 "," 253,18 ",2975111383,CFD," 0,00 "
21/03/2025 20:02:15,Position closed,NSDQ100/USD," 52,90 ",0.050757," 2,90 "," 600,47 "," 306,08 ",2974535456,CFD," 0,00 "
21/03/2025 23:17:05,Overnight fee,Weekend Fee,"(0,85)",-,"(0,85)"," 599,62 "," 305,23 ",2973774058,CFD," 0,00 "
21/03/2025 23:17:05,Overnight fee,Weekend Fee,"(0,86)",-,"(0,86)"," 598,76 "," 304,37 ",2973896732,CFD," 0,00 "
21/03/2025 23:17:05,Overnight fee,Weekend Fee,"(0,86)",-,"(0,86)"," 597,90 "," 303,51 ",2974381538,CFD," 0,00 "
21/03/2025 23:17:05,Overnight fee,Weekend Fee,"(1,43)",-,"(1,43)"," 596,47 "," 302,08 ",2973897258,CFD," 0,00 "