Date,Type,Details,Amount,Units / Contracts,Realized Equity Change,Realized Equity,Balance,Position ID,Asset type,NWA
01/06/2025 22:46:46,Open Position,NSDQ100/USD," 150,00 ",0.140978," 0,00 "," 1.543,45 "," 838,35 ",3031374881,CFD," 0,00 "
01/06/2025 23:27:08,Position closed,NSDQ100/USD," 147,21 ",0.140978,"(2,79)"," 1.540,66 "," 985,56 ",3031374881,CFD," 0,00 "
02/06/2025 07:08:55,Open Position,NSDQ100/USD," 150,00 ",0.141403," 0,00 "," 1.540,66 "," 835,56 ",3031483370,CFD," 0,00 "
02/06/2025 11:27:14,Position closed,NSDQ100/USD," 151,09 ",0.141403," 1,09 "," 1.541,75 "," 986,65 ",3031483370,CFD," 0,00 "
02/06/2025 11:33:35,Open Position,NSDQ100/USD," 101,98 ",0.096028," 0,00 "," 1.541,75 "," 884,67 ",3031614493,CFD," 0,00 "
02/06/2025 13:38:33,Position closed,NSDQ100/USD," 117,35 ",0.096028," 15,37 "," 1.557,12 "," 1.002,02 ",3031614493,CFD," 0,00 "
02/06/2025 13:54:11,Open Position,NSDQ100/USD," 129,98 ",0.12219," 0,00 "," 1.557,12 "," 872,04 ",3031979404,CFD," 0,00 "
02/06/2025 14:23:07,Position closed,NSDQ100/USD," 135,33 ",0.12219," 5,35 "," 1.562,47 "," 1.007,37 ",3031979404,CFD," 0,00 "
02/06/2025 14:23:54,Open Position,NSDQ100/USD," 119,98 ",0.112547," 0,00 "," 1.562,47 "," 887,39 ",3032072603,CFD," 0,00 "
02/06/2025 14:51:27,Position closed,NSDQ100/USD," 121,15 ",0.112547," 1,17 "," 1.563,64 "," 1.008,54 ",3032072603,CFD," 0,00 "
02/06/2025 15:35:08,Open Position,NSDQ100/USD," 119,99 ",0.112564," 0,00 "," 1.563,64 "," 888,55 ",3032475365,CFD," 0,00 "
02/06/2025 15:46:17,Position closed,NSDQ100/USD," 124,44 ",0.112564," 4,45 "," 1.568,09 "," 1.012,99 ",3032475365,CFD," 0,00 "
02/06/2025 15:55:04,Position closed,NSDQ100/USD," 107,52 ",0.095114,"(5,12)"," 1.562,97 "," 1.120,51 ",3030311440,CFD," 0,00 "
02/06/2025 15:56:26,Position closed,NSDQ100/USD," 89,23 ",0.07883,"(7,97)"," 1.555,00 "," 1.209,74 ",3032490749,CFD," 0,00 "
02/06/2025 17:14:56,Position closed,NSDQ100/USD," 80,38 ",0.070042,"(5,98)"," 1.549,02 "," 1.290,12 ",3030110749,CFD," 0,00 "
02/06/2025 17:17:29,Open Position,NSDQ100/USD," 129,99 ",0.12142," 0,00 "," 1.549,02 "," 1.160,13 ",3032554355,CFD," 0,00 "
02/06/2025 17:19:59,Open Position,NSDQ100/USD," 120,00 ",0.112077," 0,00 "," 1.549,02 "," 1.040,13 ",3032555739,CFD," 0,00 "
02/06/2025 17:42:12,Position closed,NSDQ100/USD," 120,96 ",0.112077," 0,96 "," 1.549,98 "," 1.161,09 ",3032555739,CFD," 0,00 "
02/06/2025 17:43:17,Open Position,NSDQ100/USD," 101,00 ",0.094389," 0,00 "," 1.549,98 "," 1.060,09 ",3032574217,CFD," 0,00 "
02/06/2025 18:19:10,Position closed,NSDQ100/USD," 134,65 ",0.12142," 4,66 "," 1.554,64 "," 1.194,74 ",3032554355,CFD," 0,00 "
02/06/2025 18:44:51,Open Position,NSDQ100/USD," 119,99 ",0.111812," 0,00 "," 1.554,64 "," 1.074,75 ",3032610719,CFD," 0,00 "
02/06/2025 19:07:21,Position closed,NSDQ100/USD," 121,20 ",0.111812," 1,21 "," 1.555,85 "," 1.195,95 ",3032610719,CFD," 0,00 "
02/06/2025 19:08:44,Open Position,NSDQ100/USD," 101,99 ",0.09499," 0,00 "," 1.555,85 "," 1.093,96 ",3032627200,CFD," 0,00 "
02/06/2025 19:25:07,Position closed,NSDQ100/USD," 103,49 ",0.09499," 1,50 "," 1.557,35 "," 1.197,45 ",3032627200,CFD," 0,00 "
02/06/2025 19:25:21,Open Position,NSDQ100/USD," 101,99 ",0.094905," 0,00 "," 1.557,35 "," 1.095,46 ",3032642705,CFD," 0,00 "
02/06/2025 19:58:51,Position closed,NSDQ100/USD," 115,35 ",0.094297,"(14,06)"," 1.543,29 "," 1.210,81 ",3029750363,CFD," 0,00 "
02/06/2025 20:29:50,Position closed,NSDQ100/USD," 119,00 ",0.0943,"(10,49)"," 1.532,80 "," 1.329,81 ",3029733264,CFD," 0,00 "
02/06/2025 20:29:58,Position closed,NSDQ100/USD," 104,41 ",0.094905," 2,42 "," 1.535,22 "," 1.434,22 ",3032642705,CFD," 0,00 "
02/06/2025 20:30:09,Open Position,NSDQ100/USD," 124,99 ",0.116152," 0,00 "," 1.535,22 "," 1.309,23 ",3032667991,CFD," 0,00 "
02/06/2025 20:39:29,Open Position,NSDQ100/USD," 64,98 ",0.060409," 0,00 "," 1.535,22 "," 1.244,25 ",3032669023,CFD," 0,00 "
02/06/2025 20:42:55,Position closed,NSDQ100/USD," 89,57 ",0.094389,"(11,43)"," 1.523,79 "," 1.333,82 ",3032574217,CFD," 0,00 "
02/06/2025 23:11:00,Overnight fee,Daily,"(0,31)",-,"(0,31)"," 1.523,48 "," 1.333,51 ",3032669023,CFD," 0,00 "
02/06/2025 23:11:00,Overnight fee,Daily,"(0,60)",-,"(0,60)"," 1.522,88 "," 1.332,91 ",3032667991,CFD," 0,00 "
03/06/2025 07:23:34,Open Position,NSDQ100/USD," 150,00 ",0.140326," 0,00 "," 1.522,88 "," 1.182,91 ",3032774887,CFD," 0,00 "
03/06/2025 09:12:22,Position closed,NSDQ100/USD," 153,51 ",0.140326," 3,51 "," 1.526,39 "," 1.336,42 ",3032774887,CFD," 0,00 "
03/06/2025 09:12:33,Open Position,NSDQ100/USD," 155,00 ",0.14479," 0,00 "," 1.526,39 "," 1.181,42 ",3032822898,CFD," 0,00 "
03/06/2025 10:43:40,Position closed,NSDQ100/USD," 158,11 ",0.14479," 3,11 "," 1.529,50 "," 1.339,53 ",3032822898,CFD," 0,00 "
03/06/2025 10:45:10,Open Position,NSDQ100/USD," 150,00 ",0.139964," 0,00 "," 1.529,50 "," 1.189,53 ",3032845178,CFD," 0,00 "
03/06/2025 11:40:43,Position closed,NSDQ100/USD," 157,00 ",0.139964," 7,00 "," 1.536,50 "," 1.346,53 ",3032845178,CFD," 0,00 "
03/06/2025 11:55:25,Open Position,NSDQ100/USD," 101,99 ",0.094928," 0,00 "," 1.536,50 "," 1.244,54 ",3032861080,CFD," 0,00 "
03/06/2025 13:00:22,Position closed,NSDQ100/USD," 101,86 ",0.094928,"(0,13)"," 1.536,37 "," 1.346,40 ",3032861080,CFD," 0,00 "
03/06/2025 13:05:57,Position closed,NSDQ100/USD," 64,12 ",0.060409,"(0,86)"," 1.535,51 "," 1.410,52 ",3032669023,CFD," 0,00 "
03/06/2025 13:40:51,Open Position,NSDQ100/USD," 101,99 ",0.094912," 0,00 "," 1.535,51 "," 1.308,53 ",3032996042,CFD," 0,00 "
03/06/2025 13:41:15,Position closed,NSDQ100/USD," 103,07 ",0.094912," 1,08 "," 1.536,59 "," 1.411,60 ",3032996042,CFD," 0,00 "
03/06/2025 13:41:21,Open Position,NSDQ100/USD," 100,98 ",0.093903," 0,00 "," 1.536,59 "," 1.310,62 ",3032996953,CFD," 0,00 "
03/06/2025 13:52:15,Position closed,NSDQ100/USD," 103,69 ",0.093903," 2,71 "," 1.539,30 "," 1.414,31 ",3032996953,CFD," 0,00 "
03/06/2025 13:52:15,Position closed,NSDQ100/USD," 126,75 ",0.116152," 1,76 "," 1.541,06 "," 1.541,06 ",3032667991,CFD," 0,00 "
03/06/2025 13:52:29,Open Position,NSDQ100/USD," 150,00 ",0.139235," 0,00 "," 1.541,06 "," 1.391,06 ",3033108262,CFD," 0,00 "
03/06/2025 14:02:25,Position closed,NSDQ100/USD," 154,41 ",0.139235," 4,41 "," 1.545,47 "," 1.545,47 ",3033108262,CFD," 0,00 "
03/06/2025 14:02:34,Open Position,NSDQ100/USD," 160,00 ",0.148192," 0,00 "," 1.545,47 "," 1.385,47 ",3033150155,CFD," 0,00 "
03/06/2025 14:04:44,Open Position,NSDQ100/USD," 99,99 ",0.092686," 0,00 "," 1.545,47 "," 1.285,48 ",3033159014,CFD," 0,00 "
03/06/2025 14:08:48,Position closed,NSDQ100/USD," 104,25 ",0.092686," 4,26 "," 1.549,73 "," 1.389,73 ",3033159014,CFD," 0,00 "
03/06/2025 15:02:48,Position closed,NSDQ100/USD," 164,50 ",0.148192," 4,50 "," 1.554,23 "," 1.554,23 ",3033150155,CFD," 0,00 "
03/06/2025 15:03:50,Open Position,NSDQ100/USD," 119,99 ",0.11095," 0,00 "," 1.554,23 "," 1.434,24 ",3033291186,CFD," 0,00 "
03/06/2025 15:59:38,Position closed,NSDQ100/USD," 120,76 ",0.11095," 0,77 "," 1.555,00 "," 1.555,00 ",3033291186,CFD," 0,00 "
03/06/2025 16:00:45,Open Position,NSDQ100/USD," 74,99 ",0.069287," 0,00 "," 1.555,00 "," 1.480,01 ",3033382772,CFD," 0,00 "
03/06/2025 16:18:31,Position closed,NSDQ100/USD," 76,21 ",0.069287," 1,22 "," 1.556,22 "," 1.556,22 ",3033382772,CFD," 0,00 "
03/06/2025 16:23:01,Open Position,NSDQ100/USD," 101,99 ",0.094195," 0,00 "," 1.556,22 "," 1.454,23 ",3033403631,CFD," 0,00 "
03/06/2025 17:15:00,Position closed,NSDQ100/USD," 105,84 ",0.094195," 3,85 "," 1.560,07 "," 1.560,07 ",3033403631,CFD," 0,00 "
03/06/2025 17:23:55,Open Position,NSDQ100/USD," 101,99 ",0.09393," 0,00 "," 1.560,07 "," 1.458,08 ",3033461044,CFD," 0,00 "
03/06/2025 19:29:42,Position closed,NSDQ100/USD," 97,75 ",0.09393,"(4,24)"," 1.555,83 "," 1.555,83 ",3033461044,CFD," 0,00 "
04/06/2025 10:49:08,Open Position,NSDQ100/USD," 69,98 ",0.064502," 0,00 "," 1.555,83 "," 1.485,85 ",3033915995,CFD," 0,00 "
04/06/2025 13:35:53,Position closed,NSDQ100/USD," 70,84 ",0.064502," 0,86 "," 1.556,69 "," 1.556,69 ",3033915995,CFD," 0,00 "
04/06/2025 14:12:03,Open Position,NSDQ100/USD," 101,98 ",0.094103," 0,00 "," 1.556,69 "," 1.454,71 ",3034254604,CFD," 0,00 "
04/06/2025 15:12:35,Position closed,NSDQ100/USD," 107,69 ",0.094103," 5,71 "," 1.562,40 "," 1.562,40 ",3034254604,CFD," 0,00 "
04/06/2025 16:30:59,Open Position,NSDQ100/USD," 129,98 ",0.119858," 0,00 "," 1.562,40 "," 1.432,42 ",3034463428,CFD," 0,00 "
04/06/2025 17:01:21,Position closed,NSDQ100/USD," 133,36 ",0.119858," 3,38 "," 1.565,78 "," 1.565,78 ",3034463428,CFD," 0,00 "
04/06/2025 20:04:00,Open Position,NSDQ100/USD," 101,98 ",0.09395," 0,00 "," 1.565,78 "," 1.463,80 ",3034589121,CFD," 0,00 "
04/06/2025 23:12:34,Overnight fee,Daily,"(0,49)",-,"(0,49)"," 1.565,29 "," 1.463,31 ",3034589121,CFD," 0,00 "
05/06/2025 07:35:59,Position closed,NSDQ100/USD," 107,27 ",0.09395," 5,29 "," 1.570,58 "," 1.570,58 ",3034589121,CFD," 0,00 "
05/06/2025 09:44:55,Open Position,NSDQ100/USD," 102,99 ",0.09471," 0,00 "," 1.570,58 "," 1.467,59 ",3034813201,CFD," 0,00 "
05/06/2025 13:17:58,Position closed,NSDQ100/USD," 103,94 ",0.09471," 0,95 "," 1.571,53 "," 1.571,53 ",3034813201,CFD," 0,00 "
05/06/2025 13:18:28,Open Position,NSDQ100/USD," 101,98 ",0.093682," 0,00 "," 1.571,53 "," 1.469,55 ",3034997088,CFD," 0,00 "
05/06/2025 14:02:48,Open Position,NSDQ100/USD," 101,98 ",0.093983," 0,00 "," 1.571,53 "," 1.367,57 ",3035213995,CFD," 0,00 "
05/06/2025 14:27:09,Position closed,NSDQ100/USD," 107,38 ",0.093983," 5,40 "," 1.576,93 "," 1.474,95 ",3035213995,CFD," 0,00 "
05/06/2025 15:32:07,Position closed,NSDQ100/USD," 111,59 ",0.093682," 9,61 "," 1.586,54 "," 1.586,54 ",3034997088,CFD," 0,00 "
05/06/2025 16:47:26,Open Position,NSDQ100/USD," 119,99 ",0.110569," 0,00 "," 1.586,54 "," 1.466,55 ",3035436363,CFD," 0,00 "
05/06/2025 16:48:34,Open Position,NSDQ100/USD," 99,99 ",0.092194," 0,00 "," 1.586,54 "," 1.366,56 ",3035437677,CFD," 0,00 "
05/06/2025 16:53:58,Open Position,NSDQ100/USD," 119,98 ",0.110682," 0,00 "," 1.586,54 "," 1.246,58 ",3035474968,CFD," 0,00 "
05/06/2025 17:09:55,Position closed,NSDQ100/USD," 121,50 ",0.110682," 1,52 "," 1.588,06 "," 1.368,08 ",3035474968,CFD," 0,00 "
05/06/2025 17:10:06,Open Position,NSDQ100/USD," 101,99 ",0.094013," 0,00 "," 1.588,06 "," 1.266,09 ",3035550084,CFD," 0,00 "
05/06/2025 17:19:56,Position closed,NSDQ100/USD," 103,02 ",0.092194," 3,03 "," 1.591,09 "," 1.369,11 ",3035437677,CFD," 0,00 "
05/06/2025 17:19:56,Position closed,NSDQ100/USD," 104,68 ",0.094013," 2,69 "," 1.593,78 "," 1.473,79 ",3035550084,CFD," 0,00 "
05/06/2025 17:19:56,Position closed,NSDQ100/USD," 122,33 ",0.110569," 2,34 "," 1.596,12 "," 1.596,12 ",3035436363,CFD," 0,00 "
05/06/2025 17:20:26,Open Position,NSDQ100/USD," 101,99 ",0.093884," 0,00 "," 1.596,12 "," 1.494,13 ",3035558728,CFD," 0,00 "
05/06/2025 17:35:28,Position closed,NSDQ100/USD," 103,62 ",0.093884," 1,63 "," 1.597,75 "," 1.597,75 ",3035558728,CFD," 0,00 "
05/06/2025 17:35:47,Open Position,NSDQ100/USD," 54,86 ",0.093789," 0,00 "," 1.597,75 "," 1.495,77 ",3035569956,CFD," 0,00 "
05/06/2025 19:15:26,Open Position,NSDQ100/USD," 119,99 ",0.111157," 0,00 "," 1.597,75 "," 1.375,78 ",3035645386,CFD," 0,00 "
05/06/2025 19:16:56,Edit Stop Loss,-,"(19,23)",-," 0,00 "," 1.597,75 "," 1.356,55 ",3035569956,-," 0,00 "
05/06/2025 19:19:04,Open Position,NSDQ100/USD," 150,00 ",0.139527," 0,00 "," 1.597,75 "," 1.206,55 ",3035652386,CFD," 0,00 "
05/06/2025 19:19:57,Open Position,TSLA/USD," 199,98 ",3.607515," 0,00 "," 1.597,75 "," 1.006,57 ",3035653956,CFD," 0,00 "
05/06/2025 19:20:13,Position closed,TSLA/USD," 202,46 ",3.607515," 2,48 "," 1.600,23 "," 1.209,03 ",3035653956,CFD," 0,00 "
05/06/2025 19:20:42,Open Position,TSLA.EXT/USD," 250,00 ",4.493546," 0,00 "," 1.600,23 "," 959,03 ",3035655784,CFD," 0,00 "
05/06/2025 19:28:16,Position closed,TSLA.EXT/USD," 258,64 ",4.493546," 8,64 "," 1.608,87 "," 1.217,67 ",3035655784,CFD," 0,00 "
05/06/2025 19:28:27,Position closed,NSDQ100/USD," 153,04 ",0.139527," 3,04 "," 1.611,91 "," 1.370,71 ",3035652386,CFD," 0,00 "
05/06/2025 19:28:38,Open Position,NSDQ100/USD," 119,99 ",0.111487," 0,00 "," 1.611,91 "," 1.250,72 ",3035671986,CFD," 0,00 "
05/06/2025 19:28:52,Open Position,TSLA.EXT/USD," 119,99 ",2.125226," 0,00 "," 1.611,91 "," 1.130,73 ",3035672505,CFD," 0,00 "
05/06/2025 19:30:02,Position closed,NSDQ100/USD," 120,97 ",0.111487," 0,98 "," 1.612,89 "," 1.251,70 ",3035671986,CFD," 0,00 "
05/06/2025 19:30:12,Open Position,NSDQ100/USD," 150,00 ",0.139158," 0,00 "," 1.612,89 "," 1.101,70 ",3035674381,CFD," 0,00 "
05/06/2025 19:30:25,Open Position,TSLA.EXT/USD," 130,00 ",2.283857," 0,00 "," 1.612,89 "," 971,70 ",3035674683,CFD," 0,00 "
05/06/2025 19:36:40,Position closed,NSDQ100/USD," 120,11 ",0.111157," 0,12 "," 1.613,01 "," 1.091,81 ",3035645386,CFD," 0,00 "
05/06/2025 19:36:52,Position closed,TSLA.EXT/USD," 127,32 ",2.125226," 7,33 "," 1.620,34 "," 1.219,13 ",3035672505,CFD," 0,00 "
05/06/2025 19:37:01,Position closed,TSLA.EXT/USD," 132,82 ",2.283857," 2,82 "," 1.623,16 "," 1.351,95 ",3035674683,CFD," 0,00 "
05/06/2025 19:37:31,Open Position,TSLA.EXT/USD," 119,99 ",2.084483," 0,00 "," 1.623,16 "," 1.231,96 ",3035682319,CFD," 0,00 "
05/06/2025 19:37:47,Position closed,NSDQ100/USD," 159,00 ",0.139158," 9,00 "," 1.632,16 "," 1.390,96 ",3035674381,CFD," 0,00 "
05/06/2025 19:52:36,Open Position,NSDQ100/USD," 150,00 ",0.139073," 0,00 "," 1.632,16 "," 1.240,96 ",3035733829,CFD," 0,00 "
05/06/2025 20:45:53,Open Position,NSDQ100/USD," 119,99 ",0.111616," 0,00 "," 1.632,16 "," 1.120,97 ",3035792963,CFD," 0,00 "
05/06/2025 23:12:28,Overnight fee,Daily,"(0,17)",-,"(0,17)"," 1.631,99 "," 1.120,80 ",3035682319,CFD," 0,00 "
05/06/2025 23:12:28,Overnight fee,Daily,"(0,49)",-,"(0,49)"," 1.631,50 "," 1.120,31 ",3035569956,CFD," 0,00 "
05/06/2025 23:12:28,Overnight fee,Daily,"(0,58)",-,"(0,58)"," 1.630,92 "," 1.119,73 ",3035792963,CFD," 0,00 "
05/06/2025 23:12:28,Overnight fee,Daily,"(0,72)",-,"(0,72)"," 1.630,20 "," 1.119,01 ",3035733829,CFD," 0,00 "
06/06/2025 00:07:45,Position closed,NSDQ100/USD," 125,00 ",0.111616," 5,01 "," 1.635,21 "," 1.244,01 ",3035792963,CFD," 0,00 "
06/06/2025 00:33:29,Index price adjustment,NSDQ100/USD," 0,28 ",-," 0,28 "," 1.635,49 "," 1.244,29 ",3035569956,CFD," 0,00 "
06/06/2025 00:33:29,Index price adjustment,NSDQ100/USD," 0,42 ",-," 0,42 "," 1.635,91 "," 1.244,71 ",3035733829,CFD," 0,00 "
06/06/2025 04:44:22,Position closed,TSLA.EXT/USD," 150,99 ",2.084483," 31,00 "," 1.666,91 "," 1.395,70 ",3035682319,CFD," 0,00 "
06/06/2025 04:50:09,Position closed,NSDQ100/USD," 154,01 ",0.139073," 4,01 "," 1.670,92 "," 1.549,71 ",3035733829,CFD," 0,00 "
06/06/2025 07:01:00,Open Position,NSDQ100/USD," 119,99 ",0.110875," 0,00 "," 1.670,92 "," 1.429,72 ",3035893467,CFD," 0,00 "
06/06/2025 10:21:19,Position closed,NSDQ100/USD," 120,89 ",0.110875," 0,90 "," 1.671,82 "," 1.550,61 ",3035893467,CFD," 0,00 "
06/06/2025 12:01:13,Position closed,NSDQ100/USD," 60,79 ",0.051339,"(5,56)"," 1.666,26 "," 1.611,40 ",3035989365,CFD," 0,00 "
06/06/2025 12:32:45,Position closed,NSDQ100/USD," 52,96 ",0.04245,"(1,90)"," 1.664,36 "," 1.664,36 ",3035569956,CFD," 0,00 "
06/06/2025 12:43:18,Open Position,NSDQ100/USD," 138,00 ",0.126995," 0,00 "," 1.664,36 "," 1.526,36 ",3036005049,CFD," 0,00 "
06/06/2025 14:40:47,Position closed,NSDQ100/USD," 145,50 ",0.126995," 7,50 "," 1.671,86 "," 1.671,86 ",3036005049,CFD," 0,00 "
06/06/2025 15:44:49,Open Position,NSDQ100/USD," 119,99 ",0.110222," 0,00 "," 1.671,86 "," 1.551,87 ",3036507695,CFD," 0,00 "
06/06/2025 16:11:19,Position closed,NSDQ100/USD," 122,94 ",0.110222," 2,95 "," 1.674,81 "," 1.674,81 ",3036507695,CFD," 0,00 "
06/06/2025 16:29:13,Open Position,NSDQ100/USD," 150,00 ",0.137877," 0,00 "," 1.674,81 "," 1.524,81 ",3036537648,CFD," 0,00 "
06/06/2025 17:34:40,Position closed,NSDQ100/USD," 151,51 ",0.137877," 1,51 "," 1.676,32 "," 1.676,32 ",3036537648,CFD," 0,00 "
08/06/2025 23:43:56,Open Position,NSDQ100/USD," 119,99 ",0.110435," 0,00 "," 1.676,32 "," 1.556,33 ",3036711674,CFD," 0,00 "
09/06/2025 07:08:44,Position closed,NSDQ100/USD," 120,94 ",0.110435," 0,95 "," 1.677,27 "," 1.677,27 ",3036711674,CFD," 0,00 "
09/06/2025 09:18:04,Open Position,NSDQ100/USD," 140,00 ",0.128683," 0,00 "," 1.677,27 "," 1.537,27 ",3036841941,CFD," 0,00 "
09/06/2025 11:41:50,Position closed,NSDQ100/USD," 143,99 ",0.128683," 3,99 "," 1.681,26 "," 1.681,26 ",3036841941,CFD," 0,00 "
09/06/2025 11:42:23,Open Position,NSDQ100/USD," 101,98 ",0.093589," 0,00 "," 1.681,26 "," 1.579,28 ",3036886845,CFD," 0,00 "
09/06/2025 13:43:58,Open Position,NSDQ100/USD," 119,99 ",0.110307," 0,00 "," 1.681,26 "," 1.459,29 ",3037158379,CFD," 0,00 "
09/06/2025 14:09:32,Position closed,NSDQ100/USD," 124,62 ",0.110307," 4,63 "," 1.685,89 "," 1.583,91 ",3037158379,CFD," 0,00 "
09/06/2025 14:10:01,Position closed,NSDQ100/USD," 101,83 ",0.093589,"(0,15)"," 1.685,74 "," 1.685,74 ",3036886845,CFD," 0,00 "
09/06/2025 16:13:11,Open Position,JPN225/JPY," 101,99 ",7.71052," 0,00 "," 1.685,74 "," 1.583,75 ",3037858861,CFD," 0,00 "
09/06/2025 17:41:01,Position closed,JPN225/JPY," 103,86 ",7.71052," 1,87 "," 1.687,61 "," 1.687,61 ",3037858861,CFD," 0,00 "
09/06/2025 18:21:14,Open Position,NSDQ100/USD," 51,22 ",0.093412," 0,00 "," 1.687,61 "," 1.585,62 ",3037964233,CFD," 0,00 "
09/06/2025 18:33:43,Position closed,NSDQ100/USD," 50,47 ",0.046499,"(0,30)"," 1.687,31 "," 1.636,09 ",3037970211,CFD," 0,00 "
09/06/2025 20:06:28,Open Position,NSDQ100/USD," 119,99 ",0.110149," 0,00 "," 1.687,31 "," 1.516,10 ",3038055986,CFD," 0,00 "
09/06/2025 23:11:24,Overnight fee,Daily,"(0,25)",-,"(0,25)"," 1.687,06 "," 1.515,85 ",3037964233,CFD," 0,00 "
09/06/2025 23:11:24,Overnight fee,Daily,"(0,58)",-,"(0,58)"," 1.686,48 "," 1.515,27 ",3038055986,CFD," 0,00 "
09/06/2025 23:13:58,Position closed,NSDQ100/USD," 121,41 ",0.110149," 1,42 "," 1.687,90 "," 1.636,68 ",3038055986,CFD," 0,00 "
09/06/2025 23:13:58,Position closed,NSDQ100/USD," 49,46 ",0.046913,"(1,76)"," 1.686,14 "," 1.686,14 ",3037964233,CFD," 0,00 "
09/06/2025 23:14:20,Open Position,NSDQ100/USD," 101,99 ",0.093551," 0,00 "," 1.686,14 "," 1.584,15 ",3038067382,CFD," 0,00 "
10/06/2025 06:59:38,Open Position,NSDQ100/USD," 119,99 ",0.110157," 0,00 "," 1.686,14 "," 1.464,16 ",3038109670,CFD," 0,00 "
10/06/2025 07:25:32,Position closed,NSDQ100/USD," 121,15 ",0.110157," 1,16 "," 1.687,30 "," 1.585,31 ",3038109670,CFD," 0,00 "
10/06/2025 07:25:42,Open Position,NSDQ100/USD," 135,00 ",0.123845," 0,00 "," 1.687,30 "," 1.450,31 ",3038257778,CFD," 0,00 "
10/06/2025 07:45:13,Open Position,NSDQ100/USD," 170,00 ",0.15654," 0,00 "," 1.687,30 "," 1.280,31 ",3038264063,CFD," 0,00 "
10/06/2025 07:46:52,Position closed,NSDQ100/USD," 173,53 ",0.15654," 3,53 "," 1.690,83 "," 1.453,84 ",3038264063,CFD," 0,00 "
10/06/2025 07:46:59,Open Position,NSDQ100/USD," 119,98 ",0.110358," 0,00 "," 1.690,83 "," 1.333,86 ",3038264834,CFD," 0,00 "
10/06/2025 09:06:22,Position closed,NSDQ100/USD," 125,86 ",0.110358," 5,88 "," 1.696,71 "," 1.459,72 ",3038264834,CFD," 0,00 "
10/06/2025 10:20:04,Position closed,NSDQ100/USD," 138,25 ",0.123845," 3,25 "," 1.699,96 "," 1.597,97 ",3038257778,CFD," 0,00 "
10/06/2025 10:20:04,Position closed,NSDQ100/USD," 103,94 ",0.093551," 1,95 "," 1.701,91 "," 1.701,91 ",3038067382,CFD," 0,00 "
10/06/2025 10:21:14,Open Position,NSDQ100/USD," 101,98 ",0.093433," 0,00 "," 1.701,91 "," 1.599,93 ",3038305383,CFD," 0,00 "
10/06/2025 12:12:24,Position closed,NSDQ100/USD," 102,08 ",0.093433," 0,10 "," 1.702,01 "," 1.702,01 ",3038305383,CFD," 0,00 "
10/06/2025 12:55:26,Open Position,NSDQ100/USD," 102,99 ",0.094352," 0,00 "," 1.702,01 "," 1.599,02 ",3038368145,CFD," 0,00 "
10/06/2025 14:13:26,Position closed,NSDQ100/USD," 105,04 ",0.094352," 2,05 "," 1.704,06 "," 1.704,06 ",3038368145,CFD," 0,00 "
10/06/2025 14:44:54,Open Position,NSDQ100/USD," 74,99 ",0.068609," 0,00 "," 1.704,06 "," 1.629,07 ",3038745671,CFD," 0,00 "
10/06/2025 16:12:11,Position closed,NSDQ100/USD," 75,35 ",0.068609," 0,36 "," 1.704,42 "," 1.704,42 ",3038745671,CFD," 0,00 "
10/06/2025 17:38:06,Open Position,NSDQ100/USD," 119,98 ",0.10976," 0,00 "," 1.704,42 "," 1.584,44 ",3038932667,CFD," 0,00 "
10/06/2025 18:51:58,Position closed,NSDQ100/USD," 121,73 ",0.10976," 1,75 "," 1.706,17 "," 1.706,17 ",3038932667,CFD," 0,00 "
10/06/2025 19:04:27,Open Position,NSDQ100/USD," 74,99 ",0.068379," 0,00 "," 1.706,17 "," 1.631,18 ",3038991077,CFD," 0,00 "
10/06/2025 20:06:01,Position closed,NSDQ100/USD," 75,97 ",0.068379," 0,98 "," 1.707,15 "," 1.707,15 ",3038991077,CFD," 0,00 "
10/06/2025 20:07:37,Open Position,NSDQ100/USD," 102,00 ",0.093092," 0,00 "," 1.707,15 "," 1.605,15 ",3039098344,CFD," 0,00 "
10/06/2025 23:12:50,Overnight fee,Daily,"(0,03)",-,"(0,03)"," 1.707,12 "," 1.605,12 ",3039098344,CFD," 0,00 "
11/06/2025 00:13:34,Position closed,NSDQ100/USD," 101,89 ",0.093092,"(0,11)"," 1.707,01 "," 1.707,01 ",3039098344,CFD," 0,00 "
11/06/2025 00:30:33,Index price adjustment,NSDQ100/USD,"(0,01)",-,"(0,01)"," 1.707,00 "," 1.707,00 ",3038991077,CFD," 0,00 "
11/06/2025 07:11:10,Open Position,NSDQ100/USD," 140,00 ",0.127957," 0,00 "," 1.707,00 "," 1.567,00 ",3039184711,CFD," 0,00 "
11/06/2025 09:03:50,Position closed,NSDQ100/USD," 144,34 ",0.127957," 4,34 "," 1.711,34 "," 1.711,34 ",3039184711,CFD," 0,00 "
11/06/2025 09:04:31,Open Position,NSDQ100/USD," 101,98 ",0.093074," 0,00 "," 1.711,34 "," 1.609,36 ",3039286155,CFD," 0,00 "
11/06/2025 14:20:26,Position closed,NSDQ100/USD," 109,05 ",0.093074," 7,07 "," 1.718,41 "," 1.718,41 ",3039286155,CFD," 0,00 "
11/06/2025 14:22:48,Open Position,NSDQ100/USD," 104,98 ",0.095414," 0,00 "," 1.718,41 "," 1.613,43 ",3039744545,CFD," 0,00 "
11/06/2025 14:31:17,Position closed,NSDQ100/USD," 105,83 ",0.095414," 0,85 "," 1.719,26 "," 1.719,26 ",3039744545,CFD," 0,00 "
11/06/2025 17:40:56,Open Position,NSDQ100/USD," 63,14 ",0.109202," 0,00 "," 1.719,26 "," 1.599,27 ",3039965333,CFD," 0,00 "
11/06/2025 18:43:16,Open Position,NSDQ100/USD," 150,00 ",0.137194," 0,00 "," 1.719,26 "," 1.449,27 ",3040033930,CFD," 0,00 "
11/06/2025 19:01:21,Open Position,NSDQ100/USD," 129,99 ",0.119099," 0,00 "," 1.719,26 "," 1.319,28 ",3040050303,CFD," 0,00 "
11/06/2025 20:10:09,Position closed,NSDQ100/USD," 133,58 ",0.119099," 3,59 "," 1.722,85 "," 1.452,86 ",3040050303,CFD," 0,00 "
11/06/2025 23:13:11,Overnight fee,Daily,"(0,57)",-,"(0,57)"," 1.722,28 "," 1.452,29 ",3039965333,CFD," 0,00 "
11/06/2025 23:13:11,Overnight fee,Daily,"(0,72)",-,"(0,72)"," 1.721,56 "," 1.451,57 ",3040033930,CFD," 0,00 "
12/06/2025 05:38:35,Open Position,NSDQ100/USD," 101,98 ",0.093527," 0,00 "," 1.721,56 "," 1.349,59 ",3040140244,CFD," 0,00 "
12/06/2025 10:37:43,Open Position,NSDQ100/USD," 150,00 ",0.137799," 0,00 "," 1.721,56 "," 1.199,59 ",3040335860,CFD," 0,00 "
12/06/2025 10:44:38,Edit Stop Loss,-,"(10,00)",-," 0,00 "," 1.721,56 "," 1.189,59 ",3039965333,-," 0,00 "
12/06/2025 13:08:13,Position closed,NSDQ100/USD," 154,76 ",0.137799," 4,76 "," 1.726,32 "," 1.344,35 ",3040335860,CFD," 0,00 "
12/06/2025 13:32:40,Position closed,NSDQ100/USD," 103,59 ",0.093527," 1,61 "," 1.727,93 "," 1.447,94 ",3040140244,CFD," 0,00 "
12/06/2025 14:36:06,Position closed,NSDQ100/USD," 153,19 ",0.137194," 3,19 "," 1.731,12 "," 1.601,13 ",3040033930,CFD," 0,00 "
12/06/2025 14:37:18,Open Position,NSDQ100/USD," 101,99 ",0.093122," 0,00 "," 1.731,12 "," 1.499,14 ",3041013267,CFD," 0,00 "
12/06/2025 14:39:30,Position closed,NSDQ100/USD," 102,18 ",0.093122," 0,19 "," 1.731,31 "," 1.601,32 ",3041013267,CFD," 0,00 "
12/06/2025 16:09:43,Open Position,NSDQ100/USD," 101,99 ",0.093095," 0,00 "," 1.731,31 "," 1.499,33 ",3041131458,CFD," 0,00 "
12/06/2025 17:17:38,Position closed,NSDQ100/USD," 103,30 ",0.093095," 1,31 "," 1.732,62 "," 1.602,63 ",3041131458,CFD," 0,00 "
12/06/2025 18:16:32,Open Position,NSDQ100/USD," 136,90 ",0.093042," 0,00 "," 1.732,62 "," 1.500,65 ",3041202194,CFD," 0,00 "
12/06/2025 23:12:40,Overnight fee,Daily,"(0,49)",-,"(0,49)"," 1.732,13 "," 1.500,16 ",3041202194,CFD," 0,00 "
12/06/2025 23:12:40,Overnight fee,Daily,"(0,57)",-,"(0,57)"," 1.731,56 "," 1.499,59 ",3039965333,CFD," 0,00 "
13/06/2025 00:54:47,Index price adjustment,NSDQ100/USD," 0,29 ",-," 0,29 "," 1.731,85 "," 1.499,88 ",3039965333,CFD," 0,00 "
13/06/2025 00:54:47,Index price adjustment,NSDQ100/USD," 0,25 ",-," 0,25 "," 1.732,10 "," 1.500,13 ",3041202194,CFD," 0,00 "
13/06/2025 05:06:30,Edit Stop Loss,-,"(20,00)",-," 0,00 "," 1.732,10 "," 1.480,13 ",3039965333,-," 0,00 "
13/06/2025 05:06:50,Edit Stop Loss,-,"(34,92)",-," 0,00 "," 1.732,10 "," 1.445,21 ",3041202194,-," 0,00 "
13/06/2025 05:07:11,Edit Stop Loss,-,"(10,00)",-," 0,00 "," 1.732,10 "," 1.435,21 ",3039965333,-," 0,00 "
13/06/2025 05:07:38,Open Position,NSDQ100/USD," 300,00 ",0.278814," 0,00 "," 1.732,10 "," 1.135,21 ",3041413677,CFD," 0,00 "
13/06/2025 05:57:31,Position closed,NSDQ100/USD," 308,33 ",0.278814," 8,33 "," 1.740,43 "," 1.443,54 ",3041413677,CFD," 0,00 "
13/06/2025 05:57:50,Open Position,NSDQ100/USD," 379,98 ",0.352578," 0,00 "," 1.740,43 "," 1.063,56 ",3041424376,CFD," 0,00 "
13/06/2025 08:44:23,Position closed,NSDQ100/USD," 392,06 ",0.352578," 12,08 "," 1.752,51 "," 1.455,62 ",3041424376,CFD," 0,00 "
13/06/2025 08:47:05,Open Position,NSDQ100/USD," 300,00 ",0.277929," 0,00 "," 1.752,51 "," 1.155,62 ",3041567508,CFD," 0,00 "
13/06/2025 11:11:04,Position closed,NSDQ100/USD," 320,92 ",0.277929," 20,92 "," 1.773,43 "," 1.476,54 ",3041567508,CFD," 0,00 "
13/06/2025 11:11:30,Open Position,NSDQ100/USD," 150,00 ",0.138463," 0,00 "," 1.773,43 "," 1.326,54 ",3041616746,CFD," 0,00 "
13/06/2025 12:13:07,Open Position,XTI/USD," 119,98 ",16.700069," 0,00 "," 1.773,43 "," 1.206,56 ",3041644802,CFD," 0,00 "
13/06/2025 12:14:25,Open Position,XTI/USD," 100,00 ",13.915947," 0,00 "," 1.773,43 "," 1.106,56 ",3041645035,CFD," 0,00 "
13/06/2025 12:20:48,Position closed,NSDQ100/USD," 150,37 ",0.138463," 0,37 "," 1.773,80 "," 1.256,93 ",3041616746,CFD," 0,00 "
13/06/2025 12:26:34,Position closed,XTI/USD," 96,38 ",13.915947,"(3,62)"," 1.770,18 "," 1.353,31 ",3041645035,CFD," 0,00 "
13/06/2025 12:27:05,Open Position,NSDQ100/USD," 119,98 ",0.110693," 0,00 "," 1.770,18 "," 1.233,33 ",3041648489,CFD," 0,00 "
13/06/2025 13:24:06,Position closed,XTI/USD," 118,64 ",16.700069,"(1,34)"," 1.768,84 "," 1.351,97 ",3041644802,CFD," 0,00 "
13/06/2025 13:24:32,Open Position,NSDQ100/USD," 101,98 ",0.094308," 0,00 "," 1.768,84 "," 1.249,99 ",3041665455,CFD," 0,00 "
13/06/2025 13:54:34,Position closed,NSDQ100/USD," 111,35 ",0.094308," 9,37 "," 1.778,21 "," 1.361,34 ",3041665455,CFD," 0,00 "
13/06/2025 13:54:42,Position closed,NSDQ100/USD," 125,33 ",0.110693," 5,35 "," 1.783,56 "," 1.486,67 ",3041648489,CFD," 0,00 "
13/06/2025 13:56:10,Open Position,NSDQ100/USD," 101,99 ",0.09385," 0,00 "," 1.783,56 "," 1.384,68 ",3041925283,CFD," 0,00 "
13/06/2025 14:32:53,Open Position,NVDA.EXT/USD," 119,97 ",4.232732," 0,00 "," 1.783,56 "," 1.264,71 ",3042029890,CFD," 0,00 "
13/06/2025 14:33:39,Open Position,NSDQ100/USD," 199,98 ",0.18471," 0,00 "," 1.783,56 "," 1.064,73 ",3042031018,CFD," 0,00 "
13/06/2025 15:52:26,Position closed,NSDQ100/USD," 230,59 ",0.18471," 30,61 "," 1.814,17 "," 1.295,32 ",3042031018,CFD," 0,00 "
13/06/2025 15:53:48,Position closed,NVDA.EXT/USD," 125,32 ",4.232732," 5,35 "," 1.819,52 "," 1.420,64 ",3042029890,CFD," 0,00 "
13/06/2025 15:54:11,Position closed,NSDQ100/USD," 109,77 ",0.09385," 7,78 "," 1.827,30 "," 1.530,41 ",3041925283,CFD," 0,00 "
13/06/2025 15:55:43,Position closed,NSDQ100/USD," 126,43 ",0.093042,"(10,47)"," 1.816,83 "," 1.656,84 ",3041202194,CFD," 0,00 "
13/06/2025 15:57:01,Open Position,NSDQ100/USD," 185,79 ",0.137585," 0,00 "," 1.816,83 "," 1.506,84 ",3042149136,CFD," 0,00 "
13/06/2025 17:53:27,Open Position,NSDQ100/USD," 182,47 ",0.137739," 0,00 "," 1.816,83 "," 1.356,84 ",3042217775,CFD," 0,00 "
13/06/2025 19:00:59,Open Position,NSDQ100/USD," 197,89 ",0.16629," 0,00 "," 1.816,83 "," 1.176,84 ",3042271888,CFD," 0,00 "
13/06/2025 19:28:19,Open Position,NSDQ100/USD," 193,26 ",0.16649," 0,00 "," 1.816,83 "," 996,87 ",3042297212,CFD," 0,00 "
13/06/2025 19:33:33,Edit Stop Loss,-,"(17,89)",-," 0,00 "," 1.816,83 "," 978,98 ",3042271888,-," 0,00 "
13/06/2025 19:33:43,Edit Stop Loss,-,"(32,47)",-," 0,00 "," 1.816,83 "," 946,51 ",3042217775,-," 0,00 "
13/06/2025 19:33:55,Edit Stop Loss,-,"(35,79)",-," 0,00 "," 1.816,83 "," 910,72 ",3042149136,-," 0,00 "
13/06/2025 19:34:29,Edit Stop Loss,-,"(13,29)",-," 0,00 "," 1.816,83 "," 897,43 ",3042297212,-," 0,00 "
13/06/2025 19:47:30,Open Position,NSDQ100/USD," 150,00 ",0.138858," 0,00 "," 1.816,83 "," 747,43 ",3042313538,CFD," 0,00 "
13/06/2025 19:49:35,Position closed,NSDQ100/USD," 153,48 ",0.138858," 3,48 "," 1.820,31 "," 900,91 ",3042313538,CFD," 0,00 "
13/06/2025 19:50:05,Open Position,NSDQ100/USD," 101,99 ",0.094312," 0,00 "," 1.820,31 "," 798,92 ",3042314988,CFD," 0,00 "
13/06/2025 19:54:02,Open Position,NSDQ100/USD," 101,98 ",0.094402," 0,00 "," 1.820,31 "," 696,94 ",3042317847,CFD," 0,00 "
13/06/2025 20:07:44,Position closed,NSDQ100/USD," 194,75 ",0.16649," 1,49 "," 1.821,80 "," 891,69 ",3042297212,CFD," 0,00 "
13/06/2025 20:07:53,Position closed,NSDQ100/USD," 104,19 ",0.094402," 2,21 "," 1.824,01 "," 995,88 ",3042317847,CFD," 0,00 "
13/06/2025 20:08:04,Open Position,NSDQ100/USD," 150,00 ",0.138641," 0,00 "," 1.824,01 "," 845,88 ",3042327939,CFD," 0,00 "
13/06/2025 23:12:03,Overnight fee,Weekend Fee,"(1,48)",-,"(1,48)"," 1.822,53 "," 844,40 ",3042314988,CFD," 0,00 "
13/06/2025 23:12:03,Overnight fee,Weekend Fee,"(1,72)",-,"(1,72)"," 1.820,81 "," 842,68 ",3039965333,CFD," 0,00 "
13/06/2025 23:12:03,Overnight fee,Weekend Fee,"(2,17)",-,"(2,17)"," 1.818,64 "," 840,51 ",3042149136,CFD," 0,00 "
13/06/2025 23:12:03,Overnight fee,Weekend Fee,"(2,17)",-,"(2,17)"," 1.816,47 "," 838,34 ",3042217775,CFD," 0,00 "
13/06/2025 23:12:03,Overnight fee,Weekend Fee,"(2,18)",-,"(2,18)"," 1.814,29 "," 836,16 ",3042327939,CFD," 0,00 "
13/06/2025 23:12:03,Overnight fee,Weekend Fee,"(2,62)",-,"(2,62)"," 1.811,67 "," 833,54 ",3042271888,CFD," 0,00 "
14/06/2025 00:13:32,Index price adjustment,NSDQ100/USD," 0,07 ",-," 0,07 "," 1.811,74 "," 833,61 ",3039965333,CFD," 0,00 "
14/06/2025 00:13:32,Index price adjustment,NSDQ100/USD," 0,09 ",-," 0,09 "," 1.811,83 "," 833,70 ",3042149136,CFD," 0,00 "
14/06/2025 00:13:32,Index price adjustment,NSDQ100/USD," 0,09 ",-," 0,09 "," 1.811,92 "," 833,79 ",3042217775,CFD," 0,00 "
14/06/2025 00:13:32,Index price adjustment,NSDQ100/USD," 0,10 ",-," 0,10 "," 1.812,02 "," 833,89 ",3042271888,CFD," 0,00 "
14/06/2025 00:13:32,Index price adjustment,NSDQ100/USD," 0,10 ",-," 0,10 "," 1.812,12 "," 833,99 ",3042297212,CFD," 0,00 "
14/06/2025 00:13:32,Index price adjustment,NSDQ100/USD," 0,06 ",-," 0,06 "," 1.812,18 "," 834,05 ",3042314988,CFD," 0,00 "
14/06/2025 00:13:32,Index price adjustment,NSDQ100/USD," 0,06 ",-," 0,06 "," 1.812,24 "," 834,11 ",3042317847,CFD," 0,00 "
15/06/2025 22:02:22,Open Position,NSDQ100/USD," 119,99 ",0.111397," 0,00 "," 1.812,24 "," 714,12 ",3042637492,CFD," 0,00 "
15/06/2025 22:38:57,Position closed,NSDQ100/USD," 101,89 ",0.094312,"(0,10)"," 1.812,14 "," 816,01 ",3042314988,CFD," 0,00 "
15/06/2025 22:39:04,Position closed,NSDQ100/USD," 129,32 ",0.111397," 9,33 "," 1.821,47 "," 945,33 ",3042637492,CFD," 0,00 "
15/06/2025 23:41:31,Position closed,NSDQ100/USD," 199,60 ",0.16629," 1,71 "," 1.823,18 "," 1.144,93 ",3042271888,CFD," 0,00 "
15/06/2025 23:41:40,Position closed,NSDQ100/USD," 153,43 ",0.138641," 3,43 "," 1.826,61 "," 1.298,36 ",3042327939,CFD," 0,00 "
15/06/2025 23:41:50,Open Position,NSDQ100/USD," 199,98 ",0.184607," 0,00 "," 1.826,61 "," 1.098,38 ",3042656355,CFD," 0,00 "
16/06/2025 01:03:35,Position closed,NSDQ100/USD," 202,81 ",0.184607," 2,83 "," 1.829,44 "," 1.301,19 ",3042656355,CFD," 0,00 "
16/06/2025 01:03:50,Open Position,NSDQ100/USD," 150,00 ",0.138344," 0,00 "," 1.829,44 "," 1.151,19 ",3042663403,CFD," 0,00 "
16/06/2025 06:07:39,Position closed,NSDQ100/USD," 152,70 ",0.138344," 2,70 "," 1.832,14 "," 1.303,89 ",3042663403,CFD," 0,00 "
16/06/2025 12:09:49,Position closed,NSDQ100/USD," 185,90 ",0.137739," 3,43 "," 1.835,57 "," 1.489,79 ",3042217775,CFD," 0,00 "
16/06/2025 13:48:55,Position closed,NSDQ100/USD," 189,48 ",0.137585," 3,69 "," 1.839,26 "," 1.679,27 ",3042149136,CFD," 0,00 "
16/06/2025 13:49:04,Position closed,NSDQ100/USD," 87,38 ",0.066104,"(9,47)"," 1.829,79 "," 1.766,65 ",3043074929,CFD," 0,00 "
16/06/2025 14:13:32,Position closed,NSDQ100/USD," 61,47 ",0.043098,"(1,67)"," 1.828,12 "," 1.828,12 ",3039965333,CFD," 0,00 "
16/06/2025 15:31:00,Open Position,NSDQ100/USD," 158,66 ",0.092891," 0,00 "," 1.828,12 "," 1.726,14 ",3043611721,CFD," 0,00 "
16/06/2025 23:14:26,Overnight fee,Daily,"(0,49)",-,"(0,49)"," 1.827,63 "," 1.725,65 ",3043611721,CFD," 0,00 "
17/06/2025 05:50:09,Open Position,NSDQ100/USD," 119,99 ",0.10987," 0,00 "," 1.827,63 "," 1.605,66 ",3043878452,CFD," 0,00 "
17/06/2025 06:39:11,Position closed,NSDQ100/USD," 122,50 ",0.10987," 2,51 "," 1.830,14 "," 1.728,16 ",3043878452,CFD," 0,00 "
17/06/2025 06:39:24,Open Position,NSDQ100/USD," 177,72 ",0.109728," 0,00 "," 1.830,14 "," 1.608,17 ",3043885063,CFD," 0,00 "
17/06/2025 08:41:52,Open Position,NSDQ100/USD," 119,98 ",0.110002," 0,00 "," 1.830,14 "," 1.488,19 ",3044003048,CFD," 0,00 "
17/06/2025 14:46:35,Position closed,NSDQ100/USD," 125,21 ",0.110002," 5,23 "," 1.835,37 "," 1.613,40 ",3044003048,CFD," 0,00 "
17/06/2025 17:41:52,Open Position,NSDQ100/USD," 147,86 ",0.110105," 0,00 "," 1.835,37 "," 1.493,41 ",3044917499,CFD," 0,00 "
17/06/2025 17:42:05,Edit Stop Loss,-,"(19,52)",-," 0,00 "," 1.835,37 "," 1.473,89 ",3043611721,-," 0,00 "
17/06/2025 17:42:17,Edit Stop Loss,-,"(13,84)",-," 0,00 "," 1.835,37 "," 1.460,05 ",3043885063,-," 0,00 "
17/06/2025 17:42:27,Edit Stop Loss,-,"(16,86)",-," 0,00 "," 1.835,37 "," 1.443,19 ",3044917499,-," 0,00 "
17/06/2025 17:48:30,Open Position,NSDQ100/USD," 211,70 ",0.165599," 0,00 "," 1.835,37 "," 1.263,23 ",3044921829,CFD," 0,00 "
17/06/2025 17:48:50,Edit Stop Loss,-,"(31,74)",-," 0,00 "," 1.835,37 "," 1.231,49 ",3044921829,-," 0,00 "
17/06/2025 17:49:02,Edit Stop Loss,-,"(11,01)",-," 0,00 "," 1.835,37 "," 1.220,48 ",3044917499,-," 0,00 "
17/06/2025 17:49:13,Edit Stop Loss,-,"(21,95)",-," 0,00 "," 1.835,37 "," 1.198,53 ",3043885063,-," 0,00 "
17/06/2025 17:49:23,Edit Stop Loss,-,"(18,58)",-," 0,00 "," 1.835,37 "," 1.179,95 ",3043611721,-," 0,00 "
17/06/2025 17:49:51,Open Position,NSDQ100/USD," 117,23 ",0.092037," 0,00 "," 1.835,37 "," 1.079,96 ",3044923452,CFD," 0,00 "
17/06/2025 19:28:39,Position closed,NSDQ100/USD," 213,43 ",0.165599," 1,73 "," 1.837,10 "," 1.293,39 ",3044921829,CFD," 0,00 "
17/06/2025 22:34:32,Open Position,NSDQ100/USD," 168,07 ",0.138429," 0,00 "," 1.837,10 "," 1.143,39 ",3045215890,CFD," 0,00 "
17/06/2025 22:46:10,Edit Stop Loss,-,"(17,24)",-," 0,00 "," 1.837,10 "," 1.126,15 ",3044923452,-," 0,00 "
17/06/2025 22:46:28,Edit Stop Loss,-,"(18,07)",-," 0,00 "," 1.837,10 "," 1.108,08 ",3045215890,-," 0,00 "
17/06/2025 22:49:41,Open Position,NSDQ100/USD," 99,98 ",0.092353," 0,00 "," 1.837,10 "," 1.008,10 ",3045216950,CFD," 0,00 "
17/06/2025 23:06:59,Position closed,NSDQ100/USD," 99,99 ",0.092353," 0,01 "," 1.837,11 "," 1.108,09 ",3045216950,CFD," 0,00 "
17/06/2025 23:13:17,Overnight fee,Daily,"(0,48)",-,"(0,48)"," 1.836,63 "," 1.107,61 ",3044923452,CFD," 0,00 "
17/06/2025 23:13:17,Overnight fee,Daily,"(0,49)",-,"(0,49)"," 1.836,14 "," 1.107,12 ",3043611721,CFD," 0,00 "
17/06/2025 23:13:17,Overnight fee,Daily,"(0,58)",-,"(0,58)"," 1.835,56 "," 1.106,54 ",3044917499,CFD," 0,00 "
17/06/2025 23:13:17,Overnight fee,Daily,"(0,58)",-,"(0,58)"," 1.834,98 "," 1.105,96 ",3043885063,CFD," 0,00 "
18/06/2025 00:23:05,Index price adjustment,NSDQ100/USD," 0,04 ",-," 0,04 "," 1.835,02 "," 1.106,00 ",3043611721,CFD," 0,00 "
18/06/2025 00:23:05,Index price adjustment,NSDQ100/USD," 0,04 ",-," 0,04 "," 1.835,06 "," 1.106,04 ",3043885063,CFD," 0,00 "
18/06/2025 00:23:05,Index price adjustment,NSDQ100/USD," 0,04 ",-," 0,04 "," 1.835,10 "," 1.106,08 ",3044917499,CFD," 0,00 "
18/06/2025 00:23:05,Index price adjustment,NSDQ100/USD," 0,04 ",-," 0,04 "," 1.835,14 "," 1.106,12 ",3044923452,CFD," 0,00 "
18/06/2025 05:40:17,Position closed,NSDQ100/USD," 179,11 ",0.138429," 11,04 "," 1.846,18 "," 1.285,23 ",3045215890,CFD," 0,00 "
18/06/2025 07:19:24,Position closed,NSDQ100/USD," 122,83 ",0.092037," 5,60 "," 1.851,78 "," 1.408,06 ",3044923452,CFD," 0,00 "
18/06/2025 16:58:03,Position closed,NSDQ100/USD," 147,91 ",0.110105," 0,05 "," 1.851,83 "," 1.555,97 ",3044917499,CFD," 0,00 "
18/06/2025 18:25:29,Open Position,NSDQ100/USD," 104,64 ",0.068886," 0,00 "," 1.851,83 "," 1.480,98 ",3045914285,CFD," 0,00 "
18/06/2025 23:14:00,Overnight fee,Daily,"(0,36)",-,"(0,36)"," 1.851,47 "," 1.480,62 ",3045914285,CFD," 0,00 "
18/06/2025 23:14:00,Overnight fee,Daily,"(0,49)",-,"(0,49)"," 1.850,98 "," 1.480,13 ",3043611721,CFD," 0,00 "
18/06/2025 23:14:00,Overnight fee,Daily,"(0,58)",-,"(0,58)"," 1.850,40 "," 1.479,55 ",3043885063,CFD," 0,00 "
19/06/2025 06:48:14,Edit Stop Loss,-,"(15,87)",-," 0,00 "," 1.850,40 "," 1.463,68 ",3045914285,-," 0,00 "
19/06/2025 06:55:25,Open Position,NSDQ100/USD," 150,00 ",0.138832," 0,00 "," 1.850,40 "," 1.313,68 ",3046044637,CFD," 0,00 "
19/06/2025 22:30:26,Position closed,NSDQ100/USD," 150,58 ",0.138832," 0,58 "," 1.850,98 "," 1.464,26 ",3046044637,CFD," 0,00 "
19/06/2025 22:31:11,Open Position,NSDQ100/USD," 187,45 ",0.161906," 0,00 "," 1.850,98 "," 1.289,26 ",3046377018,CFD," 0,00 "
19/06/2025 22:31:30,Edit Stop Loss,-,"(12,45)",-," 0,00 "," 1.850,98 "," 1.276,81 ",3046377018,-," 0,00 "
19/06/2025 23:13:09,Position closed,NSDQ100/USD," 192,43 ",0.161906," 4,98 "," 1.855,96 "," 1.469,24 ",3046377018,CFD," 0,00 "
19/06/2025 23:13:52,Overnight fee,Daily,"(0,36)",-,"(0,36)"," 1.855,60 "," 1.468,88 ",3045914285,CFD," 0,00 "
19/06/2025 23:13:52,Overnight fee,Daily,"(0,49)",-,"(0,49)"," 1.855,11 "," 1.468,39 ",3043611721,CFD," 0,00 "
19/06/2025 23:13:52,Overnight fee,Daily,"(0,58)",-,"(0,58)"," 1.854,53 "," 1.467,81 ",3043885063,CFD," 0,00 "
19/06/2025 23:13:52,Overnight fee,Daily,"(0,73)",-,"(0,73)"," 1.853,80 "," 1.467,08 ",3046044637,CFD," 0,00 "
19/06/2025 23:52:39,Open Position,NSDQ100/USD," 180,00 ",0.166227," 0,00 "," 1.853,80 "," 1.287,08 ",3046381309,CFD," 0,00 "
20/06/2025 01:29:17,Index price adjustment,NSDQ100/USD," 0,23 ",-," 0,23 "," 1.854,03 "," 1.287,31 ",3043611721,CFD," 0,00 "
20/06/2025 01:29:17,Index price adjustment,NSDQ100/USD," 0,27 ",-," 0,27 "," 1.854,30 "," 1.287,58 ",3043885063,CFD," 0,00 "
20/06/2025 01:29:17,Index price adjustment,NSDQ100/USD," 0,17 ",-," 0,17 "," 1.854,47 "," 1.287,75 ",3045914285,CFD," 0,00 "
20/06/2025 01:29:17,Index price adjustment,NSDQ100/USD," 0,34 ",-," 0,34 "," 1.854,81 "," 1.288,09 ",3046044637,CFD," 0,00 "
20/06/2025 06:41:21,Position closed,NSDQ100/USD," 185,43 ",0.166227," 5,43 "," 1.860,24 "," 1.473,52 ",3046381309,CFD," 0,00 "
20/06/2025 08:01:24,Open Position,NSDQ100/USD," 200,51 ",0.138189," 0,00 "," 1.860,24 "," 1.323,53 ",3046463535,CFD," 0,00 "
20/06/2025 17:17:04,Open Position,NSDQ100/USD," 233,92 ",0.166147," 0,00 "," 1.860,24 "," 1.143,54 ",3047289136,CFD," 0,00 "
20/06/2025 23:13:23,Overnight fee,Weekend Fee,"(1,09)",-,"(1,09)"," 1.859,15 "," 1.142,45 ",3045914285,CFD," 0,00 "
20/06/2025 23:13:23,Overnight fee,Weekend Fee,"(1,46)",-,"(1,46)"," 1.857,69 "," 1.140,99 ",3043611721,CFD," 0,00 "
20/06/2025 23:13:23,Overnight fee,Weekend Fee,"(1,73)",-,"(1,73)"," 1.855,96 "," 1.139,26 ",3043885063,CFD," 0,00 "
20/06/2025 23:13:23,Overnight fee,Weekend Fee,"(2,18)",-,"(2,18)"," 1.853,78 "," 1.137,08 ",3046463535,CFD," 0,00 "
20/06/2025 23:13:23,Overnight fee,Weekend Fee,"(2,62)",-,"(2,62)"," 1.851,16 "," 1.134,46 ",3047289136,CFD," 0,00 "
22/06/2025 22:00:58,Edit Stop Loss,-,"(20,70)",-," 0,00 "," 1.851,16 "," 1.113,76 ",3047289136,-," 0,00 "
22/06/2025 22:01:14,Edit Stop Loss,-,"(22,88)",-," 0,00 "," 1.851,16 "," 1.090,88 ",3046463535,-," 0,00 "
22/06/2025 22:02:59,Open Position,NSDQ100/USD," 169,63 ",0.139681," 0,00 "," 1.851,16 "," 940,88 ",3047569527,CFD," 0,00 "
22/06/2025 22:03:38,Edit Stop Loss,-,"(18,58)",-," 0,00 "," 1.851,16 "," 922,30 ",3043611721,-," 0,00 "
22/06/2025 22:03:55,Edit Stop Loss,-,"(21,94)",-," 0,00 "," 1.851,16 "," 900,36 ",3043885063,-," 0,00 "
22/06/2025 22:04:08,Edit Stop Loss,-,"(13,78)",-," 0,00 "," 1.851,16 "," 886,58 ",3045914285,-," 0,00 "
22/06/2025 22:04:20,Edit Stop Loss,-,"(27,64)",-," 0,00 "," 1.851,16 "," 858,94 ",3046463535,-," 0,00 "
22/06/2025 22:04:32,Edit Stop Loss,-,"(33,23)",-," 0,00 "," 1.851,16 "," 825,71 ",3047289136,-," 0,00 "
22/06/2025 22:04:44,Edit Stop Loss,-,"(19,63)",-," 0,00 "," 1.851,16 "," 806,08 ",3047569527,-," 0,00 "
22/06/2025 22:15:37,Position closed,NSDQ100/USD," 172,79 ",0.139681," 3,16 "," 1.854,32 "," 978,87 ",3047569527,CFD," 0,00 "
22/06/2025 22:21:38,Open Position,NSDQ100/USD," 99,99 ",0.092991," 0,00 "," 1.854,32 "," 878,88 ",3047579721,CFD," 0,00 "
23/06/2025 06:01:52,Position closed,NSDQ100/USD," 108,12 ",0.092991," 8,13 "," 1.862,45 "," 987,00 ",3047579721,CFD," 0,00 "
23/06/2025 06:03:20,Open Position,NSDQ100/USD," 119,99 ",0.111072," 0,00 "," 1.862,45 "," 867,01 ",3047628830,CFD," 0,00 "
23/06/2025 07:14:50,Position closed,NSDQ100/USD," 124,64 ",0.111072," 4,65 "," 1.867,10 "," 991,65 ",3047628830,CFD," 0,00 "
23/06/2025 14:00:10,Position closed,NSDQ100/USD," 244,88 ",0.166147," 10,96 "," 1.878,06 "," 1.236,53 ",3047289136,CFD," 0,00 "
23/06/2025 15:22:16,Position closed,NSDQ100/USD," 207,97 ",0.138189," 7,46 "," 1.885,52 "," 1.444,50 ",3046463535,CFD," 0,00 "
23/06/2025 17:33:18,Position closed,NSDQ100/USD," 107,97 ",0.068886," 3,33 "," 1.888,85 "," 1.552,47 ",3045914285,CFD," 0,00 "
23/06/2025 18:31:32,Position closed,NSDQ100/USD," 173,91 ",0.109728,"(3,81)"," 1.885,04 "," 1.726,38 ",3043885063,CFD," 0,00 "
23/06/2025 20:23:44,Position closed,NSDQ100/USD," 148,63 ",0.092891,"(10,03)"," 1.875,01 "," 1.875,01 ",3043611721,CFD," 0,00 "
24/06/2025 07:28:02,Open Position,NSDQ100/USD," 100,00 ",0.09042," 0,00 "," 1.875,01 "," 1.775,01 ",3050000753,CFD," 0,00 "
24/06/2025 09:00:32,Position closed,NSDQ100/USD," 102,51 ",0.09042," 2,51 "," 1.877,52 "," 1.877,52 ",3050000753,CFD," 0,00 "
25/06/2025 09:03:19,Open Position,NSDQ100/USD," 120,00 ",0.108044," 0,00 "," 1.877,52 "," 1.757,52 ",3051056059,CFD," 0,00 "
25/06/2025 09:32:22,Position closed,NSDQ100/USD," 119,85 ",0.108044,"(0,15)"," 1.877,37 "," 1.877,37 ",3051056059,CFD," 0,00 "
26/06/2025 09:12:11,Open Position,NSDQ100/USD," 75,00 ",0.067153," 0,00 "," 1.877,37 "," 1.802,37 ",3051994221,CFD," 0,00 "
26/06/2025 09:47:12,Position closed,NSDQ100/USD," 75,33 ",0.067153," 0,33 "," 1.877,70 "," 1.877,70 ",3051994221,CFD," 0,00 "
26/06/2025 13:13:45,Open Position,NSDQ100/USD," 119,99 ",0.107537," 0,00 "," 1.877,70 "," 1.757,71 ",3052065322,CFD," 0,00 "
26/06/2025 15:15:30,Position closed,NSDQ100/USD," 125,53 ",0.107537," 5,54 "," 1.883,24 "," 1.883,24 ",3052065322,CFD," 0,00 "
26/06/2025 19:26:45,Open Position,USD/JPY," 80,00 ",2400," 0,00 "," 1.883,24 "," 1.803,24 ",3052754808,CFD," 0,00 "
26/06/2025 19:37:45,Position closed,USD/JPY," 79,65 ",2400,"(0,35)"," 1.882,89 "," 1.882,89 ",3052754808,CFD," 0,00 "
26/06/2025 19:39:31,Open Position,NSDQ100/USD," 77,29 ",0.133709," 0,00 "," 1.882,89 "," 1.732,90 ",3052762147,CFD," 0,00 "
26/06/2025 23:14:29,Overnight fee,Daily,"(0,05)",-,"(0,05)"," 1.882,84 "," 1.732,85 ",3052762147,CFD," 0,00 "
26/06/2025 23:46:19,Position closed,NSDQ100/USD," 70,65 ",0.064811,"(2,05)"," 1.880,79 "," 1.803,50 ",3052792838,CFD," 0,00 "
27/06/2025 01:40:22,Index price adjustment,NSDQ100/USD,"(0,03)",-,"(0,03)"," 1.880,76 "," 1.803,47 ",3052762147,CFD," 0,00 "
27/06/2025 01:40:22,Index price adjustment,NSDQ100/USD,"(0,03)",-,"(0,03)"," 1.880,73 "," 1.803,44 ",3052792838,CFD," 0,00 "
27/06/2025 07:04:00,Open Position,NSDQ100/USD," 99,99 ",0.088824," 0,00 "," 1.880,73 "," 1.703,45 ",3052860428,CFD," 0,00 "
27/06/2025 08:52:55,Position closed,NSDQ100/USD," 100,46 ",0.088824," 0,47 "," 1.881,20 "," 1.803,91 ",3052860428,CFD," 0,00 "
27/06/2025 08:53:06,Open Position,NSDQ100/USD," 140,00 ",0.124301," 0,00 "," 1.881,20 "," 1.663,91 ",3052939308,CFD," 0,00 "
27/06/2025 11:40:53,Position closed,NSDQ100/USD," 143,85 ",0.124301," 3,85 "," 1.885,05 "," 1.807,76 ",3052939308,CFD," 0,00 "
27/06/2025 11:41:00,Open Position,NSDQ100/USD," 62,95 ",0.106377," 0,00 "," 1.885,05 "," 1.687,77 ",3052978830,CFD," 0,00 "
27/06/2025 13:18:27,Position closed,NSDQ100/USD," 54,13 ",0.050572,"(2,91)"," 1.882,14 "," 1.741,90 ",3053034816,CFD," 0,00 "
27/06/2025 15:12:36,Position closed,NSDQ100/USD," 63,17 ",0.055805," 0,22 "," 1.882,36 "," 1.805,07 ",3052978830,CFD," 0,00 "
27/06/2025 16:02:07,Open Position,VIX.JUL25/USD," 200,00 ",105.374077," 0,00 "," 1.882,36 "," 1.605,07 ",3053565424,CFD," 0,00 "
27/06/2025 16:05:36,Open Position,NSDQ100/USD," 101,99 ",0.045152," 0,00 "," 1.882,36 "," 1.503,08 ",3053567392,CFD," 0,00 "
27/06/2025 17:53:31,Position closed,VIX.JUL25/USD," 210,54 ",105.374077," 10,54 "," 1.892,90 "," 1.713,62 ",3053565424,CFD," 0,00 "
27/06/2025 18:00:34,Position closed,NSDQ100/USD," 98,63 ",0.045152,"(3,36)"," 1.889,54 "," 1.812,25 ",3053567392,CFD," 0,00 "
27/06/2025 18:00:34,Position closed,NSDQ100/USD," 71,63 ",0.068898,"(5,66)"," 1.883,88 "," 1.883,88 ",3052762147,CFD," 0,00 "
27/06/2025 18:01:09,Open Position,NSDQ100/USD," 100,99 ",0.044875," 0,00 "," 1.883,88 "," 1.782,89 ",3053680187,CFD," 0,00 "
27/06/2025 18:12:04,Position closed,NSDQ100/USD," 101,10 ",0.044875," 0,11 "," 1.883,99 "," 1.883,99 ",3053680187,CFD," 0,00 "