Date,Type,Details,Amount,Units,Realized Equity Change,Realized Equity,Balance,Position ID,Asset type,NWA
05/08/2024 13:27:30,Deposit,1100.00 USDRON CreditCard," 236,11 ",-," 236,11 "," 251,55 "," 241,55 ",-,-," 0,00 "
05/08/2024 13:27:30,Deposit Conversion Fee,-,"(7,05)",-," 0,00 "," 251,55 "," 241,55 ",-,-," 0,00 "
05/08/2024 13:34:17,Open Position,NSDQ100/USD," 50,00 ",0.057045," 0,00 "," 251,55 "," 191,55 ",2784254776,CFD," 0,00 "
05/08/2024 13:35:39,Position closed,BTC/USD," 12,05 ",0.000238," 2,05 "," 253,60 "," 203,60 ",1459273952,Crypto," 0,00 "
05/08/2024 14:01:04,Position closed,NSDQ100/USD," 72,93 ",0.057045," 22,93 "," 276,53 "," 276,53 ",2784254776,CFD," 0,00 "
05/08/2024 14:43:38,Open Position,NSDQ100/USD," 49,98 ",0.055923," 0,00 "," 276,53 "," 226,55 ",2785293100,CFD," 0,00 "
05/08/2024 14:49:05,Open Position,AAPL/USD," 59,99 ",1.431818," 0,00 "," 276,53 "," 166,56 ",2785304301,CFD," 0,00 "
05/08/2024 14:54:39,Open Position,JPN225/JPY," 49,98 ",4.330153," 0,00 "," 276,53 "," 116,58 ",2785315968,CFD," 0,00 "
05/08/2024 15:03:49,Position closed,AAPL/USD," 61,15 ",1.431818," 1,16 "," 277,69 "," 177,73 ",2785304301,CFD," 0,00 "
05/08/2024 15:08:16,Position closed,JPN225/JPY," 51,42 ",4.330153," 1,44 "," 279,13 "," 229,15 ",2785315968,CFD," 0,00 "
05/08/2024 15:13:36,Open Position,NSDQ100/USD," 59,99 ",0.066691," 0,00 "," 279,13 "," 169,16 ",2785357635,CFD," 0,00 "
05/08/2024 15:44:06,Open Position,NSDQ100/USD," 50,00 ",0.055635," 0,00 "," 279,13 "," 119,16 ",2785425523,CFD," 0,00 "
05/08/2024 15:59:56,Position closed,NSDQ100/USD," 51,26 ",0.055635," 1,26 "," 280,39 "," 170,42 ",2785425523,CFD," 0,00 "
05/08/2024 16:03:53,Open Position,NSDQ100/USD," 49,99 ",0.055455," 0,00 "," 280,39 "," 120,43 ",2785473213,CFD," 0,00 "
05/08/2024 16:06:32,Position closed,NSDQ100/USD," 60,08 ",0.066691," 0,09 "," 280,48 "," 180,51 ",2785357635,CFD," 0,00 "
05/08/2024 16:14:05,Open Position,NSDQ100/USD," 50,00 ",0.055387," 0,00 "," 280,48 "," 130,51 ",2785492533,CFD," 0,00 "
05/08/2024 16:14:15,Position closed,NSDQ100/USD," 50,05 ",0.055387," 0,05 "," 280,53 "," 180,56 ",2785492533,CFD," 0,00 "
05/08/2024 16:14:41,Open Position,NSDQ100/USD," 49,99 ",0.055408," 0,00 "," 280,53 "," 130,57 ",2785493215,CFD," 0,00 "
05/08/2024 16:19:53,Open Position,NSDQ100/USD," 49,99 ",0.055285," 0,00 "," 280,53 "," 80,58 ",2785524484,CFD," 0,00 "
05/08/2024 16:29:08,Open Position,NSDQ100/USD," 49,99 ",0.055037," 0,00 "," 280,53 "," 30,59 ",2785540725,CFD," 0,00 "
05/08/2024 16:32:07,Position closed,NSDQ100/USD," 52,97 ",0.055037," 2,98 "," 283,51 "," 83,56 ",2785540725,CFD," 0,00 "
05/08/2024 16:33:29,Position closed,NSDQ100/USD," 49,62 ",0.055285,"(0,37)"," 283,14 "," 133,18 ",2785524484,CFD," 0,00 "
05/08/2024 16:34:37,Open Position,NSDQ100/USD," 50,00 ",0.055329," 0,00 "," 283,14 "," 83,18 ",2785553894,CFD," 0,00 "
05/08/2024 16:37:20,Position closed,NSDQ100/USD," 50,60 ",0.055408," 0,61 "," 283,75 "," 133,78 ",2785493215,CFD," 0,00 "
05/08/2024 16:37:39,Position closed,NSDQ100/USD," 49,99 ",0.055455," 0,00 "," 283,75 "," 183,77 ",2785473213,CFD," 0,00 "
05/08/2024 16:47:50,Open Position,NSDQ100/USD," 50,00 ",0.055579," 0,00 "," 283,75 "," 133,77 ",2785585883,CFD," 0,00 "
05/08/2024 18:46:11,Position closed,NSDQ100/USD," 53,47 ",0.055923," 3,49 "," 287,24 "," 187,24 ",2785293100,CFD," 0,00 "
05/08/2024 19:13:31,Open Position,NSDQ100/USD," 49,99 ",0.056129," 0,00 "," 287,24 "," 137,25 ",2785825227,CFD," 0,00 "
05/08/2024 22:27:30,Position closed,NSDQ100/USD," 57,66 ",0.055579," 7,66 "," 294,90 "," 194,91 ",2785585883,CFD," 0,00 "
05/08/2024 22:27:38,Position closed,NSDQ100/USD," 53,03 ",0.055329," 3,03 "," 297,93 "," 247,94 ",2785553894,CFD," 0,00 "
05/08/2024 22:32:25,Open Position,USD/JPY," 50,00 ",1500.000000," 0,00 "," 297,93 "," 197,94 ",2785899814,CFD," 0,00 "
05/08/2024 22:38:13,Position closed,USD/JPY," 51,07 ",1500.000000," 1,07 "," 299,00 "," 249,01 ",2785899814,CFD," 0,00 "
05/08/2024 22:46:08,Open Position,XAU/USD," 49,99 ",0.415208," 0,00 "," 299,00 "," 199,02 ",2785902324,CFD," 0,00 "
05/08/2024 22:47:29,Open Position,NSDQ100/USD," 50,00 ",0.055229," 0,00 "," 299,00 "," 149,02 ",2785902471,CFD," 0,00 "
06/08/2024 00:41:58,Dividend,NSDQ100/USD," 0,01 ",-," 0,01 "," 299,01 "," 149,03 ",2785553894,CFD," 0,00 "
06/08/2024 00:41:58,Dividend,NSDQ100/USD," 0,01 ",-," 0,01 "," 299,02 "," 149,04 ",2785585883,CFD," 0,00 "
06/08/2024 00:41:58,Dividend,NSDQ100/USD,"(0,02)",-,"(0,02)"," 299,00 "," 149,02 ",2785825227,CFD," 0,00 "
06/08/2024 00:48:15,Overnight refund,Daily," 0,01 ",-," 0,01 "," 299,01 "," 149,03 ",2785825227,CFD," 0,00 "
06/08/2024 00:48:15,Overnight fee,Daily,"(0,26)",-,"(0,26)"," 298,75 "," 148,77 ",2785553894,CFD," 0,00 "
06/08/2024 00:48:15,Overnight fee,Daily,"(0,27)",-,"(0,27)"," 298,48 "," 148,50 ",2785585883,CFD," 0,00 "
06/08/2024 01:09:42,Position closed,NSDQ100/USD," 24,95 ",0.056129,"(25,04)"," 273,44 "," 173,45 ",2785825227,CFD," 0,00 "
06/08/2024 04:51:42,Position closed,NSDQ100/USD," 56,42 ",0.055229," 6,42 "," 279,86 "," 229,87 ",2785902471,CFD," 0,00 "
06/08/2024 06:00:30,Open Position,NSDQ100/USD," 50,00 ",0.054868," 0,00 "," 279,86 "," 179,87 ",2785978514,CFD," 0,00 "
06/08/2024 06:08:01,Position closed,XAU/USD," 54,77 ",0.415208," 4,78 "," 284,64 "," 234,64 ",2785902324,CFD," 0,00 "
06/08/2024 06:11:57,Open Position,USD/JPY," 49,99 ",1500.000000," 0,00 "," 284,64 "," 184,65 ",2785981742,CFD," 0,00 "
06/08/2024 07:42:34,Position closed,USD/JPY," 52,28 ",1500.000000," 2,29 "," 286,93 "," 236,93 ",2785981742,CFD," 0,00 "
06/08/2024 08:13:10,Open Position,USD/JPY," 99,99 ",3000.000000," 0,00 "," 286,93 "," 136,94 ",2786092401,CFD," 0,00 "
06/08/2024 08:19:06,Position closed,USD/JPY," 106,34 ",3000.000000," 6,35 "," 293,28 "," 243,28 ",2786092401,CFD," 0,00 "
06/08/2024 08:24:02,Open Position,USD/JPY," 100,00 ",3000.000000," 0,00 "," 293,28 "," 143,28 ",2786097761,CFD," 0,00 "
06/08/2024 08:25:59,Open Position,XAU/USD," 49,99 ",0.414619," 0,00 "," 293,28 "," 93,29 ",2786098366,CFD," 0,00 "
06/08/2024 08:29:10,Position closed,USD/JPY," 102,42 ",3000.000000," 2,42 "," 295,70 "," 195,71 ",2786097761,CFD," 0,00 "
06/08/2024 08:30:04,Open Position,USD/JPY," 149,99 ",4500.000000," 0,00 "," 295,70 "," 45,72 ",2786100428,CFD," 0,00 "
06/08/2024 09:01:46,Position closed,USD/JPY," 157,83 ",4500.000000," 7,84 "," 303,54 "," 203,55 ",2786100428,CFD," 0,00 "
06/08/2024 09:06:22,Open Position,USD/JPY," 149,99 ",4500.000000," 0,00 "," 303,54 "," 53,56 ",2786113841,CFD," 0,00 "
06/08/2024 09:22:00,Position closed,USD/JPY," 155,89 ",4500.000000," 5,90 "," 309,44 "," 209,45 ",2786113841,CFD," 0,00 "
06/08/2024 09:29:47,Open Position,USD/JPY," 149,99 ",4500.000000," 0,00 "," 309,44 "," 59,46 ",2786122017,CFD," 0,00 "
06/08/2024 09:38:36,Position closed,USD/JPY," 157,49 ",4500.000000," 7,50 "," 316,94 "," 216,95 ",2786122017,CFD," 0,00 "
06/08/2024 09:40:37,Open Position,VIX.SEP24/USD," 99,99 ",36.166365," 0,00 "," 316,94 "," 116,96 ",2786125817,CFD," 0,00 "
06/08/2024 09:47:50,Position closed,VIX.SEP24/USD," 101,80 ",36.166365," 1,81 "," 318,75 "," 218,76 ",2786125817,CFD," 0,00 "
06/08/2024 09:51:09,Open Position,XAU/USD," 59,99 ",0.497372," 0,00 "," 318,75 "," 158,77 ",2786128978,CFD," 0,00 "
06/08/2024 09:53:10,Open Position,NSDQ100/USD," 50,00 ",0.055716," 0,00 "," 318,75 "," 108,77 ",2786129582,CFD," 0,00 "
06/08/2024 10:06:00,Open Position,USD/JPY," 100,00 ",3000.000000," 0,00 "," 318,75 "," 8,77 ",2786134118,CFD," 0,00 "
06/08/2024 10:14:27,Position closed,NSDQ100/USD," 52,45 ",0.055716," 2,45 "," 321,20 "," 61,22 ",2786129582,CFD," 0,00 "
06/08/2024 10:27:41,Position closed,USD/JPY," 103,40 ",3000.000000," 3,40 "," 324,60 "," 164,62 ",2786134118,CFD," 0,00 "
06/08/2024 10:28:24,Open Position,USD/JPY," 99,99 ",3000.000000," 0,00 "," 324,60 "," 64,63 ",2786139390,CFD," 0,00 "
06/08/2024 11:26:58,Open Position,USD/JPY," 49,99 ",1500.000000," 0,00 "," 324,60 "," 14,64 ",2786159992,CFD," 0,00 "
06/08/2024 12:26:06,Position closed,USD/JPY," 54,87 ",1500.000000," 4,88 "," 329,48 "," 69,51 ",2786159992,CFD," 0,00 "
06/08/2024 12:26:18,Position closed,USD/JPY," 99,22 ",3000.000000,"(0,77)"," 328,71 "," 168,73 ",2786139390,CFD," 0,00 "
06/08/2024 12:27:01,Position closed,XAU/USD," 52,98 ",0.414619," 2,99 "," 331,70 "," 221,71 ",2786098366,CFD," 0,00 "
06/08/2024 12:27:09,Position closed,XAU/USD," 64,13 ",0.497372," 4,14 "," 335,84 "," 285,84 ",2786128978,CFD," 0,00 "
06/08/2024 12:50:12,Open Position,USD/JPY," 79,99 ",2400.000000," 0,00 "," 335,84 "," 205,85 ",2786188565,CFD," 0,00 "
06/08/2024 12:59:23,Position closed,USD/JPY," 81,91 ",2400.000000," 1,92 "," 337,76 "," 287,76 ",2786188565,CFD," 0,00 "
06/08/2024 13:05:15,Open Position,USD/JPY," 79,99 ",2400.000000," 0,00 "," 337,76 "," 207,77 ",2786194410,CFD," 0,00 "
06/08/2024 13:10:06,Open Position,NSDQ100/USD," 49,99 ",0.055619," 0,00 "," 337,76 "," 157,78 ",2786196508,CFD," 0,00 "
06/08/2024 13:12:54,Position closed,NSDQ100/USD," 50,22 ",0.055619," 0,23 "," 337,99 "," 208,00 ",2786196508,CFD," 0,00 "
06/08/2024 13:13:11,Position closed,USD/JPY," 84,23 ",2400.000000," 4,24 "," 342,23 "," 292,23 ",2786194410,CFD," 0,00 "
06/08/2024 13:15:16,Open Position,USD/JPY," 199,99 ",6000.000000," 0,00 "," 342,23 "," 92,24 ",2786198015,CFD," 0,00 "
06/08/2024 13:22:58,Open Position,USD/JPY," 49,99 ",1500.000000," 0,00 "," 342,23 "," 42,25 ",2786200863,CFD," 0,00 "
06/08/2024 13:27:15,Position closed,USD/JPY," 48,98 ",1500.000000,"(1,01)"," 341,22 "," 91,23 ",2786200863,CFD," 0,00 "
06/08/2024 13:34:57,Position closed,USD/JPY," 199,41 ",6000.000000,"(0,58)"," 340,64 "," 290,64 ",2786198015,CFD," 0,00 "
06/08/2024 13:35:23,Open Position,USD/JPY," 79,99 ",2400.000000," 0,00 "," 340,64 "," 210,65 ",2786327007,CFD," 0,00 "
06/08/2024 13:41:23,Position closed,USD/JPY," 83,27 ",2400.000000," 3,28 "," 343,92 "," 293,92 ",2786327007,CFD," 0,00 "
06/08/2024 13:43:31,Open Position,USD/JPY," 80,00 ",2400.000000," 0,00 "," 343,92 "," 213,92 ",2786459308,CFD," 0,00 "
06/08/2024 13:53:09,Position closed,USD/JPY," 83,09 ",2400.000000," 3,09 "," 347,01 "," 297,01 ",2786459308,CFD," 0,00 "
06/08/2024 13:53:30,Position closed,NSDQ100/USD," 38,12 ",0.054868,"(11,88)"," 335,13 "," 335,13 ",2785978514,CFD," 0,00 "
06/08/2024 13:57:26,Open Position,USD/JPY," 79,99 ",2400.000000," 0,00 "," 335,13 "," 255,14 ",2786591430,CFD," 0,00 "
06/08/2024 14:02:15,Position closed,USD/JPY," 82,85 ",2400.000000," 2,86 "," 337,99 "," 337,99 ",2786591430,CFD," 0,00 "
06/08/2024 14:05:23,Open Position,XAU/USD," 49,99 ",0.416480," 0,00 "," 337,99 "," 288,00 ",2786609858,CFD," 0,00 "
06/08/2024 14:24:15,Open Position,USD/JPY," 79,99 ",2400.000000," 0,00 "," 337,99 "," 208,01 ",2786676426,CFD," 0,00 "
06/08/2024 14:31:15,Position closed,USD/JPY," 82,63 ",2400.000000," 2,64 "," 340,63 "," 290,64 ",2786676426,CFD," 0,00 "
06/08/2024 14:32:31,Position closed,XAU/USD," 55,86 ",0.416480," 5,87 "," 346,50 "," 346,50 ",2786609858,CFD," 0,00 "
06/08/2024 15:04:05,Open Position,JPN225/JPY," 100,00 ",8.591251," 0,00 "," 346,50 "," 246,50 ",2786785217,CFD," 0,00 "
06/08/2024 15:04:55,Open Position,USD/JPY," 99,99 ",3000.000000," 0,00 "," 346,50 "," 146,51 ",2786786607,CFD," 0,00 "
06/08/2024 15:12:49,Open Position,NSDQ100/USD," 49,99 ",0.055071," 0,00 "," 346,50 "," 96,52 ",2786800109,CFD," 0,00 "
06/08/2024 15:36:25,Open Position,USD/JPY," 33,34 ",1000.200000," 0,00 "," 346,50 "," 63,18 ",2786834682,CFD," 0,00 "
06/08/2024 15:36:46,Position closed,USD/JPY," 33,28 ",1000.200000,"(0,06)"," 346,44 "," 96,46 ",2786834682,CFD," 0,00 "
06/08/2024 15:37:20,Open Position,USD/JPY," 79,99 ",2400.000000," 0,00 "," 346,44 "," 16,47 ",2786836700,CFD," 0,00 "
06/08/2024 16:33:23,Position closed,JPN225/JPY," 97,93 ",8.591251,"(2,07)"," 344,37 "," 114,40 ",2786785217,CFD," 0,00 "
06/08/2024 20:00:40,Position closed,NSDQ100/USD," 55,31 ",0.055071," 5,32 "," 349,69 "," 169,71 ",2786800109,CFD," 0,00 "
06/08/2024 20:01:25,Position closed,USD/JPY," 104,47 ",3000.000000," 4,48 "," 354,17 "," 274,18 ",2786786607,CFD," 0,00 "
06/08/2024 20:01:34,Position closed,USD/JPY," 89,39 ",2400.000000," 9,40 "," 363,57 "," 363,57 ",2786836700,CFD," 0,00 "
06/08/2024 20:23:26,Open Position,USD/JPY," 49,99 ",1500.000000," 0,00 "," 363,57 "," 313,58 ",2787118005,CFD," 0,00 "
06/08/2024 20:24:04,Open Position,XAU/USD," 79,99 ",0.669820," 0,00 "," 363,57 "," 233,59 ",2787118101,CFD," 0,00 "
06/08/2024 20:24:56,Open Position,EuroOIL/USD," 100,00 ",13.104442," 0,00 "," 363,57 "," 133,59 ",2787118844,CFD," 0,00 "
06/08/2024 20:51:17,Position closed,USD/JPY," 52,94 ",1500.000000," 2,95 "," 366,52 "," 186,53 ",2787118005,CFD," 0,00 "
06/08/2024 20:52:32,Open Position,NSDQ100/USD," 100,00 ",0.111190," 0,00 "," 366,52 "," 86,53 ",2787122499,CFD," 0,00 "
07/08/2024 00:36:25,Dividend,NSDQ100/USD,"(0,04)",-,"(0,04)"," 366,48 "," 86,49 ",2786800109,CFD," 0,00 "
07/08/2024 00:48:42,Overnight fee,Daily,"(0,42)",-,"(0,42)"," 366,06 "," 86,07 ",2787118101,CFD," 0,00 "
07/08/2024 00:48:42,Overnight fee,Daily,"(0,53)",-,"(0,53)"," 365,53 "," 85,54 ",2787122499,CFD," 0,00 "
07/08/2024 00:48:42,Overnight refund,Daily," 0,01 ",-," 0,01 "," 365,54 "," 85,55 ",2787118844,CFD," 0,00 "
07/08/2024 06:27:20,Position closed,EuroOIL/USD," 100,00 ",13.104442," 0,00 "," 365,54 "," 185,55 ",2787118844,CFD," 0,00 "
07/08/2024 06:28:13,Position closed,XAU/USD," 83,74 ",0.669820," 3,75 "," 369,29 "," 269,29 ",2787118101,CFD," 0,00 "
07/08/2024 06:29:22,Position closed,NSDQ100/USD," 124,07 ",0.111190," 24,07 "," 393,36 "," 393,36 ",2787122499,CFD," 0,00 "
07/08/2024 07:01:02,Open Position,NSDQ100/USD," 50,00 ",0.055011," 0,00 "," 393,36 "," 343,36 ",2787196872,CFD," 0,00 "
07/08/2024 07:02:59,Open Position,USD/JPY," 99,99 ",3000.000000," 0,00 "," 393,36 "," 243,37 ",2787198099,CFD," 0,00 "
07/08/2024 07:11:20,Open Position,NSDQ100/USD," 69,99 ",0.076900," 0,00 "," 393,36 "," 173,38 ",2787201542,CFD," 0,00 "
07/08/2024 07:11:56,Position closed,NSDQ100/USD," 70,67 ",0.076900," 0,68 "," 394,04 "," 244,05 ",2787201542,CFD," 0,00 "
07/08/2024 07:15:51,Open Position,USD/JPY," 70,00 ",2100.000000," 0,00 "," 394,04 "," 174,05 ",2787202747,CFD," 0,00 "
07/08/2024 07:20:54,Open Position,NSDQ100/USD," 50,00 ",0.055046," 0,00 "," 394,04 "," 124,05 ",2787210190,CFD," 0,00 "
07/08/2024 07:23:06,Position closed,USD/JPY," 105,20 ",3000.000000," 5,21 "," 399,25 "," 229,25 ",2787198099,CFD," 0,00 "
07/08/2024 07:25:44,Open Position,NSDQ100/USD," 59,99 ",0.066177," 0,00 "," 399,25 "," 169,26 ",2787216397,CFD," 0,00 "
07/08/2024 07:26:18,Open Position,USD/JPY," 50,00 ",1500.000000," 0,00 "," 399,25 "," 119,26 ",2787216567,CFD," 0,00 "
07/08/2024 07:28:06,Open Position,USD/JPY," 99,99 ",3000.000000," 0,00 "," 399,25 "," 19,27 ",2787217260,CFD," 0,00 "
07/08/2024 07:32:42,Position closed,USD/JPY," 98,86 ",3000.000000,"(1,13)"," 398,12 "," 118,13 ",2787217260,CFD," 0,00 "
07/08/2024 08:00:47,Position closed,USD/JPY," 54,56 ",1500.000000," 4,56 "," 402,68 "," 172,69 ",2787216567,CFD," 0,00 "
07/08/2024 08:09:40,Position closed,USD/JPY," 72,54 ",2100.000000," 2,54 "," 405,22 "," 245,23 ",2787202747,CFD," 0,00 "
07/08/2024 08:13:20,Position closed,NSDQ100/USD," 53,02 ",0.055011," 3,02 "," 408,24 "," 298,25 ",2787196872,CFD," 0,00 "
07/08/2024 08:27:39,Position closed,NSDQ100/USD," 53,72 ",0.055046," 3,72 "," 411,96 "," 351,97 ",2787210190,CFD," 0,00 "
07/08/2024 08:29:45,Open Position,NSDQ100/USD," 89,99 ",0.098622," 0,00 "," 411,96 "," 261,98 ",2787234455,CFD," 0,00 "
07/08/2024 08:32:09,Open Position,USD/JPY," 99,99 ",3000.000000," 0,00 "," 411,96 "," 161,99 ",2787235280,CFD," 0,00 "
07/08/2024 09:04:34,Open Position,USD/JPY," 49,99 ",1500.000000," 0,00 "," 411,96 "," 112,00 ",2787251087,CFD," 0,00 "
07/08/2024 11:04:56,Open Position,NSDQ100/USD," 49,99 ",0.054533," 0,00 "," 411,96 "," 62,01 ",2787289025,CFD," 0,00 "
07/08/2024 11:57:00,Position closed,NSDQ100/USD," 52,37 ",0.054533," 2,38 "," 414,34 "," 114,38 ",2787289025,CFD," 0,00 "
07/08/2024 12:03:05,Open Position,NSDQ100/USD," 50,00 ",0.054702," 0,00 "," 414,34 "," 64,38 ",2787327433,CFD," 0,00 "
07/08/2024 12:18:44,Position closed,NSDQ100/USD," 51,68 ",0.054702," 1,68 "," 416,02 "," 116,06 ",2787327433,CFD," 0,00 "
07/08/2024 13:11:08,Open Position,NSDQ100/USD," 100,00 ",0.109100," 0,00 "," 416,02 "," 16,06 ",2787350461,CFD," 0,00 "
07/08/2024 13:49:15,Position closed,NSDQ100/USD," 109,61 ",0.109100," 9,61 "," 425,63 "," 125,67 ",2787350461,CFD," 0,00 "
07/08/2024 13:55:26,Open Position,NSDQ100/USD," 49,99 ",0.054404," 0,00 "," 425,63 "," 75,68 ",2787608939,CFD," 0,00 "
07/08/2024 14:15:36,Position closed,NSDQ100/USD," 51,80 ",0.054404," 1,81 "," 427,44 "," 127,48 ",2787608939,CFD," 0,00 "
07/08/2024 14:17:09,Position closed,USD/JPY," 52,75 ",1500.000000," 2,76 "," 430,20 "," 180,23 ",2787251087,CFD," 0,00 "
07/08/2024 14:17:15,Position closed,USD/JPY," 99,32 ",3000.000000,"(0,67)"," 429,53 "," 279,55 ",2787235280,CFD," 0,00 "
07/08/2024 14:21:37,Open Position,USD/JPY," 100,00 ",3000.000000," 0,00 "," 429,53 "," 179,55 ",2787654531,CFD," 0,00 "
07/08/2024 14:29:01,Position closed,NSDQ100/USD," 83,31 ",0.098622,"(6,68)"," 422,85 "," 262,86 ",2787234455,CFD," 0,00 "
07/08/2024 14:30:23,Open Position,NSDQ100/USD," 70,00 ",0.076427," 0,00 "," 422,85 "," 192,86 ",2787667324,CFD," 0,00 "
07/08/2024 14:33:00,Open Position,USD/JPY," 50,00 ",1500.000000," 0,00 "," 422,85 "," 142,86 ",2787670330,CFD," 0,00 "
07/08/2024 14:37:16,Position closed,NSDQ100/USD," 71,56 ",0.076427," 1,56 "," 424,41 "," 214,42 ",2787667324,CFD," 0,00 "
07/08/2024 14:39:34,Open Position,NSDQ100/USD," 149,97 ",0.163658," 0,00 "," 424,41 "," 64,45 ",2787678746,CFD," 0,00 "
07/08/2024 14:43:12,Position closed,NSDQ100/USD," 154,92 ",0.163658," 4,95 "," 429,36 "," 219,37 ",2787678746,CFD," 0,00 "
07/08/2024 14:43:25,Position closed,USD/JPY," 51,57 ",1500.000000," 1,57 "," 430,93 "," 270,94 ",2787670330,CFD," 0,00 "
07/08/2024 14:43:35,Position closed,USD/JPY," 101,86 ",3000.000000," 1,86 "," 432,79 "," 372,80 ",2787654531,CFD," 0,00 "
07/08/2024 14:45:35,Open Position,NSDQ100/USD," 99,99 ",0.108632," 0,00 "," 432,79 "," 272,81 ",2787687077,CFD," 0,00 "
07/08/2024 14:50:18,Position closed,NSDQ100/USD," 99,20 ",0.108632,"(0,79)"," 432,00 "," 372,01 ",2787687077,CFD," 0,00 "
07/08/2024 14:54:17,Open Position,USD/JPY," 99,99 ",3000.000000," 0,00 "," 432,00 "," 272,02 ",2787697627,CFD," 0,00 "
07/08/2024 14:55:44,Open Position,NSDQ100/USD," 99,99 ",0.108631," 0,00 "," 432,00 "," 172,03 ",2787699199,CFD," 0,00 "
07/08/2024 14:58:24,Position closed,NSDQ100/USD," 100,11 ",0.108631," 0,12 "," 432,12 "," 272,14 ",2787699199,CFD," 0,00 "
07/08/2024 15:50:29,Open Position,NSDQ100/USD," 99,99 ",0.109539," 0,00 "," 432,12 "," 172,15 ",2787755616,CFD," 0,00 "
07/08/2024 15:54:32,Position closed,NSDQ100/USD," 103,44 ",0.109539," 3,45 "," 435,57 "," 275,59 ",2787755616,CFD," 0,00 "
07/08/2024 15:58:14,Open Position,NSDQ100/USD," 99,99 ",0.109332," 0,00 "," 435,57 "," 175,60 ",2787765710,CFD," 0,00 "
07/08/2024 16:04:58,Position closed,NSDQ100/USD," 55,95 ",0.066177,"(4,04)"," 431,53 "," 231,55 ",2787216397,CFD," 0,00 "
07/08/2024 16:05:09,Open Position,NSDQ100/USD," 99,98 ",0.109873," 0,00 "," 431,53 "," 131,57 ",2787770959,CFD," 0,00 "
07/08/2024 16:17:49,Position closed,NSDQ100/USD," 103,84 ",0.109873," 3,86 "," 435,39 "," 235,41 ",2787770959,CFD," 0,00 "
07/08/2024 16:18:24,Position closed,USD/JPY," 95,63 ",3000.000000,"(4,36)"," 431,03 "," 331,04 ",2787697627,CFD," 0,00 "
07/08/2024 16:20:37,Position closed,NSDQ100/USD," 95,56 ",0.109332,"(4,43)"," 426,60 "," 426,60 ",2787765710,CFD," 0,00 "
07/08/2024 16:21:31,Open Position,NSDQ100/USD," 65,00 ",0.054694," 0,00 "," 426,60 "," 376,60 ",2787784761,CFD," 0,00 "
07/08/2024 16:23:38,Open Position,NSDQ100/USD," 124,99 ",0.109428," 0,00 "," 426,60 "," 276,61 ",2787786521,CFD," 0,00 "
07/08/2024 16:27:35,Open Position,USD/JPY," 49,99 ",1500.000000," 0,00 "," 426,60 "," 226,62 ",2787789263,CFD," 0,00 "
07/08/2024 18:06:01,Position closed,USD/JPY," 54,43 ",1500.000000," 4,44 "," 431,04 "," 281,05 ",2787789263,CFD," 0,00 "
07/08/2024 18:08:32,Open Position,NSDQ100/USD," 149,99 ",0.166839," 0,00 "," 431,04 "," 131,06 ",2787961606,CFD," 0,00 "
07/08/2024 18:20:43,Edit Stop Loss,-,"(15,00)",-," 0,00 "," 431,04 "," 116,06 ",2787784761,-," 0,00 "
07/08/2024 18:21:09,Edit Stop Loss,-,"(25,00)",-," 0,00 "," 431,04 "," 91,06 ",2787786521,-," 0,00 "
08/08/2024 00:14:28,Dividend,NSDQ100/USD," 0,02 ",-," 0,02 "," 431,06 "," 91,08 ",2787784761,CFD," 0,00 "
08/08/2024 00:14:28,Dividend,NSDQ100/USD," 0,04 ",-," 0,04 "," 431,10 "," 91,12 ",2787786521,CFD," 0,00 "
08/08/2024 00:14:28,Dividend,NSDQ100/USD," 0,05 ",-," 0,05 "," 431,15 "," 91,17 ",2787961606,CFD," 0,00 "
08/08/2024 00:48:53,Overnight fee,Daily,"(0,52)",-,"(0,52)"," 430,63 "," 90,65 ",2787786521,CFD," 0,00 "
08/08/2024 00:48:53,Overnight fee,Daily,"(0,26)",-,"(0,26)"," 430,37 "," 90,39 ",2787784761,CFD," 0,00 "
08/08/2024 00:48:53,Overnight fee,Daily,"(0,80)",-,"(0,80)"," 429,57 "," 89,59 ",2787961606,CFD," 0,00 "
08/08/2024 05:39:31,Open Position,NSDQ100/USD," 50,00 ",0.056014," 0,00 "," 429,57 "," 39,59 ",2788128872,CFD," 0,00 "
08/08/2024 06:06:18,Open Position,USD/JPY," 33,33 ",1000.200000," 0,00 "," 429,57 "," 6,26 ",2788132120,CFD," 0,00 "
08/08/2024 06:43:26,Position closed,NSDQ100/USD," 53,64 ",0.056014," 3,64 "," 433,21 "," 59,90 ",2788128872,CFD," 0,00 "
08/08/2024 06:48:46,Open Position,NSDQ100/USD," 50,00 ",0.055857," 0,00 "," 433,21 "," 9,90 ",2788139325,CFD," 0,00 "
08/08/2024 07:05:01,Position closed,USD/JPY," 35,41 ",1000.200000," 2,08 "," 435,29 "," 45,31 ",2788132120,CFD," 0,00 "
08/08/2024 07:06:03,Open Position,USD/JPY," 45,00 ",1350.000000," 0,00 "," 435,29 "," 0,31 ",2788153543,CFD," 0,00 "
08/08/2024 08:52:18,Position closed,USD/JPY," 47,06 ",1350.000000," 2,06 "," 437,35 "," 47,37 ",2788153543,CFD," 0,00 "
08/08/2024 09:54:53,Open Position,USD/JPY," 40,00 ",1200.000000," 0,00 "," 437,35 "," 7,37 ",2788236463,CFD," 0,00 "
08/08/2024 12:30:03,Position closed,USD/JPY," 42,01 ",1200.000000," 2,01 "," 439,36 "," 49,38 ",2788236463,CFD," 0,00 "
08/08/2024 12:30:35,Position closed,NSDQ100/USD," 56,94 ",0.055857," 6,94 "," 446,30 "," 106,32 ",2788139325,CFD," 0,00 "
08/08/2024 12:30:40,Position closed,NSDQ100/USD," 160,04 ",0.166839," 10,05 "," 456,35 "," 266,36 ",2787961606,CFD," 0,00 "
08/08/2024 12:33:06,Open Position,NSDQ100/USD," 99,99 ",0.110969," 0,00 "," 456,35 "," 166,37 ",2788280336,CFD," 0,00 "
08/08/2024 12:34:24,Position closed,NSDQ100/USD," 99,15 ",0.110969,"(0,84)"," 455,51 "," 265,52 ",2788280336,CFD," 0,00 "
08/08/2024 12:34:39,Open Position,NSDQ100/USD," 70,00 ",0.077649," 0,00 "," 455,51 "," 195,52 ",2788281038,CFD," 0,00 "
08/08/2024 12:37:48,Open Position,NSDQ100/USD," 70,00 ",0.077499," 0,00 "," 455,51 "," 125,52 ",2788282560,CFD," 0,00 "
08/08/2024 12:43:15,Position closed,NSDQ100/USD," 71,49 ",0.077499," 1,49 "," 457,00 "," 197,01 ",2788282560,CFD," 0,00 "
08/08/2024 12:53:10,Position closed,NSDQ100/USD," 73,86 ",0.077649," 3,86 "," 460,86 "," 270,87 ",2788281038,CFD," 0,00 "
08/08/2024 12:56:14,Open Position,NSDQ100/USD," 149,99 ",0.165897," 0,00 "," 460,86 "," 120,88 ",2788290837,CFD," 0,00 "
08/08/2024 13:30:53,Open Position,NVDA/USD," 49,99 ",2.463248," 0,00 "," 460,86 "," 70,89 ",2788356928,CFD," 0,00 "
08/08/2024 13:35:56,Position closed,NSDQ100/USD," 154,23 ",0.165897," 4,24 "," 465,10 "," 225,12 ",2788290837,CFD," 0,00 "
08/08/2024 13:37:44,Open Position,NSDQ100/USD," 149,98 ",0.165930," 0,00 "," 465,10 "," 75,14 ",2788385487,CFD," 0,00 "
08/08/2024 13:41:13,Open Position,NSDQ100/USD," 49,99 ",0.055390," 0,00 "," 465,10 "," 25,15 ",2788392804,CFD," 0,00 "
08/08/2024 13:42:04,Position closed,NSDQ100/USD," 150,21 ",0.165930," 0,23 "," 465,33 "," 175,36 ",2788385487,CFD," 0,00 "
08/08/2024 13:47:27,Position closed,NSDQ100/USD," 51,78 ",0.055390," 1,79 "," 467,12 "," 227,14 ",2788392804,CFD," 0,00 "
08/08/2024 13:51:21,Open Position,NSDQ100/USD," 130,30 ",0.111294," 0,00 "," 467,12 "," 127,14 ",2788461865,CFD," 0,00 "
08/08/2024 14:05:15,Position closed,NVDA/USD," 47,91 ",2.463248,"(2,08)"," 465,04 "," 175,05 ",2788356928,CFD," 0,00 "
08/08/2024 14:05:33,Position closed,NSDQ100/USD," 58,24 ",0.054694,"(6,76)"," 458,28 "," 233,29 ",2787784761,CFD," 0,00 "
08/08/2024 14:06:21,Open Position,NSDQ100/USD," 105,91 ",0.110131," 0,00 "," 458,28 "," 133,29 ",2788523687,CFD," 0,00 "
08/08/2024 14:15:15,Open Position,NSDQ100/USD," 84,99 ",0.054981," 0,00 "," 458,28 "," 83,30 ",2788535450,CFD," 0,00 "
08/08/2024 14:44:17,Edit Stop Loss,-,"(10,30)",-," 0,00 "," 458,28 "," 73,00 ",2788461865,-," 0,00 "
08/08/2024 14:48:02,Position closed,NSDQ100/USD," 127,38 ",0.109428," 2,39 "," 460,67 "," 200,38 ",2787786521,CFD," 0,00 "
08/08/2024 14:50:50,Open Position,NSDQ100/USD," 99,98 ",0.109135," 0,00 "," 460,67 "," 100,40 ",2788589832,CFD," 0,00 "
08/08/2024 14:51:36,Edit Stop Loss,-,"(5,00)",-," 0,00 "," 460,67 "," 95,40 ",2788535450,-," 0,00 "
08/08/2024 14:51:48,Edit Stop Loss,-,"(10,00)",-," 0,00 "," 460,67 "," 85,40 ",2788535450,-," 0,00 "
08/08/2024 14:53:03,Edit Stop Loss,-,"(20,00)",-," 0,00 "," 460,67 "," 65,40 ",2788461865,-," 0,00 "
08/08/2024 16:23:39,Open Position,NSDQ100/USD," 50,00 ",0.054506," 0,00 "," 460,67 "," 15,40 ",2788698330,CFD," 0,00 "
08/08/2024 16:23:54,Position closed,NSDQ100/USD," 49,83 ",0.054506,"(0,17)"," 460,50 "," 65,23 ",2788698330,CFD," 0,00 "
08/08/2024 21:23:28,Edit Stop Loss,-,"(20,00)",-," 0,00 "," 460,50 "," 45,23 ",2788535450,-," 0,00 "
09/08/2024 00:48:37,Overnight refund,Daily," 0,02 ",-," 0,02 "," 460,52 "," 45,25 ",2788589832,CFD," 0,00 "
09/08/2024 00:48:37,Overnight refund,Daily," 0,01 ",-," 0,01 "," 460,53 "," 45,26 ",2788535450,CFD," 0,00 "
09/08/2024 00:48:37,Overnight refund,Daily," 0,02 ",-," 0,02 "," 460,55 "," 45,28 ",2788523687,CFD," 0,00 "
09/08/2024 00:48:37,Overnight refund,Daily," 0,02 ",-," 0,02 "," 460,57 "," 45,30 ",2788461865,CFD," 0,00 "
09/08/2024 01:03:46,Dividend,NSDQ100/USD,"(0,11)",-,"(0,11)"," 460,46 "," 45,19 ",2788461865,CFD," 0,00 "
09/08/2024 01:03:46,Dividend,NSDQ100/USD,"(0,11)",-,"(0,11)"," 460,35 "," 45,08 ",2788523687,CFD," 0,00 "
09/08/2024 01:03:46,Dividend,NSDQ100/USD,"(0,05)",-,"(0,05)"," 460,30 "," 45,03 ",2788535450,CFD," 0,00 "
09/08/2024 01:03:46,Dividend,NSDQ100/USD,"(0,11)",-,"(0,11)"," 460,19 "," 44,92 ",2788589832,CFD," 0,00 "
09/08/2024 08:54:57,Deposit Conversion Fee,-,"(1,50)",-," 0,00 "," 567,82 "," 152,55 ",-,-," 0,00 "
09/08/2024 08:54:57,Deposit,100.00 EUR CreditCard," 107,63 ",-," 107,63 "," 567,82 "," 152,55 ",-,-," 0,00 "
09/08/2024 08:56:35,Open Position,NSDQ100/USD," 49,99 ",0.053928," 0,00 "," 567,82 "," 102,56 ",2788949883,CFD," 0,00 "
09/08/2024 09:05:15,Open Position,USD/JPY," 99,99 ",3000.000000," 0,00 "," 567,82 "," 2,57 ",2788951806,CFD," 0,00 "
09/08/2024 09:56:29,Position closed,NSDQ100/USD," 51,07 ",0.053928," 1,08 "," 568,90 "," 53,64 ",2788949883,CFD," 0,00 "
09/08/2024 09:56:40,Open Position,NSDQ100/USD," 50,00 ",0.053981," 0,00 "," 568,90 "," 3,64 ",2788961999,CFD," 0,00 "
09/08/2024 10:08:16,Position closed,NSDQ100/USD," 47,20 ",0.053981,"(2,80)"," 566,10 "," 50,84 ",2788961999,CFD," 0,00 "
09/08/2024 10:10:19,Open Position,NSDQ100/USD," 49,99 ",0.054154," 0,00 "," 566,10 "," 0,85 ",2788964882,CFD," 0,00 "
09/08/2024 10:22:44,Position closed,NSDQ100/USD," 49,64 ",0.054154,"(0,35)"," 565,75 "," 50,49 ",2788964882,CFD," 0,00 "
09/08/2024 10:30:11,Edit Stop Loss,-,"(5,91)",-," 0,00 "," 565,75 "," 44,58 ",2788523687,-," 0,00 "
09/08/2024 11:02:44,Position closed,USD/JPY," 103,58 ",3000.000000," 3,59 "," 569,34 "," 148,16 ",2788951806,CFD," 0,00 "
09/08/2024 11:13:49,Open Position,USD/JPY," 49,99 ",1500.000000," 0,00 "," 569,34 "," 98,17 ",2788977119,CFD," 0,00 "
09/08/2024 11:15:26,Open Position,NSDQ100/USD," 90,00 ",0.097361," 0,00 "," 569,34 "," 8,17 ",2788977300,CFD," 0,00 "
09/08/2024 12:21:38,Position closed,USD/JPY," 52,50 ",1500.000000," 2,51 "," 571,85 "," 60,67 ",2788977119,CFD," 0,00 "
09/08/2024 12:23:57,Open Position,USD/JPY," 50,00 ",1500.000000," 0,00 "," 571,85 "," 10,67 ",2789016004,CFD," 0,00 "
09/08/2024 12:43:18,Position closed,NSDQ100/USD," 100,14 ",0.109135," 0,16 "," 572,01 "," 110,81 ",2788589832,CFD," 0,00 "
09/08/2024 12:46:29,Open Position,NSDQ100/USD," 50,00 ",0.054549," 0,00 "," 572,01 "," 60,81 ",2789036052,CFD," 0,00 "
09/08/2024 12:56:13,Position closed,NSDQ100/USD," 76,58 ",0.054981,"(8,41)"," 563,60 "," 137,39 ",2788535450,CFD," 0,00 "
09/08/2024 12:57:29,Open Position,NSDQ100/USD," 50,00 ",0.054525," 0,00 "," 563,60 "," 87,39 ",2789040704,CFD," 0,00 "
09/08/2024 13:15:48,Open Position,NSDQ100/USD," 70,00 ",0.076251," 0,00 "," 563,60 "," 17,39 ",2789044720,CFD," 0,00 "
09/08/2024 13:30:07,Position closed,NSDQ100/USD," 82,25 ",0.110131,"(23,66)"," 539,94 "," 99,64 ",2788523687,CFD," 0,00 "
09/08/2024 13:30:44,Open Position,NSDQ100/USD," 50,00 ",0.054419," 0,00 "," 539,94 "," 49,64 ",2789101428,CFD," 0,00 "
09/08/2024 13:32:06,Position closed,NSDQ100/USD," 84,37 ",0.111294,"(45,93)"," 494,01 "," 134,01 ",2788461865,CFD," 0,00 "
09/08/2024 13:32:14,Open Position,NSDQ100/USD," 50,00 ",0.054404," 0,00 "," 494,01 "," 84,01 ",2789112597,CFD," 0,00 "
09/08/2024 13:33:15,Open Position,NSDQ100/USD," 50,00 ",0.054395," 0,00 "," 494,01 "," 34,01 ",2789114262,CFD," 0,00 "
09/08/2024 17:34:26,Position closed,NSDQ100/USD," 84,85 ",0.076251," 14,85 "," 508,86 "," 118,86 ",2789044720,CFD," 0,00 "
09/08/2024 17:34:26,Position closed,NSDQ100/USD," 62,17 ",0.054549," 12,17 "," 521,03 "," 181,03 ",2789036052,CFD," 0,00 "
09/08/2024 17:34:26,Position closed,NSDQ100/USD," 96,54 ",0.097361," 6,54 "," 527,57 "," 277,57 ",2788977300,CFD," 0,00 "
09/08/2024 17:34:26,Position closed,NSDQ100/USD," 61,72 ",0.054525," 11,72 "," 539,29 "," 339,29 ",2789040704,CFD," 0,00 "
09/08/2024 17:34:26,Position closed,NSDQ100/USD," 59,47 ",0.054404," 9,47 "," 548,76 "," 398,76 ",2789112597,CFD," 0,00 "
09/08/2024 17:34:26,Position closed,NSDQ100/USD," 59,76 ",0.054419," 9,76 "," 558,52 "," 458,52 ",2789101428,CFD," 0,00 "
09/08/2024 17:34:26,Position closed,NSDQ100/USD," 59,31 ",0.054395," 9,31 "," 567,83 "," 517,83 ",2789114262,CFD," 0,00 "
09/08/2024 17:42:45,Open Position,NSDQ100/USD," 49,99 ",0.053962," 0,00 "," 567,83 "," 467,84 ",2789590798,CFD," 0,00 "
09/08/2024 18:27:50,Position closed,NSDQ100/USD," 52,09 ",0.053962," 2,10 "," 569,93 "," 519,93 ",2789590798,CFD," 0,00 "
09/08/2024 18:52:49,Open Position,NSDQ100/USD," 50,00 ",0.054087," 0,00 "," 569,93 "," 469,93 ",2789629046,CFD," 0,00 "
09/08/2024 18:53:39,Position closed,NSDQ100/USD," 49,42 ",0.054087,"(0,58)"," 569,35 "," 519,35 ",2789629046,CFD," 0,00 "
09/08/2024 18:54:11,Open Position,NSDQ100/USD," 64,99 ",0.054114," 0,00 "," 569,35 "," 469,36 ",2789629461,CFD," 0,00 "
10/08/2024 00:11:05,Dividend,NSDQ100/USD,"(0,14)",-,"(0,14)"," 569,21 "," 469,22 ",2789629461,CFD," 0,00 "
10/08/2024 00:48:48,Weekend refund,Weekend Fee," 0,04 ",-," 0,04 "," 569,25 "," 469,26 ",2789629461,CFD," 0,00 "
10/08/2024 00:48:48,Overnight refund,Daily," 0,16 ",-," 0,16 "," 569,41 "," 469,42 ",2789016004,CFD," 0,00 "
12/08/2024 03:35:39,Position closed,USD/JPY," 53,07 ",1500.000000," 3,07 "," 572,48 "," 522,49 ",2789016004,CFD," 0,00 "
12/08/2024 05:01:12,Open Position,USD/JPY," 139,99 ",4200.000000," 0,00 "," 572,48 "," 382,50 ",2789731193,CFD," 0,00 "
12/08/2024 05:02:32,Open Position,NSDQ100/USD," 49,99 ",0.053922," 0,00 "," 572,48 "," 332,51 ",2789731252,CFD," 0,00 "
12/08/2024 05:03:47,Open Position,XAU/USD," 90,00 ",0.739784," 0,00 "," 572,48 "," 242,51 ",2789731351,CFD," 0,00 "
12/08/2024 06:14:07,Open Position,USD/JPY," 69,99 ",2100.000000," 0,00 "," 572,48 "," 172,52 ",2789737045,CFD," 0,00 "
12/08/2024 06:57:08,Open Position,GER30/EUR," 99,99 ",0.102949," 0,00 "," 572,48 "," 72,53 ",2789740457,CFD," 0,00 "
12/08/2024 10:00:26,Open Position,NSDQ100/USD," 50,00 ",0.053893," 0,00 "," 572,48 "," 22,53 ",2789862738,CFD," 0,00 "
12/08/2024 13:46:22,Position closed,NSDQ100/USD," 54,85 ",0.053922," 4,86 "," 577,34 "," 77,38 ",2789731252,CFD," 0,00 "
12/08/2024 14:51:09,Open Position,NSDQ100/USD," 50,00 ",0.053697," 0,00 "," 577,34 "," 27,38 ",2790374489,CFD," 0,00 "
12/08/2024 19:52:54,Position closed,USD/JPY," 139,30 ",4200.000000,"(0,69)"," 576,65 "," 166,68 ",2789731193,CFD," 0,00 "
13/08/2024 00:48:45,Overnight fee,Daily,"(0,45)",-,"(0,45)"," 576,20 "," 166,23 ",2789740457,CFD," 0,00 "
13/08/2024 00:48:45,Overnight fee,Daily,"(0,39)",-,"(0,39)"," 575,81 "," 165,84 ",2789737045,CFD," 0,00 "
13/08/2024 00:48:45,Overnight refund,Daily," 0,07 ",-," 0,07 "," 575,88 "," 165,91 ",2789731351,CFD," 0,00 "
13/08/2024 00:48:45,Overnight fee,Daily,"(0,27)",-,"(0,27)"," 575,61 "," 165,64 ",2789862738,CFD," 0,00 "
13/08/2024 00:48:45,Overnight refund,Daily," 0,01 ",-," 0,01 "," 575,62 "," 165,65 ",2789629461,CFD," 0,00 "
13/08/2024 00:48:45,Overnight fee,Daily,"(0,27)",-,"(0,27)"," 575,35 "," 165,38 ",2790374489,CFD," 0,00 "
13/08/2024 04:58:20,Open Position,XAU/USD," 99,99 ",0.812327," 0,00 "," 575,35 "," 65,39 ",2790585745,CFD," 0,00 "
13/08/2024 05:01:04,Open Position,USD/JPY," 50,00 ",1500.000000," 0,00 "," 575,35 "," 15,39 ",2790585932,CFD," 0,00 "
13/08/2024 06:43:03,Position closed,NSDQ100/USD," 53,76 ",0.053893," 3,76 "," 579,11 "," 69,15 ",2789862738,CFD," 0,00 "
13/08/2024 06:43:10,Position closed,NSDQ100/USD," 50,06 ",0.053697," 0,06 "," 579,17 "," 119,21 ",2790374489,CFD," 0,00 "
13/08/2024 06:43:34,Open Position,NSDQ100/USD," 69,99 ",0.075177," 0,00 "," 579,17 "," 49,22 ",2790593327,CFD," 0,00 "
13/08/2024 06:43:51,Position closed,GER30/EUR," 99,59 ",0.102949,"(0,40)"," 578,77 "," 148,81 ",2789740457,CFD," 0,00 "
13/08/2024 06:52:07,Open Position,NSDQ100/USD," 148,81 ",0.159732," 0,00 "," 578,77 "," 0,00 ",2790594207,CFD," 0,00 "
13/08/2024 06:52:55,Position closed,NSDQ100/USD," 148,43 ",0.159732,"(0,38)"," 578,39 "," 148,43 ",2790594207,CFD," 0,00 "
13/08/2024 06:53:25,Open Position,NSDQ100/USD," 129,99 ",0.139522," 0,00 "," 578,39 "," 18,44 ",2790594314,CFD," 0,00 "
13/08/2024 07:25:41,Position closed,NSDQ100/USD," 139,02 ",0.139522," 9,03 "," 587,42 "," 157,46 ",2790594314,CFD," 0,00 "
13/08/2024 07:26:13,Open Position,NSDQ100/USD," 79,99 ",0.085605," 0,00 "," 587,42 "," 77,47 ",2790619362,CFD," 0,00 "
13/08/2024 07:28:03,Position closed,USD/JPY," 50,88 ",1500.000000," 0,88 "," 588,30 "," 128,35 ",2790585932,CFD," 0,00 "
13/08/2024 07:29:38,Open Position,NSDQ100/USD," 49,99 ",0.053504," 0,00 "," 588,30 "," 78,36 ",2790619961,CFD," 0,00 "
13/08/2024 07:30:05,Position closed,NSDQ100/USD," 49,87 ",0.053504,"(0,12)"," 588,18 "," 128,23 ",2790619961,CFD," 0,00 "
13/08/2024 07:30:52,Open Position,NSDQ100/USD," 49,99 ",0.053516," 0,00 "," 588,18 "," 78,24 ",2790620145,CFD," 0,00 "
13/08/2024 07:53:13,Open Position,USD/JPY," 50,00 ",1500.000000," 0,00 "," 588,18 "," 28,24 ",2790626169,CFD," 0,00 "
13/08/2024 09:26:27,Position closed,NSDQ100/USD," 83,50 ",0.085605," 3,51 "," 591,69 "," 111,74 ",2790619362,CFD," 0,00 "
13/08/2024 09:26:35,Position closed,NSDQ100/USD," 51,92 ",0.053516," 1,93 "," 593,62 "," 163,66 ",2790620145,CFD," 0,00 "
13/08/2024 09:27:22,Position closed,NSDQ100/USD," 67,73 ",0.075177,"(2,26)"," 591,36 "," 231,39 ",2790593327,CFD," 0,00 "
13/08/2024 09:27:44,Open Position,NSDQ100/USD," 149,99 ",0.160836," 0,00 "," 591,36 "," 81,40 ",2790648407,CFD," 0,00 "
13/08/2024 12:22:20,Position closed,NSDQ100/USD," 149,31 ",0.160836,"(0,68)"," 590,68 "," 230,71 ",2790648407,CFD," 0,00 "
13/08/2024 12:25:42,Position closed,XAU/USD," 102,94 ",0.812327," 2,95 "," 593,63 "," 333,65 ",2790585745,CFD," 0,00 "
13/08/2024 12:32:05,Open Position,NSDQ100/USD," 49,99 ",0.053459," 0,00 "," 593,63 "," 283,66 ",2790680309,CFD," 0,00 "
13/08/2024 12:32:59,Open Position,XAU/USD," 80,00 ",0.648067," 0,00 "," 593,63 "," 203,66 ",2790680765,CFD," 0,00 "
13/08/2024 12:36:08,Position closed,NSDQ100/USD," 49,79 ",0.053459,"(0,20)"," 593,43 "," 253,45 ",2790680309,CFD," 0,00 "
13/08/2024 12:38:57,Open Position,NSDQ100/USD," 69,99 ",0.074792," 0,00 "," 593,43 "," 183,46 ",2790683150,CFD," 0,00 "
13/08/2024 12:47:26,Open Position,USD/JPY," 50,00 ",1500.000000," 0,00 "," 593,43 "," 133,46 ",2790686907,CFD," 0,00 "
13/08/2024 12:48:14,Position closed,NSDQ100/USD," 71,67 ",0.074792," 1,68 "," 595,11 "," 205,13 ",2790683150,CFD," 0,00 "
13/08/2024 12:49:50,Open Position,NSDQ100/USD," 60,00 ",0.064171," 0,00 "," 595,11 "," 145,13 ",2790688512,CFD," 0,00 "
13/08/2024 12:53:02,Position closed,NSDQ100/USD," 59,84 ",0.064171,"(0,16)"," 594,95 "," 204,97 ",2790688512,CFD," 0,00 "
13/08/2024 12:53:15,Open Position,NSDQ100/USD," 99,99 ",0.106970," 0,00 "," 594,95 "," 104,98 ",2790690390,CFD," 0,00 "
13/08/2024 12:59:51,Position closed,XAU/USD," 80,34 ",0.648067," 0,34 "," 595,29 "," 185,32 ",2790680765,CFD," 0,00 "
13/08/2024 13:14:00,Position closed,USD/JPY," 72,92 ",2100.000000," 2,93 "," 598,22 "," 258,24 ",2789737045,CFD," 0,00 "
13/08/2024 13:15:21,Open Position,USD/JPY," 70,33 ",2110.200000," 0,00 "," 598,22 "," 187,91 ",2790697386,CFD," 0,00 "
13/08/2024 13:15:28,Position closed,USD/JPY," 70,26 ",2110.200000,"(0,07)"," 598,15 "," 258,17 ",2790697386,CFD," 0,00 "
13/08/2024 13:15:45,Open Position,USD/JPY," 70,34 ",2110.200000," 0,00 "," 598,15 "," 187,83 ",2790697445,CFD," 0,00 "
13/08/2024 13:21:33,Position closed,USD/JPY," 71,24 ",2110.200000," 0,90 "," 599,05 "," 259,07 ",2790697445,CFD," 0,00 "
13/08/2024 13:21:58,Open Position,XAU/USD," 79,99 ",0.649598," 0,00 "," 599,05 "," 179,08 ",2790699007,CFD," 0,00 "
13/08/2024 13:30:04,Open Position,NSDQ100/USD," 50,00 ",0.053390," 0,00 "," 599,05 "," 129,08 ",2790701616,CFD," 0,00 "
13/08/2024 13:30:14,Open Position,BA/USD," 49,90 ",1.513249," 0,00 "," 599,05 "," 79,18 ",2790711063,CFD," 0,00 "
13/08/2024 13:30:15,Open Position,BA/USD," 69,86 ",2.118549," 0,00 "," 599,05 "," 9,32 ",2790711331,CFD," 0,00 "
13/08/2024 13:35:19,Position closed,NSDQ100/USD," 51,95 ",0.053390," 1,95 "," 601,00 "," 61,27 ",2790701616,CFD," 0,00 "
13/08/2024 13:37:20,Open Position,NSDQ100/USD," 49,99 ",0.053274," 0,00 "," 601,00 "," 11,28 ",2790759336,CFD," 0,00 "
13/08/2024 13:45:55,Open Position,OCGN/USD," 10,00 ",39.062500," 0,00 "," 601,00 "," 1,28 ",2790779004,CFD," 0,00 "
13/08/2024 13:47:29,Position closed,XAU/USD," 85,85 ",0.649598," 5,86 "," 606,86 "," 87,13 ",2790699007,CFD," 0,00 "
13/08/2024 13:49:12,Open Position,XAU/USD," 50,00 ",0.404653," 0,00 "," 606,86 "," 37,13 ",2790784742,CFD," 0,00 "
13/08/2024 13:51:12,Edit Stop Loss,-,"(5,00)",-," 0,00 "," 606,86 "," 32,13 ",2789629461,-," 0,00 "
13/08/2024 13:53:40,Position closed,XAU/USD," 50,98 ",0.404653," 0,98 "," 607,84 "," 83,11 ",2790784742,CFD," 0,00 "
13/08/2024 13:53:46,Open Position,XAU/USD," 49,99 ",0.404259," 0,00 "," 607,84 "," 33,12 ",2790823815,CFD," 0,00 "
13/08/2024 13:56:40,Position closed,XAU/USD," 49,27 ",0.404259,"(0,72)"," 607,12 "," 82,39 ",2790823815,CFD," 0,00 "
13/08/2024 13:57:18,Open Position,XAU/USD," 50,00 ",0.403934," 0,00 "," 607,12 "," 32,39 ",2790830049,CFD," 0,00 "
13/08/2024 15:17:36,Position closed,BA/USD," 50,75 ",1.513249," 0,85 "," 607,97 "," 83,14 ",2790711063,CFD," 0,00 "
13/08/2024 15:17:36,Position closed,BA/USD," 71,06 ",2.118549," 1,20 "," 609,17 "," 154,20 ",2790711331,CFD," 0,00 "
13/08/2024 16:16:47,Edit Stop Loss,-,"(10,00)",-," 0,00 "," 609,17 "," 144,20 ",2789629461,-," 0,00 "
13/08/2024 16:17:22,Open Position,NSDQ100/USD," 49,99 ",0.052881," 0,00 "," 609,17 "," 94,21 ",2790997392,CFD," 0,00 "
13/08/2024 16:19:06,Open Position,NSDQ100/USD," 49,99 ",0.052879," 0,00 "," 609,17 "," 44,22 ",2790998231,CFD," 0,00 "
14/08/2024 00:48:52,Overnight fee,Daily,"(0,02)",-,"(0,02)"," 609,15 "," 44,20 ",2790779004,CFD," 0,00 "
14/08/2024 00:48:52,Overnight fee,Daily,"(0,26)",-,"(0,26)"," 608,89 "," 43,94 ",2790830049,CFD," 0,00 "
14/08/2024 00:48:52,Overnight refund,Daily," 0,07 ",-," 0,07 "," 608,96 "," 44,01 ",2789731351,CFD," 0,00 "
14/08/2024 00:48:52,Overnight refund,Daily," 0,02 ",-," 0,02 "," 608,98 "," 44,03 ",2790690390,CFD," 0,00 "
14/08/2024 00:48:52,Overnight refund,Daily," 0,01 ",-," 0,01 "," 608,99 "," 44,04 ",2790997392,CFD," 0,00 "
14/08/2024 00:48:52,Overnight refund,Daily," 0,01 ",-," 0,01 "," 609,00 "," 44,05 ",2790759336,CFD," 0,00 "
14/08/2024 00:48:52,Overnight refund,Daily," 0,01 ",-," 0,01 "," 609,01 "," 44,06 ",2789629461,CFD," 0,00 "
14/08/2024 00:48:52,Overnight refund,Daily," 0,01 ",-," 0,01 "," 609,02 "," 44,07 ",2790998231,CFD," 0,00 "
14/08/2024 00:48:52,Overnight refund,Daily," 0,16 ",-," 0,16 "," 609,18 "," 44,23 ",2790626169,CFD," 0,00 "
14/08/2024 00:48:52,Overnight refund,Daily," 0,16 ",-," 0,16 "," 609,34 "," 44,39 ",2790686907,CFD," 0,00 "
14/08/2024 08:39:22,Position closed,XAU/USD," 49,52 ",0.403934,"(0,48)"," 608,86 "," 93,91 ",2790830049,CFD," 0,00 "
14/08/2024 08:40:36,Open Position,XAU/USD," 50,00 ",0.404107," 0,00 "," 608,86 "," 43,91 ",2791270941,CFD," 0,00 "
14/08/2024 08:41:02,Position closed,XAU/USD," 49,91 ",0.404107,"(0,09)"," 608,77 "," 93,82 ",2791270941,CFD," 0,00 "
14/08/2024 08:42:54,Open Position,NSDQ100/USD," 50,00 ",0.052663," 0,00 "," 608,77 "," 43,82 ",2791271312,CFD," 0,00 "
14/08/2024 12:12:27,Position closed,NSDQ100/USD," 50,99 ",0.052663," 0,99 "," 609,76 "," 94,81 ",2791271312,CFD," 0,00 "
14/08/2024 12:29:41,Open Position,NSDQ100/USD," 90,00 ",0.094617," 0,00 "," 609,76 "," 4,81 ",2791334089,CFD," 0,00 "
14/08/2024 12:31:07,Position closed,USD/JPY," 50,52 ",1500.000000," 0,52 "," 610,28 "," 55,33 ",2790686907,CFD," 0,00 "
14/08/2024 12:31:28,Position closed,USD/JPY," 44,76 ",1500.000000,"(5,24)"," 605,04 "," 100,09 ",2790626169,CFD," 0,00 "
14/08/2024 12:38:49,Open Position,NSDQ100/USD," 100,00 ",0.105201," 0,00 "," 605,04 "," 0,09 ",2791343764,CFD," 0,00 "
14/08/2024 12:43:43,Position closed,NSDQ100/USD," 102,06 ",0.105201," 2,06 "," 607,10 "," 102,15 ",2791343764,CFD," 0,00 "
14/08/2024 12:43:48,Position closed,NSDQ100/USD," 90,82 ",0.094617," 0,82 "," 607,92 "," 192,97 ",2791334089,CFD," 0,00 "
14/08/2024 12:45:34,Open Position,NSDQ100/USD," 50,00 ",0.052492," 0,00 "," 607,92 "," 142,97 ",2791347722,CFD," 0,00 "
14/08/2024 12:46:00,Open Position,NSDQ100/USD," 100,00 ",0.104994," 0,00 "," 607,92 "," 42,97 ",2791349371,CFD," 0,00 "
14/08/2024 12:52:38,Position closed,XAU/USD," 65,89 ",0.739784,"(24,11)"," 583,81 "," 108,86 ",2789731351,CFD," 0,00 "
14/08/2024 12:53:40,Open Position,XAU/USD," 50,00 ",0.405350," 0,00 "," 583,81 "," 58,86 ",2791351825,CFD," 0,00 "
14/08/2024 13:02:19,Position closed,NSDQ100/USD," 99,91 ",0.104994,"(0,09)"," 583,72 "," 158,77 ",2791349371,CFD," 0,00 "
14/08/2024 13:02:31,Position closed,NSDQ100/USD," 49,88 ",0.052492,"(0,12)"," 583,60 "," 208,65 ",2791347722,CFD," 0,00 "
14/08/2024 13:07:39,Open Position,XAU/USD," 50,00 ",0.405477," 0,00 "," 583,60 "," 158,65 ",2791359071,CFD," 0,00 "
14/08/2024 13:10:12,Position closed,NSDQ100/USD," 42,78 ",0.052879,"(7,21)"," 576,39 "," 201,43 ",2790998231,CFD," 0,00 "
14/08/2024 13:12:02,Position closed,XAU/USD," 50,67 ",0.405350," 0,67 "," 577,06 "," 252,10 ",2791351825,CFD," 0,00 "
14/08/2024 13:12:06,Position closed,XAU/USD," 51,08 ",0.405477," 1,08 "," 578,14 "," 303,18 ",2791359071,CFD," 0,00 "
14/08/2024 13:13:55,Open Position,XAU/USD," 150,00 ",1.216614," 0,00 "," 578,14 "," 153,18 ",2791360852,CFD," 0,00 "
14/08/2024 13:15:16,Position closed,NSDQ100/USD," 43,13 ",0.052881,"(6,86)"," 571,28 "," 196,31 ",2790997392,CFD," 0,00 "
14/08/2024 13:15:55,Open Position,XAU/USD," 50,00 ",0.405621," 0,00 "," 571,28 "," 146,31 ",2791361182,CFD," 0,00 "
14/08/2024 13:17:25,Open Position,XAU/USD," 50,00 ",0.406007," 0,00 "," 571,28 "," 96,31 ",2791362298,CFD," 0,00 "
14/08/2024 13:18:15,Open Position,XAU/USD," 50,00 ",0.406191," 0,00 "," 571,28 "," 46,31 ",2791362602,CFD," 0,00 "
14/08/2024 13:20:36,Position closed,NSDQ100/USD," 35,60 ",0.053274,"(14,39)"," 556,89 "," 81,91 ",2790759336,CFD," 0,00 "
14/08/2024 13:20:50,Open Position,XAU/USD," 50,00 ",0.407413," 0,00 "," 556,89 "," 31,91 ",2791363259,CFD," 0,00 "
14/08/2024 13:35:32,Position closed,NSDQ100/USD," 36,17 ",0.054114,"(28,82)"," 528,07 "," 68,08 ",2789629461,CFD," 0,00 "
14/08/2024 13:35:41,Position closed,NSDQ100/USD," 65,13 ",0.106970,"(34,86)"," 493,21 "," 133,21 ",2790690390,CFD," 0,00 "
14/08/2024 13:36:09,Open Position,NSDQ100/USD," 129,99 ",0.136704," 0,00 "," 493,21 "," 3,22 ",2791454248,CFD," 0,00 "
14/08/2024 13:39:18,Position closed,NSDQ100/USD," 131,38 ",0.136704," 1,39 "," 494,60 "," 134,60 ",2791454248,CFD," 0,00 "
14/08/2024 13:40:08,Open Position,NSDQ100/USD," 129,99 ",0.136657," 0,00 "," 494,60 "," 4,61 ",2791471855,CFD," 0,00 "
14/08/2024 13:43:42,Position closed,XAU/USD," 51,50 ",0.407413," 1,50 "," 496,10 "," 56,11 ",2791363259,CFD," 0,00 "
14/08/2024 13:43:51,Open Position,NSDQ100/USD," 50,00 ",0.052714," 0,00 "," 496,10 "," 6,11 ",2791479274,CFD," 0,00 "
14/08/2024 14:27:49,Deposit Conversion Fee,-,"(1,50)",-," 0,00 "," 604,96 "," 114,97 ",-,-," 0,00 "
14/08/2024 14:27:49,Deposit,100.00 EUR CreditCard," 108,86 ",-," 108,86 "," 604,96 "," 114,97 ",-,-," 0,00 "
14/08/2024 14:28:03,Open Position,NSDQ100/USD," 99,99 ",0.105791," 0,00 "," 604,96 "," 14,98 ",2791590321,CFD," 0,00 "
14/08/2024 14:30:09,Deposit Conversion Fee,-,"(1,50)",-," 0,00 "," 713,85 "," 123,87 ",-,-," 0,00 "
14/08/2024 14:30:09,Deposit,100.00 EUR CreditCard," 108,89 ",-," 108,89 "," 713,85 "," 123,87 ",-,-," 0,00 "
14/08/2024 14:30:21,Open Position,NSDQ100/USD," 99,99 ",0.105717," 0,00 "," 713,85 "," 23,88 ",2791592436,CFD," 0,00 "
14/08/2024 15:59:18,Position closed,NSDQ100/USD," 119,26 ",0.105717," 19,27 "," 733,12 "," 143,14 ",2791592436,CFD," 0,00 "
14/08/2024 15:59:18,Position closed,NSDQ100/USD," 120,66 ",0.105791," 20,67 "," 753,79 "," 263,80 ",2791590321,CFD," 0,00 "
14/08/2024 15:59:18,Position closed,NSDQ100/USD," 140,22 ",0.136657," 10,23 "," 764,02 "," 404,02 ",2791471855,CFD," 0,00 "
14/08/2024 15:59:18,Position closed,NSDQ100/USD," 56,90 ",0.052714," 6,90 "," 770,92 "," 460,92 ",2791479274,CFD," 0,00 "
14/08/2024 16:23:27,Open Position,XAU/USD," 50,00 ",0.409532," 0,00 "," 770,92 "," 410,92 ",2791719299,CFD," 0,00 "
14/08/2024 16:30:38,Open Position,NSDQ100/USD," 109,99 ",0.115890," 0,00 "," 770,92 "," 300,93 ",2791724234,CFD," 0,00 "
14/08/2024 16:33:22,Open Position,NSDQ100/USD," 79,99 ",0.084283," 0,00 "," 770,92 "," 220,94 ",2791725919,CFD," 0,00 "
14/08/2024 16:34:57,Open Position,NSDQ100/USD," 60,00 ",0.063225," 0,00 "," 770,92 "," 160,94 ",2791726698,CFD," 0,00 "
14/08/2024 16:40:48,Open Position,NSDQ100/USD," 50,00 ",0.052667," 0,00 "," 770,92 "," 110,94 ",2791729253,CFD," 0,00 "
14/08/2024 16:50:35,Open Position,NSDQ100/USD," 50,00 ",0.052752," 0,00 "," 770,92 "," 60,94 ",2791734837,CFD," 0,00 "
14/08/2024 17:59:30,Position closed,OCGN/USD," 9,22 ",39.062500,"(0,78)"," 770,14 "," 70,16 ",2790779004,CFD," 0,00 "
14/08/2024 18:02:30,Open Position,NSDQ100/USD," 60,00 ",0.063274," 0,00 "," 770,14 "," 10,16 ",2791769986,CFD," 0,00 "
14/08/2024 18:34:08,Position closed,NSDQ100/USD," 110,48 ",0.115890," 0,49 "," 770,63 "," 120,64 ",2791724234,CFD," 0,00 "
14/08/2024 18:34:08,Position closed,NSDQ100/USD," 80,34 ",0.084283," 0,35 "," 770,98 "," 200,98 ",2791725919,CFD," 0,00 "
14/08/2024 18:34:08,Position closed,NSDQ100/USD," 50,02 ",0.052667," 0,02 "," 771,00 "," 251,00 ",2791729253,CFD," 0,00 "
14/08/2024 18:34:08,Position closed,NSDQ100/USD," 60,51 ",0.063225," 0,51 "," 771,51 "," 311,51 ",2791726698,CFD," 0,00 "
14/08/2024 18:34:08,Position closed,NSDQ100/USD," 51,64 ",0.052752," 1,64 "," 773,15 "," 363,15 ",2791734837,CFD," 0,00 "
14/08/2024 18:34:08,Position closed,NSDQ100/USD," 61,43 ",0.063274," 1,43 "," 774,58 "," 424,58 ",2791769986,CFD," 0,00 "
14/08/2024 18:39:39,Open Position,NSDQ100/USD," 99,99 ",0.105305," 0,00 "," 774,58 "," 324,59 ",2791783834,CFD," 0,00 "
14/08/2024 18:47:45,Open Position,NSDQ100/USD," 50,00 ",0.052677," 0,00 "," 774,58 "," 274,59 ",2791786418,CFD," 0,00 "
14/08/2024 18:59:12,Position closed,NSDQ100/USD," 101,95 ",0.105305," 1,96 "," 776,54 "," 376,54 ",2791783834,CFD," 0,00 "
14/08/2024 18:59:13,Position closed,NSDQ100/USD," 51,46 ",0.052677," 1,46 "," 778,00 "," 428,00 ",2791786418,CFD," 0,00 "
14/08/2024 19:10:28,Open Position,NSDQ100/USD," 109,99 ",0.115816," 0,00 "," 778,00 "," 318,01 ",2791795327,CFD," 0,00 "
14/08/2024 19:21:41,Open Position,NSDQ100/USD," 80,00 ",0.084394," 0,00 "," 778,00 "," 238,01 ",2791801461,CFD," 0,00 "
14/08/2024 19:49:29,Position closed,NSDQ100/USD," 109,67 ",0.115816,"(0,32)"," 777,68 "," 347,68 ",2791795327,CFD," 0,00 "
14/08/2024 19:49:29,Position closed,NSDQ100/USD," 82,88 ",0.084394," 2,88 "," 780,56 "," 430,56 ",2791801461,CFD," 0,00 "
14/08/2024 20:05:07,Open Position,TSLA.EXT/USD," 50,00 ",1.239082," 0,00 "," 780,56 "," 380,56 ",2791819428,CFD," 0,00 "
14/08/2024 20:09:40,Open Position,NSDQ100/USD," 69,99 ",0.073518," 0,00 "," 780,56 "," 310,57 ",2791819882,CFD," 0,00 "
15/08/2024 00:48:45,Overnight fee,Daily,"(0,08)",-,"(0,08)"," 780,48 "," 310,49 ",2791819428,CFD," 0,00 "
15/08/2024 00:48:45,Overnight fee,Weekend Fee,"(2,34)",-,"(2,34)"," 778,14 "," 308,15 ",2791360852,CFD," 0,00 "
15/08/2024 00:48:45,Overnight fee,Weekend Fee,"(0,78)",-,"(0,78)"," 777,36 "," 307,37 ",2791362602,CFD," 0,00 "
15/08/2024 00:48:45,Overnight fee,Weekend Fee,"(0,78)",-,"(0,78)"," 776,58 "," 306,59 ",2791361182,CFD," 0,00 "
15/08/2024 00:48:45,Overnight fee,Weekend Fee,"(0,79)",-,"(0,79)"," 775,79 "," 305,80 ",2791719299,CFD," 0,00 "
15/08/2024 00:48:45,Overnight fee,Weekend Fee,"(0,78)",-,"(0,78)"," 775,01 "," 305,02 ",2791362298,CFD," 0,00 "
15/08/2024 00:48:45,Overnight refund,Daily," 0,02 ",-," 0,02 "," 775,03 "," 305,04 ",2791819882,CFD," 0,00 "
15/08/2024 07:29:57,Open Position,NSDQ100/USD," 80,00 ",0.083801," 0,00 "," 775,03 "," 225,04 ",2791880901,CFD," 0,00 "
15/08/2024 08:55:14,Open Position,NSDQ100/USD," 60,00 ",0.062972," 0,00 "," 775,03 "," 165,04 ",2791894732,CFD," 0,00 "
15/08/2024 08:55:42,Open Position,NSDQ100/USD," 49,99 ",0.052479," 0,00 "," 775,03 "," 115,05 ",2791894843,CFD," 0,00 "
15/08/2024 10:21:48,Position closed,XAU/USD," 57,36 ",0.409532," 7,36 "," 782,39 "," 172,41 ",2791719299,CFD," 0,00 "
15/08/2024 10:23:47,Position closed,NSDQ100/USD," 50,50 ",0.052479," 0,51 "," 782,90 "," 222,91 ",2791894843,CFD," 0,00 "
15/08/2024 10:24:04,Position closed,NSDQ100/USD," 70,07 ",0.073518," 0,08 "," 782,98 "," 292,98 ",2791819882,CFD," 0,00 "
15/08/2024 10:25:31,Open Position,XAU/USD," 49,99 ",0.406637," 0,00 "," 782,98 "," 242,99 ",2791906685,CFD," 0,00 "
15/08/2024 10:56:18,Open Position,NSDQ100/USD," 70,00 ",0.073535," 0,00 "," 782,98 "," 172,99 ",2791914417,CFD," 0,00 "
15/08/2024 11:27:49,Position closed,XAU/USD," 49,97 ",0.406637,"(0,02)"," 782,96 "," 222,96 ",2791906685,CFD," 0,00 "
15/08/2024 11:29:44,Open Position,XAU/USD," 59,99 ",0.487668," 0,00 "," 782,96 "," 162,97 ",2791918762,CFD," 0,00 "
15/08/2024 11:30:24,Position closed,NSDQ100/USD," 72,41 ",0.073535," 2,41 "," 785,37 "," 235,38 ",2791914417,CFD," 0,00 "
15/08/2024 11:30:24,Position closed,NSDQ100/USD," 78,19 ",0.083801,"(1,81)"," 783,56 "," 313,57 ",2791880901,CFD," 0,00 "
15/08/2024 11:30:24,Position closed,NSDQ100/USD," 60,96 ",0.062972," 0,96 "," 784,52 "," 374,53 ",2791894732,CFD," 0,00 "
15/08/2024 11:31:51,Open Position,NSDQ100/USD," 49,99 ",0.052443," 0,00 "," 784,52 "," 324,54 ",2791919062,CFD," 0,00 "
15/08/2024 11:32:39,Open Position,NSDQ100/USD," 90,00 ",0.094312," 0,00 "," 784,52 "," 234,54 ",2791919163,CFD," 0,00 "
15/08/2024 11:35:00,Open Position,NSDQ100/USD," 60,00 ",0.062888," 0,00 "," 784,52 "," 174,54 ",2791919496,CFD," 0,00 "
15/08/2024 11:38:10,Position closed,NSDQ100/USD," 88,68 ",0.094312,"(1,32)"," 783,20 "," 263,22 ",2791919163,CFD," 0,00 "
15/08/2024 11:38:16,Position closed,NSDQ100/USD," 59,27 ",0.062888,"(0,73)"," 782,47 "," 322,49 ",2791919496,CFD," 0,00 "
15/08/2024 12:10:34,Position closed,NSDQ100/USD," 49,76 ",0.052443,"(0,23)"," 782,24 "," 372,25 ",2791919062,CFD," 0,00 "
15/08/2024 12:11:10,Position closed,XAU/USD," 148,87 ",1.216614,"(1,13)"," 781,11 "," 521,12 ",2791360852,CFD," 0,00 "
15/08/2024 12:11:10,Position closed,XAU/USD," 50,78 ",0.406007," 0,78 "," 781,89 "," 571,90 ",2791362298,CFD," 0,00 "
15/08/2024 12:11:10,Position closed,XAU/USD," 51,22 ",0.406191," 1,22 "," 783,11 "," 623,12 ",2791362602,CFD," 0,00 "
15/08/2024 12:11:10,Position closed,XAU/USD," 49,83 ",0.405621,"(0,17)"," 782,94 "," 672,95 ",2791361182,CFD," 0,00 "
15/08/2024 12:11:10,Position closed,XAU/USD," 62,06 ",0.487668," 2,07 "," 785,01 "," 735,01 ",2791918762,CFD," 0,00 "
15/08/2024 12:37:19,Position closed,TSLA.EXT/USD," 52,90 ",1.239082," 2,90 "," 787,91 "," 787,91 ",2791819428,CFD," 0,00 "
15/08/2024 12:40:42,Open Position,XAU/USD," 50,00 ",0.407836," 0,00 "," 787,91 "," 737,91 ",2791940545,CFD," 0,00 "
15/08/2024 12:41:28,Open Position,XAU/USD," 50,00 ",0.407787," 0,00 "," 787,91 "," 687,91 ",2791941557,CFD," 0,00 "
15/08/2024 12:43:56,Open Position,NSDQ100/USD," 49,99 ",0.052093," 0,00 "," 787,91 "," 637,92 ",2791942749,CFD," 0,00 "
15/08/2024 12:47:50,Position closed,NSDQ100/USD," 48,27 ",0.052093,"(1,72)"," 786,19 "," 686,19 ",2791942749,CFD," 0,00 "
15/08/2024 12:52:17,Open Position,NSDQ100/USD," 50,00 ",0.051966," 0,00 "," 786,19 "," 636,19 ",2791948263,CFD," 0,00 "
15/08/2024 13:05:41,Open Position,XAU/USD," 50,00 ",0.410419," 0,00 "," 786,19 "," 586,19 ",2791955027,CFD," 0,00 "
15/08/2024 13:06:37,Open Position,NSDQ100/USD," 100,00 ",0.103949," 0,00 "," 786,19 "," 486,19 ",2791955301,CFD," 0,00 "
15/08/2024 13:07:29,Open Position,XAU/USD," 50,00 ",0.410379," 0,00 "," 786,19 "," 436,19 ",2791955655,CFD," 0,00 "
15/08/2024 13:08:14,Open Position,XAU/USD," 50,00 ",0.410697," 0,00 "," 786,19 "," 386,19 ",2791956046,CFD," 0,00 "
15/08/2024 13:08:44,Open Position,NSDQ100/USD," 50,00 ",0.051969," 0,00 "," 786,19 "," 336,19 ",2791956239,CFD," 0,00 "
15/08/2024 13:30:17,Open Position,TSLA/USD," 99,97 ",2.428487," 0,00 "," 786,19 "," 236,22 ",2791978286,CFD," 0,00 "
15/08/2024 13:48:48,Position closed,TSLA/USD," 113,14 ",2.428487," 13,17 "," 799,36 "," 349,36 ",2791978286,CFD," 0,00 "
15/08/2024 13:49:12,Position closed,NSDQ100/USD," 53,06 ",0.051969," 3,06 "," 802,42 "," 402,42 ",2791956239,CFD," 0,00 "
15/08/2024 13:49:12,Position closed,NSDQ100/USD," 106,30 ",0.103949," 6,30 "," 808,72 "," 508,72 ",2791955301,CFD," 0,00 "
15/08/2024 13:49:12,Position closed,NSDQ100/USD," 53,00 ",0.051966," 3,00 "," 811,72 "," 561,72 ",2791948263,CFD," 0,00 "
15/08/2024 14:31:24,Position closed,XAU/USD," 49,42 ",0.407836,"(0,58)"," 811,14 "," 611,14 ",2791940545,CFD," 0,00 "
15/08/2024 14:31:24,Position closed,XAU/USD," 49,30 ",0.407787,"(0,70)"," 810,44 "," 660,44 ",2791941557,CFD," 0,00 "
15/08/2024 14:31:24,Position closed,XAU/USD," 55,75 ",0.410419," 5,75 "," 816,19 "," 716,19 ",2791955027,CFD," 0,00 "
15/08/2024 14:31:24,Position closed,XAU/USD," 55,66 ",0.410379," 5,66 "," 821,85 "," 771,85 ",2791955655,CFD," 0,00 "
15/08/2024 14:31:24,Position closed,XAU/USD," 56,44 ",0.410697," 6,44 "," 828,29 "," 828,29 ",2791956046,CFD," 0,00 "
15/08/2024 14:45:29,Open Position,NSDQ100/USD," 199,99 ",0.206155," 0,00 "," 828,29 "," 628,30 ",2792427617,CFD," 0,00 "
15/08/2024 14:57:18,Position closed,NSDQ100/USD," 205,20 ",0.206155," 5,21 "," 833,50 "," 833,50 ",2792427617,CFD," 0,00 "
15/08/2024 14:59:57,Open Position,NSDQ100/USD," 50,00 ",0.051590," 0,00 "," 833,50 "," 783,50 ",2792445651,CFD," 0,00 "
15/08/2024 15:08:47,Open Position,NSDQ100/USD," 50,00 ",0.051571," 0,00 "," 833,50 "," 733,50 ",2792466037,CFD," 0,00 "
15/08/2024 15:24:02,Position closed,NSDQ100/USD," 51,25 ",0.051571," 1,25 "," 834,75 "," 784,75 ",2792466037,CFD," 0,00 "
15/08/2024 15:24:02,Position closed,NSDQ100/USD," 51,62 ",0.051590," 1,62 "," 836,37 "," 836,37 ",2792445651,CFD," 0,00 "
15/08/2024 16:41:23,Open Position,NSDQ100/USD," 89,99 ",0.092626," 0,00 "," 836,37 "," 746,38 ",2792643415,CFD," 0,00 "
15/08/2024 16:55:20,Position closed,NSDQ100/USD," 90,11 ",0.092626," 0,12 "," 836,49 "," 836,49 ",2792643415,CFD," 0,00 "
15/08/2024 17:07:30,Open Position,NSDQ100/USD," 50,00 ",0.051447," 0,00 "," 836,49 "," 786,49 ",2792657552,CFD," 0,00 "
15/08/2024 17:08:39,Open Position,XAU/USD," 99,99 ",0.814527," 0,00 "," 836,49 "," 686,50 ",2792657988,CFD," 0,00 "
15/08/2024 17:13:33,Open Position,TSLA/USD," 49,99 ",0.234576," 0,00 "," 836,49 "," 636,51 ",2792659980,CFD," 0,00 "
15/08/2024 17:17:36,Position closed,NSDQ100/USD," 50,23 ",0.051447," 0,23 "," 836,72 "," 686,74 ",2792657552,CFD," 0,00 "
15/08/2024 17:17:54,Open Position,NSDQ100/USD," 179,99 ",0.185193," 0,00 "," 836,72 "," 506,75 ",2792662227,CFD," 0,00 "
15/08/2024 19:27:38,Position closed,XAU/USD," 104,10 ",0.814527," 4,11 "," 840,83 "," 610,85 ",2792657988,CFD," 0,00 "
15/08/2024 19:30:09,Open Position,NSDQ100/USD," 99,99 ",0.102687," 0,00 "," 840,83 "," 510,86 ",2792755667,CFD," 0,00 "
15/08/2024 19:35:07,Open Position,USD/JPY," 99,99 ",3000.000000," 0,00 "," 840,83 "," 410,87 ",2792758948,CFD," 0,00 "
15/08/2024 19:50:03,Position closed,NSDQ100/USD," 102,09 ",0.102687," 2,10 "," 842,93 "," 512,96 ",2792755667,CFD," 0,00 "
15/08/2024 20:50:16,Open Position,NSDQ100/USD," 99,99 ",0.102708," 0,00 "," 842,93 "," 412,97 ",2792778867,CFD," 0,00 "
15/08/2024 20:51:20,Open Position,USD/JPY," 49,99 ",1500.000000," 0,00 "," 842,93 "," 362,98 ",2792778929,CFD," 0,00 "
16/08/2024 00:26:13,Dividend,NSDQ100/USD,"(0,67)",-,"(0,67)"," 842,26 "," 362,31 ",2792662227,CFD," 0,00 "
16/08/2024 00:48:28,Overnight refund,Daily," 0,04 ",-," 0,04 "," 842,30 "," 362,35 ",2792662227,CFD," 0,00 "
16/08/2024 00:48:28,Overnight refund,Daily," 0,02 ",-," 0,02 "," 842,32 "," 362,37 ",2792778867,CFD," 0,00 "
16/08/2024 00:48:28,Overnight fee,Daily,"(0,28)",-,"(0,28)"," 842,04 "," 362,09 ",2792778929,CFD," 0,00 "
16/08/2024 00:48:28,Overnight fee,Daily,"(0,55)",-,"(0,55)"," 841,49 "," 361,54 ",2792758948,CFD," 0,00 "
16/08/2024 01:43:05,Position closed,USD/JPY," 102,99 ",3000.000000," 3,00 "," 844,49 "," 464,53 ",2792758948,CFD," 0,00 "
16/08/2024 02:32:19,Position closed,USD/JPY," 55,03 ",1500.000000," 5,04 "," 849,53 "," 519,56 ",2792778929,CFD," 0,00 "
16/08/2024 06:31:38,Open Position,NSDQ100/USD," 99,99 ",0.102216," 0,00 "," 849,53 "," 419,57 ",2792810012,CFD," 0,00 "
16/08/2024 06:33:04,Open Position,XAU/USD," 49,99 ",0.406952," 0,00 "," 849,53 "," 369,58 ",2792810100,CFD," 0,00 "
16/08/2024 07:53:17,Open Position,XAU/USD," 49,98 ",0.406089," 0,00 "," 849,53 "," 319,60 ",2792850682,CFD," 0,00 "
16/08/2024 08:05:59,Open Position,NSDQ100/USD," 100,00 ",0.102303," 0,00 "," 849,53 "," 219,60 ",2792854018,CFD," 0,00 "
16/08/2024 08:45:23,Position closed,NSDQ100/USD," 104,71 ",0.102216," 4,72 "," 854,25 "," 324,31 ",2792810012,CFD," 0,00 "
16/08/2024 08:46:16,Open Position,NSDQ100/USD," 50,00 ",0.051224," 0,00 "," 854,25 "," 274,31 ",2792862545,CFD," 0,00 "
16/08/2024 11:29:26,Open Position,XAU/USD," 99,99 ",0.810169," 0,00 "," 854,25 "," 174,32 ",2792901161,CFD," 0,00 "
16/08/2024 11:29:49,Position closed,XAU/USD," 47,22 ",0.406089,"(2,76)"," 851,49 "," 221,54 ",2792850682,CFD," 0,00 "
16/08/2024 11:29:58,Position closed,XAU/USD," 45,31 ",0.406952,"(4,68)"," 846,81 "," 266,85 ",2792810100,CFD," 0,00 "
16/08/2024 12:15:31,Position closed,NSDQ100/USD," 182,00 ",0.185193," 2,01 "," 848,82 "," 448,85 ",2792662227,CFD," 0,00 "
16/08/2024 12:20:35,Position closed,NSDQ100/USD," 105,38 ",0.102708," 5,39 "," 854,21 "," 554,23 ",2792778867,CFD," 0,00 "
16/08/2024 12:21:32,Open Position,NSDQ100/USD," 99,99 ",0.102996," 0,00 "," 854,21 "," 454,24 ",2792914470,CFD," 0,00 "
16/08/2024 12:22:14,Position closed,XAU/USD," 102,15 ",0.810169," 2,16 "," 856,37 "," 556,39 ",2792901161,CFD," 0,00 "
16/08/2024 12:22:53,Open Position,NSDQ100/USD," 50,00 ",0.051490," 0,00 "," 856,37 "," 506,39 ",2792914782,CFD," 0,00 "
16/08/2024 12:23:11,Open Position,NSDQ100/USD," 50,00 ",0.051499," 0,00 "," 856,37 "," 456,39 ",2792914832,CFD," 0,00 "
16/08/2024 12:34:02,Open Position,NSDQ100/USD," 120,00 ",0.123921," 0,00 "," 856,37 "," 336,39 ",2792918572,CFD," 0,00 "
16/08/2024 12:34:10,Open Position,NSDQ100/USD," 90,00 ",0.092908," 0,00 "," 856,37 "," 246,39 ",2792918650,CFD," 0,00 "
16/08/2024 13:30:46,Open Position,TSLA/USD," 50,00 ",1.180237," 0,00 "," 856,37 "," 196,39 ",2792977833,CFD," 0,00 "
16/08/2024 13:37:04,Position closed,TSLA/USD," 46,65 ",1.180237,"(3,35)"," 853,02 "," 243,04 ",2792977833,CFD," 0,00 "
16/08/2024 13:37:04,Position closed,TSLA/USD," 49,64 ",0.234576,"(0,35)"," 852,67 "," 292,68 ",2792659980,CFD," 0,00 "
16/08/2024 13:57:51,Open Position,NSDQ100/USD," 99,98 ",0.102973," 0,00 "," 852,67 "," 192,70 ",2793141507,CFD," 0,00 "
16/08/2024 14:05:34,Open Position,NSDQ100/USD," 50,00 ",0.051392," 0,00 "," 852,67 "," 142,70 ",2793156717,CFD," 0,00 "
16/08/2024 14:17:28,Position closed,NSDQ100/USD," 106,45 ",0.102996," 6,46 "," 859,13 "," 249,15 ",2792914470,CFD," 0,00 "
16/08/2024 14:17:28,Position closed,NSDQ100/USD," 53,01 ",0.051490," 3,01 "," 862,14 "," 302,16 ",2792914782,CFD," 0,00 "
16/08/2024 14:17:28,Position closed,NSDQ100/USD," 99,80 ",0.092908," 9,80 "," 871,94 "," 401,96 ",2792918650,CFD," 0,00 "
16/08/2024 14:17:28,Position closed,NSDQ100/USD," 47,84 ",0.051224,"(2,16)"," 869,78 "," 449,80 ",2792862545,CFD," 0,00 "
16/08/2024 14:17:28,Position closed,NSDQ100/USD," 92,82 ",0.102303,"(7,18)"," 862,60 "," 542,62 ",2792854018,CFD," 0,00 "
16/08/2024 14:17:28,Position closed,NSDQ100/USD," 106,04 ",0.102973," 6,06 "," 868,66 "," 648,66 ",2793141507,CFD," 0,00 "
16/08/2024 14:17:28,Position closed,NSDQ100/USD," 53,18 ",0.051499," 3,18 "," 871,84 "," 701,84 ",2792914832,CFD," 0,00 "
16/08/2024 14:17:28,Position closed,NSDQ100/USD," 133,92 ",0.123921," 13,92 "," 885,76 "," 835,76 ",2792918572,CFD," 0,00 "
16/08/2024 14:17:28,Position closed,NSDQ100/USD," 51,08 ",0.051392," 1,08 "," 886,84 "," 886,84 ",2793156717,CFD," 0,00 "
16/08/2024 14:19:29,Open Position,NSDQ100/USD," 89,99 ",0.092341," 0,00 "," 886,84 "," 796,85 ",2793172689,CFD," 0,00 "
16/08/2024 14:20:25,Open Position,NSDQ100/USD," 99,99 ",0.102559," 0,00 "," 886,84 "," 696,86 ",2793173495,CFD," 0,00 "
16/08/2024 14:27:21,Position closed,NSDQ100/USD," 88,65 ",0.092341,"(1,34)"," 885,50 "," 785,51 ",2793172689,CFD," 0,00 "
16/08/2024 14:27:21,Position closed,NSDQ100/USD," 97,69 ",0.102559,"(2,30)"," 883,20 "," 883,20 ",2793173495,CFD," 0,00 "
16/08/2024 14:37:31,Open Position,NSDQ100/USD," 299,99 ",0.308012," 0,00 "," 883,20 "," 583,21 ",2793193678,CFD," 0,00 "
16/08/2024 14:43:11,Open Position,NSDQ100/USD," 50,00 ",0.051364," 0,00 "," 883,20 "," 533,21 ",2793199542,CFD," 0,00 "
16/08/2024 14:52:10,Open Position,NSDQ100/USD," 99,99 ",0.102813," 0,00 "," 883,20 "," 433,22 ",2793209360,CFD," 0,00 "
16/08/2024 15:07:25,Open Position,NSDQ100/USD," 60,00 ",0.061710," 0,00 "," 883,20 "," 373,22 ",2793238390,CFD," 0,00 "
16/08/2024 15:23:10,Open Position,NSDQ100/USD," 50,00 ",0.051454," 0,00 "," 883,20 "," 323,22 ",2793284871,CFD," 0,00 "
16/08/2024 15:29:23,Open Position,NSDQ100/USD," 50,00 ",0.051434," 0,00 "," 883,20 "," 273,22 ",2793297590,CFD," 0,00 "
16/08/2024 15:47:30,Position closed,NSDQ100/USD," 299,68 ",0.308012,"(0,31)"," 882,89 "," 572,90 ",2793193678,CFD," 0,00 "
16/08/2024 15:49:55,Position closed,NSDQ100/USD," 101,91 ",0.102813," 1,92 "," 884,81 "," 674,81 ",2793209360,CFD," 0,00 "
16/08/2024 15:49:55,Position closed,NSDQ100/USD," 50,14 ",0.051364," 0,14 "," 884,95 "," 724,95 ",2793199542,CFD," 0,00 "
16/08/2024 15:49:55,Position closed,NSDQ100/USD," 51,89 ",0.051454," 1,89 "," 886,84 "," 776,84 ",2793284871,CFD," 0,00 "
16/08/2024 15:49:55,Position closed,NSDQ100/USD," 61,57 ",0.061710," 1,57 "," 888,41 "," 838,41 ",2793238390,CFD," 0,00 "
16/08/2024 15:49:55,Position closed,NSDQ100/USD," 51,49 ",0.051434," 1,49 "," 889,90 "," 889,90 ",2793297590,CFD," 0,00 "
16/08/2024 16:56:42,Open Position,NSDQ100/USD," 50,00 ",0.051166," 0,00 "," 889,90 "," 839,90 ",2793347343,CFD," 0,00 "
16/08/2024 17:42:14,Position closed,NSDQ100/USD," 50,03 ",0.051166," 0,03 "," 889,93 "," 889,93 ",2793347343,CFD," 0,00 "
19/08/2024 07:39:49,Open Position,NSDQ100/USD," 199,99 ",0.205103," 0,00 "," 889,93 "," 689,94 ",2793583126,CFD," 0,00 "
19/08/2024 09:04:24,Open Position,NSDQ100/USD," 179,99 ",0.184853," 0,00 "," 889,93 "," 509,95 ",2793610985,CFD," 0,00 "
19/08/2024 09:16:40,Open Position,NSDQ100/USD," 100,00 ",0.102770," 0,00 "," 889,93 "," 409,95 ",2793613297,CFD," 0,00 "
19/08/2024 09:29:25,Open Position,NSDQ100/USD," 50,00 ",0.051323," 0,00 "," 889,93 "," 359,95 ",2793615163,CFD," 0,00 "
19/08/2024 09:31:15,Open Position,NSDQ100/USD," 100,00 ",0.102633," 0,00 "," 889,93 "," 259,95 ",2793615480,CFD," 0,00 "
19/08/2024 09:33:06,Open Position,NSDQ100/USD," 70,00 ",0.071837," 0,00 "," 889,93 "," 189,95 ",2793616002,CFD," 0,00 "
19/08/2024 10:21:54,Open Position,NSDQ100/USD," 50,00 ",0.051262," 0,00 "," 889,93 "," 139,95 ",2793624383,CFD," 0,00 "
19/08/2024 11:38:05,Position closed,NSDQ100/USD," 187,84 ",0.184853," 7,85 "," 897,78 "," 327,79 ",2793610985,CFD," 0,00 "
19/08/2024 11:38:05,Position closed,NSDQ100/USD," 51,69 ",0.051323," 1,69 "," 899,47 "," 379,48 ",2793615163,CFD," 0,00 "
19/08/2024 11:38:05,Position closed,NSDQ100/USD," 105,80 ",0.102770," 5,80 "," 905,27 "," 485,28 ",2793613297,CFD," 0,00 "
19/08/2024 11:38:05,Position closed,NSDQ100/USD," 203,12 ",0.205103," 3,13 "," 908,40 "," 688,40 ",2793583126,CFD," 0,00 "
19/08/2024 11:38:05,Position closed,NSDQ100/USD," 72,07 ",0.071837," 2,07 "," 910,47 "," 760,47 ",2793616002,CFD," 0,00 "
19/08/2024 11:38:05,Position closed,NSDQ100/USD," 103,13 ",0.102633," 3,13 "," 913,60 "," 863,60 ",2793615480,CFD," 0,00 "
19/08/2024 11:38:05,Position closed,NSDQ100/USD," 50,51 ",0.051262," 0,51 "," 914,11 "," 914,11 ",2793624383,CFD," 0,00 "
19/08/2024 11:49:47,Open Position,NSDQ100/USD," 100,00 ",0.102447," 0,00 "," 914,11 "," 814,11 ",2793640423,CFD," 0,00 "
19/08/2024 11:49:59,Open Position,NSDQ100/USD," 209,99 ",0.215146," 0,00 "," 914,11 "," 604,12 ",2793640439,CFD," 0,00 "
19/08/2024 11:55:03,Open Position,NSDQ100/USD," 50,00 ",0.051220," 0,00 "," 914,11 "," 554,12 ",2793641303,CFD," 0,00 "
19/08/2024 12:30:16,Open Position,NSDQ100/USD," 50,00 ",0.051164," 0,00 "," 914,11 "," 504,12 ",2793659824,CFD," 0,00 "
19/08/2024 12:30:30,Position closed,NSDQ100/USD," 49,65 ",0.051164,"(0,35)"," 913,76 "," 553,77 ",2793659824,CFD," 0,00 "
19/08/2024 12:31:12,Position closed,NSDQ100/USD," 213,55 ",0.215146," 3,56 "," 917,32 "," 767,32 ",2793640439,CFD," 0,00 "
19/08/2024 12:31:12,Position closed,NSDQ100/USD," 50,76 ",0.051220," 0,76 "," 918,08 "," 818,08 ",2793641303,CFD," 0,00 "
19/08/2024 12:31:12,Position closed,NSDQ100/USD," 101,62 ",0.102447," 1,62 "," 919,70 "," 919,70 ",2793640423,CFD," 0,00 "
19/08/2024 12:37:27,Open Position,NSDQ100/USD," 100,00 ",0.102377," 0,00 "," 919,70 "," 819,70 ",2793661310,CFD," 0,00 "
19/08/2024 12:42:25,Position closed,NSDQ100/USD," 99,26 ",0.102377,"(0,74)"," 918,96 "," 918,96 ",2793661310,CFD," 0,00 "
19/08/2024 12:44:09,Open Position,XAU/USD," 99,99 ",0.802555," 0,00 "," 918,96 "," 818,97 ",2793664644,CFD," 0,00 "
19/08/2024 12:53:12,Open Position,XAU/USD," 99,99 ",0.803128," 0,00 "," 918,96 "," 718,98 ",2793666326,CFD," 0,00 "
19/08/2024 12:54:01,Open Position,NSDQ100/USD," 179,99 ",0.184312," 0,00 "," 918,96 "," 538,99 ",2793666490,CFD," 0,00 "
19/08/2024 12:54:15,Open Position,NSDQ100/USD," 100,00 ",0.102396," 0,00 "," 918,96 "," 438,99 ",2793666522,CFD," 0,00 "
19/08/2024 13:00:46,Open Position,XAU/USD," 50,00 ",0.401454," 0,00 "," 918,96 "," 388,99 ",2793667669,CFD," 0,00 "
19/08/2024 13:31:19,Open Position,TSLA/USD," 49,99 ",1.138854," 0,00 "," 918,96 "," 339,00 ",2793753653,CFD," 0,00 "
19/08/2024 13:31:49,Open Position,NSDQ100/USD," 149,98 ",0.153782," 0,00 "," 918,96 "," 189,02 ",2793792418,CFD," 0,00 "
19/08/2024 13:31:52,Open Position,NSDQ100/USD," 50,00 ",0.051284," 0,00 "," 918,96 "," 139,02 ",2793793040,CFD," 0,00 "
19/08/2024 13:32:05,Open Position,NSDQ100/USD," 50,00 ",0.051262," 0,00 "," 918,96 "," 89,02 ",2793795702,CFD," 0,00 "
19/08/2024 13:33:10,Open Position,NSDQ100/USD," 50,00 ",0.051229," 0,00 "," 918,96 "," 39,02 ",2793797506,CFD," 0,00 "
19/08/2024 13:34:16,Position closed,XAU/USD," 100,15 ",0.802555," 0,16 "," 919,12 "," 139,17 ",2793664644,CFD," 0,00 "
19/08/2024 13:34:16,Position closed,XAU/USD," 101,58 ",0.803128," 1,59 "," 920,71 "," 240,75 ",2793666326,CFD," 0,00 "
19/08/2024 13:34:16,Position closed,XAU/USD," 50,52 ",0.401454," 0,52 "," 921,23 "," 291,27 ",2793667669,CFD," 0,00 "
19/08/2024 13:34:29,Open Position,NSDQ100/USD," 50,00 ",0.051276," 0,00 "," 921,23 "," 241,27 ",2793805222,CFD," 0,00 "
19/08/2024 13:35:13,Open Position,NSDQ100/USD," 50,00 ",0.051279," 0,00 "," 921,23 "," 191,27 ",2793807154,CFD," 0,00 "
19/08/2024 13:36:19,Open Position,NSDQ100/USD," 50,00 ",0.051277," 0,00 "," 921,23 "," 141,27 ",2793809553,CFD," 0,00 "
19/08/2024 13:36:46,Open Position,NSDQ100/USD," 50,00 ",0.051312," 0,00 "," 921,23 "," 91,27 ",2793810631,CFD," 0,00 "
19/08/2024 13:37:31,Open Position,NSDQ100/USD," 70,00 ",0.071904," 0,00 "," 921,23 "," 21,27 ",2793812247,CFD," 0,00 "
19/08/2024 13:50:38,Position closed,NSDQ100/USD," 98,73 ",0.102396,"(1,27)"," 919,96 "," 120,00 ",2793666522,CFD," 0,00 "
19/08/2024 13:51:52,Position closed,NSDQ100/USD," 151,36 ",0.153782," 1,38 "," 921,34 "," 271,36 ",2793792418,CFD," 0,00 "
19/08/2024 13:52:22,Position closed,NSDQ100/USD," 50,05 ",0.051229," 0,05 "," 921,39 "," 321,41 ",2793797506,CFD," 0,00 "
19/08/2024 13:55:01,Open Position,NSDQ100/USD," 50,00 ",0.051284," 0,00 "," 921,39 "," 271,41 ",2793936879,CFD," 0,00 "
19/08/2024 13:55:26,Open Position,NSDQ100/USD," 50,00 ",0.051278," 0,00 "," 921,39 "," 221,41 ",2793937810,CFD," 0,00 "
19/08/2024 13:56:48,Position closed,NSDQ100/USD," 176,45 ",0.184312,"(3,54)"," 917,85 "," 397,86 ",2793666490,CFD," 0,00 "
19/08/2024 13:57:44,Open Position,NSDQ100/USD," 50,00 ",0.051271," 0,00 "," 917,85 "," 347,86 ",2793944040,CFD," 0,00 "
19/08/2024 13:58:41,Open Position,NSDQ100/USD," 50,00 ",0.051273," 0,00 "," 917,85 "," 297,86 ",2793945493,CFD," 0,00 "
19/08/2024 13:59:30,Open Position,NSDQ100/USD," 79,99 ",0.082068," 0,00 "," 917,85 "," 217,87 ",2793946691,CFD," 0,00 "
19/08/2024 14:01:12,Open Position,NSDQ100/USD," 60,00 ",0.061525," 0,00 "," 917,85 "," 157,87 ",2793948919,CFD," 0,00 "
19/08/2024 14:01:33,Open Position,NSDQ100/USD," 50,00 ",0.051320," 0,00 "," 917,85 "," 107,87 ",2793949522,CFD," 0,00 "
19/08/2024 14:01:42,Open Position,NSDQ100/USD," 50,00 ",0.051316," 0,00 "," 917,85 "," 57,87 ",2793949848,CFD," 0,00 "
19/08/2024 14:02:31,Open Position,NSDQ100/USD," 50,00 ",0.051337," 0,00 "," 917,85 "," 7,87 ",2793950691,CFD," 0,00 "
19/08/2024 14:17:53,Position closed,TSLA/USD," 50,87 ",1.138854," 0,88 "," 918,73 "," 58,74 ",2793753653,CFD," 0,00 "
19/08/2024 14:18:05,Open Position,NSDQ100/USD," 50,00 ",0.051367," 0,00 "," 918,73 "," 8,74 ",2793979971,CFD," 0,00 "
19/08/2024 14:28:22,Position closed,NSDQ100/USD," 50,80 ",0.051284," 0,80 "," 919,53 "," 59,54 ",2793793040,CFD," 0,00 "
19/08/2024 14:28:22,Position closed,NSDQ100/USD," 50,63 ",0.051276," 0,63 "," 920,16 "," 110,17 ",2793805222,CFD," 0,00 "
19/08/2024 14:28:22,Position closed,NSDQ100/USD," 50,36 ",0.051262," 0,36 "," 920,52 "," 160,53 ",2793795702,CFD," 0,00 "
19/08/2024 14:28:22,Position closed,NSDQ100/USD," 50,69 ",0.051279," 0,69 "," 921,21 "," 211,22 ",2793807154,CFD," 0,00 "
19/08/2024 14:28:22,Position closed,NSDQ100/USD," 51,34 ",0.051312," 1,34 "," 922,55 "," 262,56 ",2793810631,CFD," 0,00 "
19/08/2024 14:28:22,Position closed,NSDQ100/USD," 50,80 ",0.051284," 0,80 "," 923,35 "," 313,36 ",2793936879,CFD," 0,00 "
19/08/2024 14:28:22,Position closed,NSDQ100/USD," 50,66 ",0.051277," 0,66 "," 924,01 "," 364,02 ",2793809553,CFD," 0,00 "
19/08/2024 14:28:22,Position closed,NSDQ100/USD," 50,54 ",0.051271," 0,54 "," 924,55 "," 414,56 ",2793944040,CFD," 0,00 "
19/08/2024 14:28:22,Position closed,NSDQ100/USD," 81,62 ",0.082068," 1,63 "," 926,18 "," 496,18 ",2793946691,CFD," 0,00 "
19/08/2024 14:28:22,Position closed,NSDQ100/USD," 73,18 ",0.071904," 3,18 "," 929,36 "," 569,36 ",2793812247,CFD," 0,00 "
19/08/2024 14:28:22,Position closed,NSDQ100/USD," 50,68 ",0.051278," 0,68 "," 930,04 "," 620,04 ",2793937810,CFD," 0,00 "
19/08/2024 14:28:22,Position closed,NSDQ100/USD," 60,64 ",0.061525," 0,64 "," 930,68 "," 680,68 ",2793948919,CFD," 0,00 "
19/08/2024 14:28:22,Position closed,NSDQ100/USD," 50,59 ",0.051273," 0,59 "," 931,27 "," 731,27 ",2793945493,CFD," 0,00 "
19/08/2024 14:28:22,Position closed,NSDQ100/USD," 51,83 ",0.051337," 1,83 "," 933,10 "," 783,10 ",2793950691,CFD," 0,00 "
19/08/2024 14:28:22,Position closed,NSDQ100/USD," 51,50 ",0.051320," 1,50 "," 934,60 "," 834,60 ",2793949522,CFD," 0,00 "
19/08/2024 14:28:22,Position closed,NSDQ100/USD," 51,43 ",0.051316," 1,43 "," 936,03 "," 886,03 ",2793949848,CFD," 0,00 "
19/08/2024 14:28:22,Position closed,NSDQ100/USD," 52,42 ",0.051367," 2,42 "," 938,45 "," 938,45 ",2793979971,CFD," 0,00 "
19/08/2024 14:30:40,Open Position,NSDQ100/USD," 99,99 ",0.102419," 0,00 "," 938,45 "," 838,46 ",2793999881,CFD," 0,00 "
19/08/2024 14:31:05,Position closed,NSDQ100/USD," 99,04 ",0.102419,"(0,95)"," 937,50 "," 937,50 ",2793999881,CFD," 0,00 "
19/08/2024 14:31:43,Open Position,NSDQ100/USD," 50,00 ",0.051207," 0,00 "," 937,50 "," 887,50 ",2794000839,CFD," 0,00 "
19/08/2024 14:34:37,Position closed,NSDQ100/USD," 49,81 ",0.051207,"(0,19)"," 937,31 "," 937,31 ",2794000839,CFD," 0,00 "
19/08/2024 14:36:04,Open Position,NSDQ100/USD," 50,00 ",0.051227," 0,00 "," 937,31 "," 887,31 ",2794007409,CFD," 0,00 "
19/08/2024 14:36:28,Open Position,NSDQ100/USD," 50,00 ",0.051218," 0,00 "," 937,31 "," 837,31 ",2794007652,CFD," 0,00 "
19/08/2024 14:37:48,Open Position,NSDQ100/USD," 99,99 ",0.102459," 0,00 "," 937,31 "," 737,32 ",2794008914,CFD," 0,00 "
19/08/2024 14:38:23,Open Position,NSDQ100/USD," 50,00 ",0.051229," 0,00 "," 937,31 "," 687,32 ",2794009797,CFD," 0,00 "
19/08/2024 14:39:09,Open Position,NSDQ100/USD," 50,00 ",0.051224," 0,00 "," 937,31 "," 637,32 ",2794010639,CFD," 0,00 "
19/08/2024 14:39:46,Open Position,NSDQ100/USD," 50,00 ",0.051216," 0,00 "," 937,31 "," 587,32 ",2794019890,CFD," 0,00 "
19/08/2024 14:40:34,Open Position,NSDQ100/USD," 50,00 ",0.051247," 0,00 "," 937,31 "," 537,32 ",2794020526,CFD," 0,00 "
19/08/2024 14:40:49,Open Position,NSDQ100/USD," 50,00 ",0.051253," 0,00 "," 937,31 "," 487,32 ",2794020924,CFD," 0,00 "
19/08/2024 14:41:12,Open Position,NSDQ100/USD," 50,00 ",0.051228," 0,00 "," 937,31 "," 437,32 ",2794021216,CFD," 0,00 "
19/08/2024 14:47:17,Position closed,NSDQ100/USD," 101,11 ",0.102459," 1,12 "," 938,43 "," 538,43 ",2794008914,CFD," 0,00 "
19/08/2024 14:47:17,Position closed,NSDQ100/USD," 50,52 ",0.051227," 0,52 "," 938,95 "," 588,95 ",2794007409,CFD," 0,00 "
19/08/2024 14:47:17,Position closed,NSDQ100/USD," 50,56 ",0.051229," 0,56 "," 939,51 "," 639,51 ",2794009797,CFD," 0,00 "
19/08/2024 14:47:17,Position closed,NSDQ100/USD," 51,02 ",0.051253," 1,02 "," 940,53 "," 690,53 ",2794020924,CFD," 0,00 "
19/08/2024 14:47:17,Position closed,NSDQ100/USD," 50,91 ",0.051247," 0,91 "," 941,44 "," 741,44 ",2794020526,CFD," 0,00 "
19/08/2024 14:47:17,Position closed,NSDQ100/USD," 50,35 ",0.051218," 0,35 "," 941,79 "," 791,79 ",2794007652,CFD," 0,00 "
19/08/2024 14:47:17,Position closed,NSDQ100/USD," 50,47 ",0.051224," 0,47 "," 942,26 "," 842,26 ",2794010639,CFD," 0,00 "
19/08/2024 14:47:17,Position closed,NSDQ100/USD," 50,53 ",0.051228," 0,53 "," 942,79 "," 892,79 ",2794021216,CFD," 0,00 "
19/08/2024 14:47:17,Position closed,NSDQ100/USD," 50,30 ",0.051216," 0,30 "," 943,09 "," 943,09 ",2794019890,CFD," 0,00 "
19/08/2024 14:48:55,Open Position,NSDQ100/USD," 50,00 ",0.051202," 0,00 "," 943,09 "," 893,09 ",2794031370,CFD," 0,00 "
19/08/2024 14:49:14,Open Position,NSDQ100/USD," 50,00 ",0.051209," 0,00 "," 943,09 "," 843,09 ",2794031807,CFD," 0,00 "
19/08/2024 14:50:58,Open Position,NSDQ100/USD," 99,99 ",0.102316," 0,00 "," 943,09 "," 743,10 ",2794034256,CFD," 0,00 "
19/08/2024 14:51:10,Open Position,NSDQ100/USD," 50,00 ",0.051142," 0,00 "," 943,09 "," 693,10 ",2794035468,CFD," 0,00 "
19/08/2024 14:51:24,Position closed,NSDQ100/USD," 49,72 ",0.051142,"(0,28)"," 942,81 "," 742,82 ",2794035468,CFD," 0,00 "
19/08/2024 14:51:28,Position closed,NSDQ100/USD," 100,14 ",0.102316," 0,15 "," 942,96 "," 842,96 ",2794034256,CFD," 0,00 "
19/08/2024 14:51:28,Position closed,NSDQ100/USD," 51,07 ",0.051209," 1,07 "," 944,03 "," 894,03 ",2794031807,CFD," 0,00 "
19/08/2024 14:51:28,Position closed,NSDQ100/USD," 50,87 ",0.051202," 0,87 "," 944,90 "," 944,90 ",2794031370,CFD," 0,00 "
19/08/2024 14:52:03,Open Position,NSDQ100/USD," 99,99 ",0.102280," 0,00 "," 944,90 "," 844,91 ",2794037232,CFD," 0,00 "
19/08/2024 14:52:39,Position closed,NSDQ100/USD," 99,56 ",0.102280,"(0,43)"," 944,47 "," 944,47 ",2794037232,CFD," 0,00 "
19/08/2024 14:53:24,Open Position,NSDQ100/USD," 99,99 ",0.102228," 0,00 "," 944,47 "," 844,48 ",2794039657,CFD," 0,00 "
19/08/2024 14:54:03,Open Position,NSDQ100/USD," 220,00 ",0.224814," 0,00 "," 944,47 "," 624,48 ",2794040552,CFD," 0,00 "
19/08/2024 14:54:48,Open Position,NSDQ100/USD," 49,99 ",0.051100," 0,00 "," 944,47 "," 574,49 ",2794041374,CFD," 0,00 "
19/08/2024 14:55:25,Open Position,NSDQ100/USD," 149,99 ",0.153388," 0,00 "," 944,47 "," 424,50 ",2794042088,CFD," 0,00 "
19/08/2024 14:56:02,Open Position,NSDQ100/USD," 50,00 ",0.051134," 0,00 "," 944,47 "," 374,50 ",2794042880,CFD," 0,00 "
19/08/2024 14:56:27,Open Position,NSDQ100/USD," 99,98 ",0.102249," 0,00 "," 944,47 "," 274,52 ",2794043444,CFD," 0,00 "
19/08/2024 14:57:29,Open Position,NSDQ100/USD," 50,00 ",0.051134," 0,00 "," 944,47 "," 224,52 ",2794044955,CFD," 0,00 "
19/08/2024 14:58:00,Open Position,NSDQ100/USD," 50,00 ",0.051128," 0,00 "," 944,47 "," 174,52 ",2794045357,CFD," 0,00 "
19/08/2024 14:59:48,Open Position,NSDQ100/USD," 50,00 ",0.051116," 0,00 "," 944,47 "," 124,52 ",2794048243,CFD," 0,00 "
19/08/2024 15:00:12,Position closed,NSDQ100/USD," 218,75 ",0.224814,"(1,25)"," 943,22 "," 343,27 ",2794040552,CFD," 0,00 "
19/08/2024 15:00:17,Position closed,NSDQ100/USD," 100,76 ",0.102249," 0,78 "," 944,00 "," 444,03 ",2794043444,CFD," 0,00 "
19/08/2024 15:00:21,Position closed,NSDQ100/USD," 151,37 ",0.153388," 1,38 "," 945,38 "," 595,40 ",2794042088,CFD," 0,00 "
19/08/2024 15:00:28,Position closed,NSDQ100/USD," 49,84 ",0.051100,"(0,15)"," 945,23 "," 645,24 ",2794041374,CFD," 0,00 "
19/08/2024 15:01:09,Position closed,NSDQ100/USD," 100,15 ",0.102228," 0,16 "," 945,39 "," 745,39 ",2794039657,CFD," 0,00 "
19/08/2024 15:01:09,Position closed,NSDQ100/USD," 50,47 ",0.051134," 0,47 "," 945,86 "," 795,86 ",2794044955,CFD," 0,00 "
19/08/2024 15:01:09,Position closed,NSDQ100/USD," 50,35 ",0.051128," 0,35 "," 946,21 "," 846,21 ",2794045357,CFD," 0,00 "
19/08/2024 15:01:09,Position closed,NSDQ100/USD," 50,48 ",0.051134," 0,48 "," 946,69 "," 896,69 ",2794042880,CFD," 0,00 "
19/08/2024 15:01:09,Position closed,NSDQ100/USD," 50,12 ",0.051116," 0,12 "," 946,81 "," 946,81 ",2794048243,CFD," 0,00 "
19/08/2024 15:02:25,Open Position,NSDQ100/USD," 50,00 ",0.051088," 0,00 "," 946,81 "," 896,81 ",2794051136,CFD," 0,00 "
19/08/2024 15:03:03,Open Position,NSDQ100/USD," 50,00 ",0.051078," 0,00 "," 946,81 "," 846,81 ",2794051569,CFD," 0,00 "
19/08/2024 15:03:16,Open Position,NSDQ100/USD," 50,00 ",0.051069," 0,00 "," 946,81 "," 796,81 ",2794051705,CFD," 0,00 "
19/08/2024 15:03:47,Open Position,NSDQ100/USD," 50,00 ",0.051079," 0,00 "," 946,81 "," 746,81 ",2794051971,CFD," 0,00 "
19/08/2024 15:04:55,Open Position,NSDQ100/USD," 50,00 ",0.051073," 0,00 "," 946,81 "," 696,81 ",2794053097,CFD," 0,00 "
19/08/2024 15:05:30,Open Position,NSDQ100/USD," 50,00 ",0.051080," 0,00 "," 946,81 "," 646,81 ",2794053709,CFD," 0,00 "
19/08/2024 15:06:54,Open Position,USD/JPY," 100,00 ",3000.000000," 0,00 "," 946,81 "," 546,81 ",2794055109,CFD," 0,00 "
19/08/2024 15:08:16,Open Position,NSDQ100/USD," 50,00 ",0.051073," 0,00 "," 946,81 "," 496,81 ",2794056239,CFD," 0,00 "
19/08/2024 15:09:08,Open Position,USD/JPY," 100,00 ",3000.000000," 0,00 "," 946,81 "," 396,81 ",2794057191,CFD," 0,00 "
19/08/2024 15:10:06,Open Position,NSDQ100/USD," 50,00 ",0.051047," 0,00 "," 946,81 "," 346,81 ",2794060838,CFD," 0,00 "
19/08/2024 15:10:21,Position closed,NSDQ100/USD," 49,66 ",0.051047,"(0,34)"," 946,47 "," 396,47 ",2794060838,CFD," 0,00 "
19/08/2024 15:10:32,Open Position,NSDQ100/USD," 99,99 ",0.102134," 0,00 "," 946,47 "," 296,48 ",2794061355,CFD," 0,00 "
19/08/2024 15:11:21,Open Position,USD/JPY," 50,00 ",1500.000000," 0,00 "," 946,47 "," 246,48 ",2794062360,CFD," 0,00 "
19/08/2024 15:11:38,Open Position,NSDQ100/USD," 50,00 ",0.051064," 0,00 "," 946,47 "," 196,48 ",2794062524,CFD," 0,00 "
19/08/2024 15:12:06,Open Position,NSDQ100/USD," 50,00 ",0.051084," 0,00 "," 946,47 "," 146,48 ",2794062995,CFD," 0,00 "
19/08/2024 15:12:26,Position closed,USD/JPY," 50,40 ",1500.000000," 0,40 "," 946,87 "," 196,88 ",2794062360,CFD," 0,00 "
19/08/2024 15:12:26,Position closed,USD/JPY," 101,70 ",3000.000000," 1,70 "," 948,57 "," 298,58 ",2794055109,CFD," 0,00 "
19/08/2024 15:12:26,Position closed,USD/JPY," 100,16 ",3000.000000," 0,16 "," 948,73 "," 398,74 ",2794057191,CFD," 0,00 "
19/08/2024 15:12:45,Open Position,NSDQ100/USD," 50,00 ",0.051101," 0,00 "," 948,73 "," 348,74 ",2794065044,CFD," 0,00 "
19/08/2024 15:13:01,Open Position,NSDQ100/USD," 50,00 ",0.051103," 0,00 "," 948,73 "," 298,74 ",2794065453,CFD," 0,00 "
19/08/2024 15:13:42,Open Position,USD/JPY," 80,00 ",2400.000000," 0,00 "," 948,73 "," 218,74 ",2794066322,CFD," 0,00 "
19/08/2024 15:14:01,Open Position,NSDQ100/USD," 99,99 ",0.102195," 0,00 "," 948,73 "," 118,75 ",2794066641,CFD," 0,00 "
19/08/2024 15:15:24,Open Position,NSDQ100/USD," 50,00 ",0.051099," 0,00 "," 948,73 "," 68,75 ",2794071917,CFD," 0,00 "
19/08/2024 15:53:11,Position closed,USD/JPY," 80,10 ",2400.000000," 0,10 "," 948,83 "," 148,85 ",2794066322,CFD," 0,00 "
19/08/2024 15:54:35,Position closed,NSDQ100/USD," 50,15 ",0.051069," 0,15 "," 948,98 "," 199,00 ",2794051705,CFD," 0,00 "
19/08/2024 15:54:35,Position closed,NSDQ100/USD," 50,34 ",0.051079," 0,34 "," 949,32 "," 249,34 ",2794051971,CFD," 0,00 "
19/08/2024 15:54:35,Position closed,NSDQ100/USD," 50,31 ",0.051078," 0,31 "," 949,63 "," 299,65 ",2794051569,CFD," 0,00 "
19/08/2024 15:54:35,Position closed,NSDQ100/USD," 50,35 ",0.051080," 0,35 "," 949,98 "," 350,00 ",2794053709,CFD," 0,00 "
19/08/2024 15:54:35,Position closed,NSDQ100/USD," 50,50 ",0.051088," 0,50 "," 950,48 "," 400,50 ",2794051136,CFD," 0,00 "
19/08/2024 15:54:35,Position closed,NSDQ100/USD," 50,22 ",0.051073," 0,22 "," 950,70 "," 450,72 ",2794056239,CFD," 0,00 "
19/08/2024 15:54:35,Position closed,NSDQ100/USD," 50,43 ",0.051084," 0,43 "," 951,13 "," 501,15 ",2794062995,CFD," 0,00 "
19/08/2024 15:54:35,Position closed,NSDQ100/USD," 100,18 ",0.102134," 0,19 "," 951,32 "," 601,33 ",2794061355,CFD," 0,00 "
19/08/2024 15:54:35,Position closed,NSDQ100/USD," 50,21 ",0.051073," 0,21 "," 951,53 "," 651,54 ",2794053097,CFD," 0,00 "
19/08/2024 15:54:35,Position closed,NSDQ100/USD," 50,78 ",0.051101," 0,78 "," 952,31 "," 702,32 ",2794065044,CFD," 0,00 "
19/08/2024 15:54:35,Position closed,NSDQ100/USD," 50,82 ",0.051103," 0,82 "," 953,13 "," 753,14 ",2794065453,CFD," 0,00 "
19/08/2024 15:54:35,Position closed,NSDQ100/USD," 50,73 ",0.051099," 0,73 "," 953,86 "," 803,87 ",2794071917,CFD," 0,00 "
19/08/2024 15:54:35,Position closed,NSDQ100/USD," 50,05 ",0.051064," 0,05 "," 953,91 "," 853,92 ",2794062524,CFD," 0,00 "
19/08/2024 15:54:35,Position closed,NSDQ100/USD," 101,41 ",0.102195," 1,42 "," 955,33 "," 955,33 ",2794066641,CFD," 0,00 "
19/08/2024 15:57:33,Open Position,NSDQ100/USD," 99,99 ",0.102222," 0,00 "," 955,33 "," 855,34 ",2794126415,CFD," 0,00 "
19/08/2024 15:57:58,Open Position,NSDQ100/USD," 99,99 ",0.102253," 0,00 "," 955,33 "," 755,35 ",2794126684,CFD," 0,00 "
19/08/2024 15:58:12,Open Position,NSDQ100/USD," 190,00 ",0.194467," 0,00 "," 955,33 "," 565,35 ",2794126860,CFD," 0,00 "
19/08/2024 15:58:23,Open Position,NSDQ100/USD," 149,99 ",0.153489," 0,00 "," 955,33 "," 415,36 ",2794127016,CFD," 0,00 "
19/08/2024 15:58:43,Open Position,NSDQ100/USD," 109,99 ",0.112571," 0,00 "," 955,33 "," 305,37 ",2794127161,CFD," 0,00 "
19/08/2024 15:58:51,Open Position,NSDQ100/USD," 80,00 ",0.081856," 0,00 "," 955,33 "," 225,37 ",2794127224,CFD," 0,00 "
19/08/2024 15:59:14,Open Position,NSDQ100/USD," 60,00 ",0.061387," 0,00 "," 955,33 "," 165,37 ",2794127460,CFD," 0,00 "
19/08/2024 15:59:52,Open Position,NSDQ100/USD," 50,00 ",0.051155," 0,00 "," 955,33 "," 115,37 ",2794127850,CFD," 0,00 "
19/08/2024 16:00:44,Open Position,NSDQ100/USD," 50,00 ",0.051191," 0,00 "," 955,33 "," 65,37 ",2794129053,CFD," 0,00 "
19/08/2024 16:01:07,Open Position,NSDQ100/USD," 50,00 ",0.051183," 0,00 "," 955,33 "," 15,37 ",2794129275,CFD," 0,00 "
19/08/2024 16:12:35,Position closed,NSDQ100/USD," 99,77 ",0.102222,"(0,22)"," 955,11 "," 115,14 ",2794126415,CFD," 0,00 "
19/08/2024 16:15:44,Open Position,NSDQ100/USD," 99,99 ",0.102263," 0,00 "," 955,11 "," 15,15 ",2794156445,CFD," 0,00 "
19/08/2024 16:16:34,Position closed,NSDQ100/USD," 194,12 ",0.194467," 4,12 "," 959,23 "," 209,27 ",2794126860,CFD," 0,00 "
19/08/2024 16:16:34,Position closed,NSDQ100/USD," 112,06 ",0.112571," 2,07 "," 961,30 "," 321,33 ",2794127161,CFD," 0,00 "
19/08/2024 16:16:34,Position closed,NSDQ100/USD," 100,25 ",0.102253," 0,26 "," 961,56 "," 421,58 ",2794126684,CFD," 0,00 "
19/08/2024 16:16:34,Position closed,NSDQ100/USD," 152,50 ",0.153489," 2,51 "," 964,07 "," 574,08 ",2794127016,CFD," 0,00 "
19/08/2024 16:16:34,Position closed,NSDQ100/USD," 60,81 ",0.061387," 0,81 "," 964,88 "," 634,89 ",2794127460,CFD," 0,00 "
19/08/2024 16:16:34,Position closed,NSDQ100/USD," 81,25 ",0.081856," 1,25 "," 966,13 "," 716,14 ",2794127224,CFD," 0,00 "
19/08/2024 16:16:34,Position closed,NSDQ100/USD," 50,68 ",0.051155," 0,68 "," 966,81 "," 766,82 ",2794127850,CFD," 0,00 "
19/08/2024 16:16:34,Position closed,NSDQ100/USD," 51,24 ",0.051183," 1,24 "," 968,05 "," 818,06 ",2794129275,CFD," 0,00 "
19/08/2024 16:16:34,Position closed,NSDQ100/USD," 51,39 ",0.051191," 1,39 "," 969,44 "," 869,45 ",2794129053,CFD," 0,00 "
19/08/2024 16:16:34,Position closed,NSDQ100/USD," 100,44 ",0.102263," 0,45 "," 969,89 "," 969,89 ",2794156445,CFD," 0,00 "
19/08/2024 16:21:29,Open Position,NSDQ100/USD," 50,00 ",0.051103," 0,00 "," 969,89 "," 919,89 ",2794159757,CFD," 0,00 "
19/08/2024 16:23:42,Open Position,XAU/USD," 50,00 ",0.399581," 0,00 "," 969,89 "," 869,89 ",2794160811,CFD," 0,00 "
19/08/2024 16:23:57,Open Position,XAU/USD," 50,00 ",0.399622," 0,00 "," 969,89 "," 819,89 ",2794160922,CFD," 0,00 "
19/08/2024 16:33:04,Position closed,XAU/USD," 51,11 ",0.399622," 1,11 "," 971,00 "," 871,00 ",2794160922,CFD," 0,00 "
19/08/2024 16:33:04,Position closed,XAU/USD," 51,00 ",0.399581," 1,00 "," 972,00 "," 922,00 ",2794160811,CFD," 0,00 "
19/08/2024 16:42:50,Open Position,NSDQ100/USD," 50,00 ",0.051067," 0,00 "," 972,00 "," 872,00 ",2794171323,CFD," 0,00 "
19/08/2024 16:43:56,Position closed,NSDQ100/USD," 49,91 ",0.051067,"(0,09)"," 971,91 "," 921,91 ",2794171323,CFD," 0,00 "
19/08/2024 16:43:56,Position closed,NSDQ100/USD," 50,60 ",0.051103," 0,60 "," 972,51 "," 972,51 ",2794159757,CFD," 0,00 "
19/08/2024 16:50:34,Open Position,NSDQ100/USD," 99,99 ",0.102089," 0,00 "," 972,51 "," 872,52 ",2794179183,CFD," 0,00 "
19/08/2024 16:50:49,Position closed,NSDQ100/USD," 99,54 ",0.102089,"(0,45)"," 972,06 "," 972,06 ",2794179183,CFD," 0,00 "
19/08/2024 16:52:17,Open Position,NSDQ100/USD," 99,99 ",0.102062," 0,00 "," 972,06 "," 872,07 ",2794179984,CFD," 0,00 "
19/08/2024 16:52:41,Position closed,NSDQ100/USD," 99,06 ",0.102062,"(0,93)"," 971,13 "," 971,13 ",2794179984,CFD," 0,00 "
19/08/2024 17:38:03,Open Position,NSDQ100/USD," 99,99 ",0.101975," 0,00 "," 971,13 "," 871,14 ",2794207827,CFD," 0,00 "
19/08/2024 17:46:59,Position closed,NSDQ100/USD," 99,18 ",0.101975,"(0,81)"," 970,32 "," 970,32 ",2794207827,CFD," 0,00 "
19/08/2024 17:50:10,Open Position,AAPL/USD," 99,99 ",2.226413," 0,00 "," 970,32 "," 870,33 ",2794214243,CFD," 0,00 "
19/08/2024 17:52:57,Open Position,USD/JPY," 100,00 ",3000.000000," 0,00 "," 970,32 "," 770,33 ",2794215582,CFD," 0,00 "
19/08/2024 18:51:29,Position closed,AAPL/USD," 99,78 ",2.226413,"(0,21)"," 970,11 "," 870,11 ",2794214243,CFD," 0,00 "
19/08/2024 18:51:34,Position closed,USD/JPY," 100,39 ",3000.000000," 0,39 "," 970,50 "," 970,50 ",2794215582,CFD," 0,00 "
19/08/2024 19:05:16,Open Position,NSDQ100/USD," 49,99 ",0.050853," 0,00 "," 970,50 "," 920,51 ",2794258415,CFD," 0,00 "
19/08/2024 21:43:22,Open Position,USD/JPY," 49,99 ",1500.000000," 0,00 "," 970,50 "," 870,52 ",2794313237,CFD," 0,00 "
19/08/2024 22:00:23,Open Position,NSDQ100/USD," 99,98 ",0.101117," 0,00 "," 970,50 "," 770,54 ",2794313588,CFD," 0,00 "
19/08/2024 22:01:05,Open Position,XAU/USD," 70,00 ",0.559257," 0,00 "," 970,50 "," 700,54 ",2794313822,CFD," 0,00 "
20/08/2024 00:37:05,Dividend,NSDQ100/USD,"(0,01)",-,"(0,01)"," 970,49 "," 700,53 ",2794258415,CFD," 0,00 "
20/08/2024 00:48:39,Overnight refund,Daily," 0,01 ",-," 0,01 "," 970,50 "," 700,54 ",2794258415,CFD," 0,00 "
20/08/2024 05:50:03,Withdraw Fee,-,"(5,00)",-,"(5,00)"," 965,50 "," 695,54 ",-,-," 0,00 "
20/08/2024 05:50:03,Withdraw Request,-,"(65,00)",-,"(65,00)"," 900,50 "," 630,54 ",-,-," 0,00 "
20/08/2024 05:50:03,Withdrawal Conversion Fee,-,"(0,87)",-," 0,00 "," 900,50 "," 630,54 ",-,-," 0,00 "
20/08/2024 05:54:06,Deposit Conversion Fee,-," 0,00 ",-," 0,00 "," 963,62 "," 693,66 ",-,-," 0,00 "
20/08/2024 05:54:06,Deposit,57.00 EUR eToroMoney," 63,12 ",-," 63,12 "," 963,62 "," 693,66 ",-,-," 0,00 "
20/08/2024 06:02:33,Position closed,XAU/USD," 71,88 ",0.559257," 1,88 "," 965,50 "," 765,54 ",2794313822,CFD," 0,00 "
20/08/2024 06:16:15,Open Position,XAU/USD," 99,99 ",0.800611," 0,00 "," 965,50 "," 665,55 ",2794340361,CFD," 0,00 "
20/08/2024 06:16:55,Position closed,XAU/USD," 99,72 ",0.800611,"(0,27)"," 965,23 "," 765,27 ",2794340361,CFD," 0,00 "
20/08/2024 06:31:48,Open Position,NSDQ100/USD," 99,99 ",0.100993," 0,00 "," 965,23 "," 665,28 ",2794342253,CFD," 0,00 "
20/08/2024 07:10:20,Position closed,NSDQ100/USD," 98,95 ",0.100993,"(1,04)"," 964,19 "," 764,23 ",2794342253,CFD," 0,00 "
20/08/2024 07:30:34,Open Position,NSDQ100/USD," 299,99 ",0.302516," 0,00 "," 964,19 "," 464,24 ",2794379224,CFD," 0,00 "
20/08/2024 07:41:20,Open Position,NSDQ100/USD," 99,99 ",0.100884," 0,00 "," 964,19 "," 364,25 ",2794381981,CFD," 0,00 "
20/08/2024 07:42:14,Position closed,NSDQ100/USD," 295,46 ",0.302516,"(4,53)"," 959,66 "," 659,71 ",2794379224,CFD," 0,00 "
20/08/2024 07:42:27,Position closed,NSDQ100/USD," 99,39 ",0.100884,"(0,60)"," 959,06 "," 759,10 ",2794381981,CFD," 0,00 "
20/08/2024 07:45:51,Open Position,NSDQ100/USD," 50,00 ",0.050436," 0,00 "," 959,06 "," 709,10 ",2794387514,CFD," 0,00 "
20/08/2024 08:14:53,Position closed,NSDQ100/USD," 48,92 ",0.050436,"(1,08)"," 957,98 "," 758,02 ",2794387514,CFD," 0,00 "
20/08/2024 08:15:53,Open Position,NSDQ100/USD," 50,00 ",0.050474," 0,00 "," 957,98 "," 708,02 ",2794396337,CFD," 0,00 "
20/08/2024 08:24:42,Position closed,USD/JPY," 51,31 ",1500.000000," 1,32 "," 959,30 "," 759,33 ",2794313237,CFD," 0,00 "
20/08/2024 08:25:27,Open Position,NSDQ100/USD," 99,99 ",0.101034," 0,00 "," 959,30 "," 659,34 ",2794398717,CFD," 0,00 "
20/08/2024 08:41:26,Position closed,NSDQ100/USD," 101,34 ",0.101117," 1,36 "," 960,66 "," 760,68 ",2794313588,CFD," 0,00 "
20/08/2024 08:41:37,Open Position,NSDQ100/USD," 99,99 ",0.101179," 0,00 "," 960,66 "," 660,69 ",2794406301,CFD," 0,00 "
20/08/2024 08:42:02,Open Position,NSDQ100/USD," 99,99 ",0.101185," 0,00 "," 960,66 "," 560,70 ",2794406393,CFD," 0,00 "
20/08/2024 09:17:49,Open Position,NSDQ100/USD," 149,99 ",0.151464," 0,00 "," 960,66 "," 410,71 ",2794413633,CFD," 0,00 "
20/08/2024 09:26:28,Open Position,NSDQ100/USD," 109,99 ",0.111097," 0,00 "," 960,66 "," 300,72 ",2794415288,CFD," 0,00 "
20/08/2024 09:33:12,Open Position,NSDQ100/USD," 50,00 ",0.050510," 0,00 "," 960,66 "," 250,72 ",2794420255,CFD," 0,00 "
20/08/2024 09:36:47,Open Position,NSDQ100/USD," 70,00 ",0.070681," 0,00 "," 960,66 "," 180,72 ",2794420907,CFD," 0,00 "
20/08/2024 10:55:32,Position closed,NSDQ100/USD," 43,61 ",0.050853,"(6,38)"," 954,28 "," 224,33 ",2794258415,CFD," 0,00 "
20/08/2024 11:35:45,Open Position,NSDQ100/USD," 60,00 ",0.060679," 0,00 "," 954,28 "," 164,33 ",2794508906,CFD," 0,00 "
20/08/2024 12:39:29,Open Position,NSDQ100/USD," 50,00 ",0.050589," 0,00 "," 954,28 "," 114,33 ",2794531890,CFD," 0,00 "
20/08/2024 12:44:38,Open Position,NSDQ100/USD," 50,00 ",0.050601," 0,00 "," 954,28 "," 64,33 ",2794532788,CFD," 0,00 "
20/08/2024 12:57:01,Open Position,NSDQ100/USD," 50,00 ",0.050618," 0,00 "," 954,28 "," 14,33 ",2794535587,CFD," 0,00 "
20/08/2024 13:49:50,Position closed,NSDQ100/USD," 49,06 ",0.050474,"(0,94)"," 953,34 "," 63,39 ",2794396337,CFD," 0,00 "
20/08/2024 13:49:50,Position closed,NSDQ100/USD," 102,88 ",0.101185," 2,89 "," 956,23 "," 166,27 ",2794406393,CFD," 0,00 "
20/08/2024 13:49:50,Position closed,NSDQ100/USD," 99,89 ",0.101034,"(0,10)"," 956,13 "," 266,16 ",2794398717,CFD," 0,00 "
20/08/2024 13:49:50,Position closed,NSDQ100/USD," 102,76 ",0.101179," 2,77 "," 958,90 "," 368,92 ",2794406301,CFD," 0,00 "
20/08/2024 13:49:50,Position closed,NSDQ100/USD," 109,08 ",0.111097,"(0,91)"," 957,99 "," 478,00 ",2794415288,CFD," 0,00 "
20/08/2024 13:49:50,Position closed,NSDQ100/USD," 148,31 ",0.151464,"(1,68)"," 956,31 "," 626,31 ",2794413633,CFD," 0,00 "
20/08/2024 13:49:50,Position closed,NSDQ100/USD," 49,82 ",0.050510,"(0,18)"," 956,13 "," 676,13 ",2794420255,CFD," 0,00 "
20/08/2024 13:49:50,Position closed,NSDQ100/USD," 69,09 ",0.070681,"(0,91)"," 955,22 "," 745,22 ",2794420907,CFD," 0,00 "
20/08/2024 13:49:50,Position closed,NSDQ100/USD," 51,96 ",0.050618," 1,96 "," 957,18 "," 797,18 ",2794535587,CFD," 0,00 "
20/08/2024 13:49:50,Position closed,NSDQ100/USD," 61,10 ",0.060679," 1,10 "," 958,28 "," 858,28 ",2794508906,CFD," 0,00 "
20/08/2024 13:49:50,Position closed,NSDQ100/USD," 51,37 ",0.050589," 1,37 "," 959,65 "," 909,65 ",2794531890,CFD," 0,00 "
20/08/2024 13:49:50,Position closed,NSDQ100/USD," 51,62 ",0.050601," 1,62 "," 961,27 "," 961,27 ",2794532788,CFD," 0,00 "
20/08/2024 13:50:40,Open Position,NSDQ100/USD," 99,98 ",0.101003," 0,00 "," 961,27 "," 861,29 ",2794672319,CFD," 0,00 "
20/08/2024 13:51:06,Open Position,NSDQ100/USD," 500,00 ",0.505175," 0,00 "," 961,27 "," 361,29 ",2794687379,CFD," 0,00 "
20/08/2024 13:51:46,Open Position,NSDQ100/USD," 99,99 ",0.101073," 0,00 "," 961,27 "," 261,30 ",2794700800,CFD," 0,00 "
20/08/2024 13:52:09,Open Position,NSDQ100/USD," 99,99 ",0.101031," 0,00 "," 961,27 "," 161,31 ",2794709268,CFD," 0,00 "
20/08/2024 14:01:10,Position closed,NSDQ100/USD," 509,23 ",0.505175," 9,23 "," 970,50 "," 670,54 ",2794687379,CFD," 0,00 "
20/08/2024 14:01:10,Position closed,NSDQ100/USD," 102,60 ",0.101073," 2,61 "," 973,11 "," 773,14 ",2794700800,CFD," 0,00 "
20/08/2024 14:01:10,Position closed,NSDQ100/USD," 101,41 ",0.101003," 1,43 "," 974,54 "," 874,55 ",2794672319,CFD," 0,00 "
20/08/2024 14:01:10,Position closed,NSDQ100/USD," 101,77 ",0.101031," 1,78 "," 976,32 "," 976,32 ",2794709268,CFD," 0,00 "
20/08/2024 14:02:06,Open Position,NSDQ100/USD," 99,99 ",0.101007," 0,00 "," 976,32 "," 876,33 ",2794731835,CFD," 0,00 "
20/08/2024 14:02:10,Open Position,NSDQ100/USD," 220,00 ",0.222185," 0,00 "," 976,32 "," 656,33 ",2794731910,CFD," 0,00 "
20/08/2024 14:02:19,Open Position,NSDQ100/USD," 170,00 ",0.171668," 0,00 "," 976,32 "," 486,33 ",2794732104,CFD," 0,00 "
20/08/2024 14:02:32,Open Position,NSDQ100/USD," 129,99 ",0.131314," 0,00 "," 976,32 "," 356,34 ",2794732293,CFD," 0,00 "
20/08/2024 14:02:41,Open Position,NSDQ100/USD," 89,99 ",0.090893," 0,00 "," 976,32 "," 266,35 ",2794732878,CFD," 0,00 "
20/08/2024 14:03:37,Open Position,NSDQ100/USD," 70,00 ",0.070679," 0,00 "," 976,32 "," 196,35 ",2794734813,CFD," 0,00 "
20/08/2024 14:04:55,Open Position,NSDQ100/USD," 50,00 ",0.050510," 0,00 "," 976,32 "," 146,35 ",2794736542,CFD," 0,00 "
20/08/2024 14:11:18,Open Position,NSDQ100/USD," 50,00 ",0.050508," 0,00 "," 976,32 "," 96,35 ",2794744905,CFD," 0,00 "
20/08/2024 14:12:20,Open Position,NSDQ100/USD," 70,00 ",0.070890," 0,00 "," 976,32 "," 26,35 ",2794748726,CFD," 0,00 "
21/08/2024 00:48:30,Overnight fee,Daily,"(1,17)",-,"(1,17)"," 975,15 "," 25,18 ",2794731910,CFD," 0,00 "
21/08/2024 00:48:30,Overnight fee,Daily,"(0,90)",-,"(0,90)"," 974,25 "," 24,28 ",2794732104,CFD," 0,00 "
21/08/2024 00:48:30,Overnight fee,Daily,"(0,37)",-,"(0,37)"," 973,88 "," 23,91 ",2794748726,CFD," 0,00 "
21/08/2024 00:48:30,Overnight fee,Daily,"(0,27)",-,"(0,27)"," 973,61 "," 23,64 ",2794744905,CFD," 0,00 "
21/08/2024 00:48:30,Overnight fee,Daily,"(0,48)",-,"(0,48)"," 973,13 "," 23,16 ",2794732878,CFD," 0,00 "
21/08/2024 00:48:30,Overnight fee,Daily,"(0,27)",-,"(0,27)"," 972,86 "," 22,89 ",2794736542,CFD," 0,00 "
21/08/2024 00:48:30,Overnight fee,Daily,"(0,69)",-,"(0,69)"," 972,17 "," 22,20 ",2794732293,CFD," 0,00 "
21/08/2024 00:48:30,Overnight fee,Daily,"(0,53)",-,"(0,53)"," 971,64 "," 21,67 ",2794731835,CFD," 0,00 "
21/08/2024 00:48:30,Overnight fee,Daily,"(0,37)",-,"(0,37)"," 971,27 "," 21,30 ",2794734813,CFD," 0,00 "
21/08/2024 14:36:47,Position closed,NSDQ100/USD," 134,58 ",0.131314," 4,59 "," 975,86 "," 155,88 ",2794732293,CFD," 0,00 "
21/08/2024 14:36:47,Position closed,NSDQ100/USD," 103,44 ",0.101007," 3,45 "," 979,31 "," 259,32 ",2794731835,CFD," 0,00 "
21/08/2024 14:36:47,Position closed,NSDQ100/USD," 51,82 ",0.050508," 1,82 "," 981,13 "," 311,14 ",2794744905,CFD," 0,00 "
21/08/2024 14:36:47,Position closed,NSDQ100/USD," 226,98 ",0.222185," 6,98 "," 988,11 "," 538,12 ",2794731910,CFD," 0,00 "
21/08/2024 14:36:47,Position closed,NSDQ100/USD," 92,82 ",0.090893," 2,83 "," 990,94 "," 630,94 ",2794732878,CFD," 0,00 "
21/08/2024 14:36:47,Position closed,NSDQ100/USD," 71,90 ",0.070679," 1,90 "," 992,84 "," 702,84 ",2794734813,CFD," 0,00 "
21/08/2024 14:36:47,Position closed,NSDQ100/USD," 76,09 ",0.070890," 6,09 "," 998,93 "," 778,93 ",2794748726,CFD," 0,00 "
21/08/2024 14:36:47,Position closed,NSDQ100/USD," 174,99 ",0.171668," 4,99 "," 1.003,92 "," 953,92 ",2794732104,CFD," 0,00 "
21/08/2024 14:36:47,Position closed,NSDQ100/USD," 51,86 ",0.050510," 1,86 "," 1.005,78 "," 1.005,78 ",2794736542,CFD," 0,00 "
21/08/2024 14:41:46,Open Position,NSDQ100/USD," 109,98 ",0.110652," 0,00 "," 1.005,78 "," 895,80 ",2795468675,CFD," 0,00 "
21/08/2024 14:42:22,Position closed,NSDQ100/USD," 110,68 ",0.110652," 0,70 "," 1.006,48 "," 1.006,48 ",2795468675,CFD," 0,00 "
21/08/2024 14:43:18,Open Position,NSDQ100/USD," 700,00 ",0.703593," 0,00 "," 1.006,48 "," 306,48 ",2795470909,CFD," 0,00 "
21/08/2024 14:46:23,Position closed,NSDQ100/USD," 694,67 ",0.703593,"(5,33)"," 1.001,15 "," 1.001,15 ",2795470909,CFD," 0,00 "
21/08/2024 14:48:29,Open Position,NSDQ100/USD," 109,99 ",0.110891," 0,00 "," 1.001,15 "," 891,16 ",2795477239,CFD," 0,00 "
21/08/2024 14:48:42,Open Position,NSDQ100/USD," 230,00 ",0.231869," 0,00 "," 1.001,15 "," 661,16 ",2795477441,CFD," 0,00 "
21/08/2024 14:49:00,Open Position,NSDQ100/USD," 99,99 ",0.100804," 0,00 "," 1.001,15 "," 561,17 ",2795477966,CFD," 0,00 "
21/08/2024 14:49:22,Open Position,NSDQ100/USD," 99,99 ",0.100843," 0,00 "," 1.001,15 "," 461,18 ",2795478628,CFD," 0,00 "
21/08/2024 14:49:50,Open Position,NSDQ100/USD," 119,99 ",0.121036," 0,00 "," 1.001,15 "," 341,19 ",2795479235,CFD," 0,00 "
21/08/2024 14:50:13,Open Position,NSDQ100/USD," 89,98 ",0.090904," 0,00 "," 1.001,15 "," 251,21 ",2795482141,CFD," 0,00 "
21/08/2024 14:50:28,Open Position,NSDQ100/USD," 70,00 ",0.070724," 0,00 "," 1.001,15 "," 181,21 ",2795483009,CFD," 0,00 "
21/08/2024 14:50:37,Open Position,NSDQ100/USD," 50,00 ",0.050500," 0,00 "," 1.001,15 "," 131,21 ",2795483171,CFD," 0,00 "
21/08/2024 14:50:41,Open Position,NSDQ100/USD," 50,00 ",0.050506," 0,00 "," 1.001,15 "," 81,21 ",2795483222,CFD," 0,00 "
21/08/2024 14:51:07,Open Position,NSDQ100/USD," 79,99 ",0.080876," 0,00 "," 1.001,15 "," 1,22 ",2795483823,CFD," 0,00 "
21/08/2024 18:29:09,Position closed,NSDQ100/USD," 230,24 ",0.231869," 0,24 "," 1.001,39 "," 231,46 ",2795477441,CFD," 0,00 "
21/08/2024 18:29:09,Position closed,NSDQ100/USD," 99,93 ",0.100804,"(0,06)"," 1.001,33 "," 331,39 ",2795477966,CFD," 0,00 "
21/08/2024 18:29:09,Position closed,NSDQ100/USD," 93,70 ",0.090904," 3,72 "," 1.005,05 "," 425,09 ",2795482141,CFD," 0,00 "
21/08/2024 18:29:09,Position closed,NSDQ100/USD," 110,06 ",0.110891," 0,07 "," 1.005,12 "," 535,15 ",2795477239,CFD," 0,00 "
21/08/2024 18:29:09,Position closed,NSDQ100/USD," 100,71 ",0.100843," 0,72 "," 1.005,84 "," 635,86 ",2795478628,CFD," 0,00 "
21/08/2024 18:29:09,Position closed,NSDQ100/USD," 51,88 ",0.050500," 1,88 "," 1.007,72 "," 687,74 ",2795483171,CFD," 0,00 "
21/08/2024 18:29:09,Position closed,NSDQ100/USD," 73,16 ",0.070724," 3,16 "," 1.010,88 "," 760,90 ",2795483009,CFD," 0,00 "
21/08/2024 18:29:09,Position closed,NSDQ100/USD," 121,33 ",0.121036," 1,34 "," 1.012,22 "," 882,23 ",2795479235,CFD," 0,00 "
21/08/2024 18:29:09,Position closed,NSDQ100/USD," 84,63 ",0.080876," 4,64 "," 1.016,86 "," 966,86 ",2795483823,CFD," 0,00 "
21/08/2024 18:29:09,Position closed,NSDQ100/USD," 52,02 ",0.050506," 2,02 "," 1.018,88 "," 1.018,88 ",2795483222,CFD," 0,00 "
21/08/2024 18:39:05,Open Position,NSDQ100/USD," 109,99 ",0.111029," 0,00 "," 1.018,88 "," 908,89 ",2795650721,CFD," 0,00 "
21/08/2024 18:39:52,Open Position,NSDQ100/USD," 99,99 ",0.100911," 0,00 "," 1.018,88 "," 808,90 ",2795651255,CFD," 0,00 "
21/08/2024 18:47:58,Open Position,NSDQ100/USD," 50,00 ",0.050470," 0,00 "," 1.018,88 "," 758,90 ",2795655257,CFD," 0,00 "
21/08/2024 18:52:35,Position closed,NSDQ100/USD," 50,69 ",0.050470," 0,69 "," 1.019,57 "," 809,59 ",2795655257,CFD," 0,00 "
21/08/2024 18:52:35,Position closed,NSDQ100/USD," 111,44 ",0.111029," 1,45 "," 1.021,02 "," 921,03 ",2795650721,CFD," 0,00 "
21/08/2024 18:52:35,Position closed,NSDQ100/USD," 100,82 ",0.100911," 0,83 "," 1.021,85 "," 1.021,85 ",2795651255,CFD," 0,00 "
21/08/2024 19:12:43,Open Position,NSDQ100/USD," 200,00 ",0.202151," 0,00 "," 1.021,85 "," 821,85 ",2795673984,CFD," 0,00 "
21/08/2024 19:20:27,Open Position,NSDQ100/USD," 50,00 ",0.050605," 0,00 "," 1.021,85 "," 771,85 ",2795677309,CFD," 0,00 "
21/08/2024 19:20:40,Open Position,NSDQ100/USD," 50,00 ",0.050600," 0,00 "," 1.021,85 "," 721,85 ",2795677377,CFD," 0,00 "
21/08/2024 19:20:53,Open Position,NSDQ100/USD," 99,99 ",0.101196," 0,00 "," 1.021,85 "," 621,86 ",2795677444,CFD," 0,00 "
21/08/2024 19:21:16,Open Position,NSDQ100/USD," 159,99 ",0.161900," 0,00 "," 1.021,85 "," 461,87 ",2795677662,CFD," 0,00 "
21/08/2024 19:24:15,Open Position,NSDQ100/USD," 50,00 ",0.050613," 0,00 "," 1.021,85 "," 411,87 ",2795678558,CFD," 0,00 "
21/08/2024 19:31:57,Position closed,NSDQ100/USD," 199,58 ",0.202151,"(0,42)"," 1.021,43 "," 611,45 ",2795673984,CFD," 0,00 "
21/08/2024 19:31:57,Position closed,NSDQ100/USD," 102,17 ",0.101196," 2,18 "," 1.023,61 "," 713,62 ",2795677444,CFD," 0,00 "
21/08/2024 19:31:57,Position closed,NSDQ100/USD," 51,23 ",0.050605," 1,23 "," 1.024,84 "," 764,85 ",2795677309,CFD," 0,00 "
21/08/2024 19:31:57,Position closed,NSDQ100/USD," 51,13 ",0.050600," 1,13 "," 1.025,97 "," 815,98 ",2795677377,CFD," 0,00 "
21/08/2024 19:31:57,Position closed,NSDQ100/USD," 51,38 ",0.050613," 1,38 "," 1.027,35 "," 867,36 ",2795678558,CFD," 0,00 "
21/08/2024 19:31:57,Position closed,NSDQ100/USD," 163,20 ",0.161900," 3,21 "," 1.030,56 "," 1.030,56 ",2795677662,CFD," 0,00 "
21/08/2024 19:33:56,Open Position,USD/JPY," 300,00 ",9000.000000," 0,00 "," 1.030,56 "," 730,56 ",2795682155,CFD," 0,00 "
21/08/2024 19:43:57,Open Position,USD/JPY," 50,00 ",1500.000000," 0,00 "," 1.030,56 "," 680,56 ",2795686729,CFD," 0,00 "
21/08/2024 19:55:39,Position closed,USD/JPY," 302,67 ",9000.000000," 2,67 "," 1.033,23 "," 983,23 ",2795682155,CFD," 0,00 "
21/08/2024 19:55:39,Position closed,USD/JPY," 50,55 ",1500.000000," 0,55 "," 1.033,78 "," 1.033,78 ",2795686729,CFD," 0,00 "
21/08/2024 19:59:59,Open Position,USD/JPY," 100,00 ",3000.000000," 0,00 "," 1.033,78 "," 933,78 ",2795701717,CFD," 0,00 "
22/08/2024 00:48:47,Weekend refund,Weekend Fee," 0,97 ",-," 0,97 "," 1.034,75 "," 934,75 ",2795701717,CFD," 0,00 "
22/08/2024 01:13:00,Position closed,USD/JPY," 108,89 ",3000.000000," 8,89 "," 1.043,64 "," 1.043,64 ",2795701717,CFD," 0,00 "
22/08/2024 01:15:28,Open Position,NSDQ100/USD," 49,99 ",0.050392," 0,00 "," 1.043,64 "," 993,65 ",2795726669,CFD," 0,00 "
22/08/2024 01:15:48,Open Position,NSDQ100/USD," 49,99 ",0.050391," 0,00 "," 1.043,64 "," 943,66 ",2795726675,CFD," 0,00 "
22/08/2024 06:47:06,Open Position,NSDQ100/USD," 99,99 ",0.100895," 0,00 "," 1.043,64 "," 843,67 ",2795744646,CFD," 0,00 "
22/08/2024 06:52:06,Position closed,NSDQ100/USD," 50,58 ",0.050392," 0,59 "," 1.044,23 "," 894,25 ",2795726669,CFD," 0,00 "
22/08/2024 06:52:06,Position closed,NSDQ100/USD," 98,96 ",0.100895,"(1,03)"," 1.043,20 "," 993,21 ",2795744646,CFD," 0,00 "
22/08/2024 06:52:06,Position closed,NSDQ100/USD," 50,59 ",0.050391," 0,60 "," 1.043,80 "," 1.043,80 ",2795726675,CFD," 0,00 "
22/08/2024 07:12:11,Open Position,NSDQ100/USD," 110,00 ",0.110936," 0,00 "," 1.043,80 "," 933,80 ",2795762489,CFD," 0,00 "
22/08/2024 08:10:58,Open Position,NSDQ100/USD," 100,00 ",0.100923," 0,00 "," 1.043,80 "," 833,80 ",2795791381,CFD," 0,00 "
22/08/2024 08:11:13,Open Position,NSDQ100/USD," 50,00 ",0.050459," 0,00 "," 1.043,80 "," 783,80 ",2795791400,CFD," 0,00 "
22/08/2024 08:15:03,Open Position,NSDQ100/USD," 199,99 ",0.201780," 0,00 "," 1.043,80 "," 583,81 ",2795791976,CFD," 0,00 "
22/08/2024 08:19:42,Open Position,NSDQ100/USD," 50,00 ",0.050431," 0,00 "," 1.043,80 "," 533,81 ",2795792679,CFD," 0,00 "
22/08/2024 08:31:31,Position closed,NSDQ100/USD," 110,00 ",0.110936," 0,00 "," 1.043,80 "," 643,81 ",2795762489,CFD," 0,00 "
22/08/2024 08:31:31,Position closed,NSDQ100/USD," 50,68 ",0.050459," 0,68 "," 1.044,48 "," 694,49 ",2795791400,CFD," 0,00 "
22/08/2024 08:31:31,Position closed,NSDQ100/USD," 101,44 ",0.100923," 1,44 "," 1.045,92 "," 795,93 ",2795791381,CFD," 0,00 "
22/08/2024 08:31:31,Position closed,NSDQ100/USD," 50,12 ",0.050431," 0,12 "," 1.046,04 "," 846,05 ",2795792679,CFD," 0,00 "
22/08/2024 08:31:31,Position closed,NSDQ100/USD," 201,55 ",0.201780," 1,56 "," 1.047,60 "," 1.047,60 ",2795791976,CFD," 0,00 "
22/08/2024 08:32:31,Open Position,NSDQ100/USD," 50,00 ",0.050415," 0,00 "," 1.047,60 "," 997,60 ",2795798747,CFD," 0,00 "
22/08/2024 08:32:42,Open Position,NSDQ100/USD," 50,00 ",0.050416," 0,00 "," 1.047,60 "," 947,60 ",2795798770,CFD," 0,00 "
22/08/2024 08:33:02,Open Position,NSDQ100/USD," 50,00 ",0.050412," 0,00 "," 1.047,60 "," 897,60 ",2795798804,CFD," 0,00 "
22/08/2024 09:27:01,Open Position,NSDQ100/USD," 50,00 ",0.050395," 0,00 "," 1.047,60 "," 847,60 ",2795806477,CFD," 0,00 "
22/08/2024 09:38:29,Open Position,NSDQ100/USD," 149,99 ",0.151267," 0,00 "," 1.047,60 "," 697,61 ",2795808227,CFD," 0,00 "
22/08/2024 09:39:44,Open Position,XAU/USD," 99,99 ",0.797887," 0,00 "," 1.047,60 "," 597,62 ",2795808410,CFD," 0,00 "
22/08/2024 10:18:54,Position closed,NSDQ100/USD," 50,42 ",0.050395," 0,42 "," 1.048,02 "," 648,04 ",2795806477,CFD," 0,00 "
22/08/2024 10:18:54,Position closed,NSDQ100/USD," 50,84 ",0.050416," 0,84 "," 1.048,86 "," 698,88 ",2795798770,CFD," 0,00 "
22/08/2024 10:18:54,Position closed,NSDQ100/USD," 50,77 ",0.050412," 0,77 "," 1.049,63 "," 749,65 ",2795798804,CFD," 0,00 "
22/08/2024 10:18:54,Position closed,NSDQ100/USD," 50,81 ",0.050415," 0,81 "," 1.050,44 "," 800,46 ",2795798747,CFD," 0,00 "
22/08/2024 10:18:54,Position closed,NSDQ100/USD," 152,85 ",0.151267," 2,86 "," 1.053,30 "," 953,31 ",2795808227,CFD," 0,00 "
22/08/2024 10:20:51,Open Position,NSDQ100/USD," 50,00 ",0.050368," 0,00 "," 1.053,30 "," 903,31 ",2795814290,CFD," 0,00 "
22/08/2024 10:36:04,Open Position,NSDQ100/USD," 50,00 ",0.050339," 0,00 "," 1.053,30 "," 853,31 ",2795816449,CFD," 0,00 "
22/08/2024 10:58:06,Position closed,NSDQ100/USD," 50,26 ",0.050339," 0,26 "," 1.053,56 "," 903,57 ",2795816449,CFD," 0,00 "
22/08/2024 10:58:06,Position closed,NSDQ100/USD," 50,84 ",0.050368," 0,84 "," 1.054,40 "," 954,41 ",2795814290,CFD," 0,00 "
22/08/2024 10:58:34,Position closed,XAU/USD," 99,71 ",0.797887,"(0,28)"," 1.054,12 "," 1.054,12 ",2795808410,CFD," 0,00 "
22/08/2024 11:03:55,Open Position,NSDQ100/USD," 49,99 ",0.050312," 0,00 "," 1.054,12 "," 1.004,13 ",2795821678,CFD," 0,00 "
22/08/2024 11:13:18,Position closed,NSDQ100/USD," 49,45 ",0.050312,"(0,54)"," 1.053,58 "," 1.053,58 ",2795821678,CFD," 0,00 "
22/08/2024 11:14:02,Open Position,NSDQ100/USD," 50,00 ",0.050279," 0,00 "," 1.053,58 "," 1.003,58 ",2795823261,CFD," 0,00 "
22/08/2024 11:21:15,Open Position,NSDQ100/USD," 129,99 ",0.130636," 0,00 "," 1.053,58 "," 873,59 ",2795824327,CFD," 0,00 "
22/08/2024 11:21:33,Position closed,NSDQ100/USD," 129,05 ",0.130636,"(0,94)"," 1.052,64 "," 1.002,64 ",2795824327,CFD," 0,00 "
22/08/2024 11:26:30,Position closed,NSDQ100/USD," 50,21 ",0.050279," 0,21 "," 1.052,85 "," 1.052,85 ",2795823261,CFD," 0,00 "
22/08/2024 11:37:31,Open Position,NSDQ100/USD," 50,00 ",0.050303," 0,00 "," 1.052,85 "," 1.002,85 ",2795828097,CFD," 0,00 "
22/08/2024 12:06:14,Position closed,NSDQ100/USD," 51,26 ",0.050303," 1,26 "," 1.054,11 "," 1.054,11 ",2795828097,CFD," 0,00 "
22/08/2024 12:06:46,Open Position,XAU/USD," 349,99 ",2.800201," 0,00 "," 1.054,11 "," 704,12 ",2795834026,CFD," 0,00 "
22/08/2024 12:07:00,Open Position,XAU/USD," 50,00 ",0.400011," 0,00 "," 1.054,11 "," 654,12 ",2795834070,CFD," 0,00 "
22/08/2024 12:07:46,Open Position,NSDQ100/USD," 50,00 ",0.050233," 0,00 "," 1.054,11 "," 604,12 ",2795834169,CFD," 0,00 "
22/08/2024 12:10:34,Position closed,NSDQ100/USD," 49,32 ",0.050233,"(0,68)"," 1.053,43 "," 653,44 ",2795834169,CFD," 0,00 "
22/08/2024 12:11:47,Open Position,NSDQ100/USD," 50,00 ",0.050256," 0,00 "," 1.053,43 "," 603,44 ",2795835218,CFD," 0,00 "
22/08/2024 12:22:30,Open Position,NSDQ100/USD," 100,00 ",0.100608," 0,00 "," 1.053,43 "," 503,44 ",2795837170,CFD," 0,00 "
22/08/2024 12:22:55,Open Position,NSDQ100/USD," 129,99 ",0.130783," 0,00 "," 1.053,43 "," 373,45 ",2795837208,CFD," 0,00 "
22/08/2024 12:29:01,Open Position,NSDQ100/USD," 100,00 ",0.100601," 0,00 "," 1.053,43 "," 273,45 ",2795842245,CFD," 0,00 "
22/08/2024 12:34:03,Open Position,NSDQ100/USD," 70,00 ",0.070436," 0,00 "," 1.053,43 "," 203,45 ",2795862180,CFD," 0,00 "
22/08/2024 12:37:52,Open Position,NSDQ100/USD," 60,00 ",0.060409," 0,00 "," 1.053,43 "," 143,45 ",2795863160,CFD," 0,00 "
22/08/2024 12:38:04,Open Position,NSDQ100/USD," 50,00 ",0.050344," 0,00 "," 1.053,43 "," 93,45 ",2795863242,CFD," 0,00 "
22/08/2024 12:40:04,Position closed,XAU/USD," 51,13 ",0.400011," 1,13 "," 1.054,56 "," 144,58 ",2795834070,CFD," 0,00 "
22/08/2024 12:40:04,Position closed,XAU/USD," 358,22 ",2.800201," 8,23 "," 1.062,79 "," 502,80 ",2795834026,CFD," 0,00 "
22/08/2024 12:40:33,Open Position,NSDQ100/USD," 129,99 ",0.130839," 0,00 "," 1.062,79 "," 372,81 ",2795867464,CFD," 0,00 "
22/08/2024 12:52:39,Open Position,XAU/USD," 199,99 ",1.599405," 0,00 "," 1.062,79 "," 172,82 ",2795869685,CFD," 0,00 "
22/08/2024 12:54:26,Position closed,XAU/USD," 201,86 ",1.599405," 1,87 "," 1.064,66 "," 374,68 ",2795869685,CFD," 0,00 "
22/08/2024 12:57:04,Position closed,NSDQ100/USD," 49,70 ",0.050256,"(0,30)"," 1.064,36 "," 424,38 ",2795835218,CFD," 0,00 "
22/08/2024 12:57:04,Position closed,NSDQ100/USD," 131,52 ",0.130783," 1,53 "," 1.065,89 "," 555,90 ",2795837208,CFD," 0,00 "
22/08/2024 12:57:04,Position closed,NSDQ100/USD," 71,11 ",0.070436," 1,11 "," 1.067,00 "," 627,01 ",2795862180,CFD," 0,00 "
22/08/2024 12:57:04,Position closed,NSDQ100/USD," 101,30 ",0.100608," 1,30 "," 1.068,30 "," 728,31 ",2795837170,CFD," 0,00 "
22/08/2024 12:57:04,Position closed,NSDQ100/USD," 101,15 ",0.100601," 1,15 "," 1.069,45 "," 829,46 ",2795842245,CFD," 0,00 "
22/08/2024 12:57:04,Position closed,NSDQ100/USD," 51,45 ",0.050344," 1,45 "," 1.070,90 "," 880,91 ",2795863242,CFD," 0,00 "
22/08/2024 12:57:04,Position closed,NSDQ100/USD," 61,66 ",0.060409," 1,66 "," 1.072,56 "," 942,57 ",2795863160,CFD," 0,00 "
22/08/2024 12:57:04,Position closed,NSDQ100/USD," 132,64 ",0.130839," 2,65 "," 1.075,21 "," 1.075,21 ",2795867464,CFD," 0,00 "
22/08/2024 12:59:24,Open Position,NSDQ100/USD," 50,00 ",0.050254," 0,00 "," 1.075,21 "," 1.025,21 ",2795871291,CFD," 0,00 "
22/08/2024 12:59:55,Open Position,XAU/USD," 50,00 ",0.399833," 0,00 "," 1.075,21 "," 975,21 ",2795871370,CFD," 0,00 "
22/08/2024 13:00:02,Open Position,XAU/USD," 99,99 ",0.799664," 0,00 "," 1.075,21 "," 875,22 ",2795871386,CFD," 0,00 "
22/08/2024 13:02:16,Open Position,NSDQ100/USD," 50,00 ",0.050240," 0,00 "," 1.075,21 "," 825,22 ",2795872026,CFD," 0,00 "
22/08/2024 13:05:11,Open Position,NSDQ100/USD," 50,00 ",0.050234," 0,00 "," 1.075,21 "," 775,22 ",2795872673,CFD," 0,00 "
22/08/2024 13:05:29,Position closed,NSDQ100/USD," 49,69 ",0.050234,"(0,31)"," 1.074,90 "," 824,91 ",2795872673,CFD," 0,00 "
22/08/2024 13:10:25,Position closed,NSDQ100/USD," 49,50 ",0.050240,"(0,50)"," 1.074,40 "," 874,41 ",2795872026,CFD," 0,00 "
22/08/2024 13:10:25,Position closed,NSDQ100/USD," 49,76 ",0.050254,"(0,24)"," 1.074,16 "," 924,17 ",2795871291,CFD," 0,00 "
22/08/2024 13:13:36,Open Position,NSDQ100/USD," 50,00 ",0.050234," 0,00 "," 1.074,16 "," 874,17 ",2795874859,CFD," 0,00 "
22/08/2024 13:16:36,Open Position,NSDQ100/USD," 50,00 ",0.050226," 0,00 "," 1.074,16 "," 824,17 ",2795875626,CFD," 0,00 "
22/08/2024 13:16:46,Open Position,NSDQ100/USD," 100,00 ",0.100453," 0,00 "," 1.074,16 "," 724,17 ",2795875655,CFD," 0,00 "
22/08/2024 13:21:04,Open Position,NSDQ100/USD," 50,00 ",0.050214," 0,00 "," 1.074,16 "," 674,17 ",2795877011,CFD," 0,00 "
22/08/2024 13:21:45,Open Position,XAU/USD," 400,00 ",3.208869," 0,00 "," 1.074,16 "," 274,17 ",2795877331,CFD," 0,00 "
22/08/2024 13:22:45,Position closed,NSDQ100/USD," 100,47 ",0.100453," 0,47 "," 1.074,63 "," 374,64 ",2795875655,CFD," 0,00 "
22/08/2024 13:22:45,Position closed,NSDQ100/USD," 50,40 ",0.050234," 0,40 "," 1.075,03 "," 425,04 ",2795874859,CFD," 0,00 "
22/08/2024 13:22:45,Position closed,NSDQ100/USD," 50,23 ",0.050226," 0,23 "," 1.075,26 "," 475,27 ",2795875626,CFD," 0,00 "
22/08/2024 13:22:45,Position closed,NSDQ100/USD," 50,00 ",0.050214," 0,00 "," 1.075,26 "," 525,27 ",2795877011,CFD," 0,00 "
22/08/2024 13:31:52,Open Position,NSDQ100/USD," 55,00 ",0.050210," 0,00 "," 1.075,26 "," 475,27 ",2795937480,CFD," 0,00 "
22/08/2024 13:44:38,Open Position,NSDQ100/USD," 55,00 ",0.050254," 0,00 "," 1.075,26 "," 425,27 ",2795961586,CFD," 0,00 "
22/08/2024 13:45:52,Open Position,XAU/USD," 50,00 ",0.402375," 0,00 "," 1.075,26 "," 375,27 ",2795963322,CFD," 0,00 "
22/08/2024 13:46:33,Open Position,XAU/USD," 49,99 ",0.402477," 0,00 "," 1.075,26 "," 325,28 ",2795964754,CFD," 0,00 "
22/08/2024 13:47:00,Open Position,NSDQ100/USD," 54,99 ",0.050283," 0,00 "," 1.075,26 "," 275,29 ",2795965514,CFD," 0,00 "
22/08/2024 13:48:23,Open Position,XAU/USD," 69,98 ",0.562858," 0,00 "," 1.075,26 "," 205,31 ",2795967754,CFD," 0,00 "
22/08/2024 13:51:39,Open Position,NSDQ100/USD," 67,00 ",0.060383," 0,00 "," 1.075,26 "," 145,31 ",2796013135,CFD," 0,00 "
22/08/2024 13:51:57,Open Position,XAU/USD," 50,00 ",0.401725," 0,00 "," 1.075,26 "," 95,31 ",2796013442,CFD," 0,00 "
22/08/2024 14:10:29,Open Position,NSDQ100/USD," 89,99 ",0.090814," 0,00 "," 1.075,26 "," 5,32 ",2796135242,CFD," 0,00 "
22/08/2024 15:28:13,Deposit Conversion Fee,-," 0,00 ",-," 0,00 "," 1.275,26 "," 205,32 ",-,-," 0,00 "
22/08/2024 15:28:13,Deposit,200.00 USD CreditCard," 200,00 ",-," 200,00 "," 1.275,26 "," 205,32 ",-,-," 0,00 "
22/08/2024 15:28:30,Open Position,NSDQ100/USD," 200,00 ",0.202633," 0,00 "," 1.275,26 "," 5,32 ",2796294062,CFD," 0,00 "
22/08/2024 19:26:05,Position closed,XAU/USD," 47,93 ",0.402477,"(2,06)"," 1.273,20 "," 53,25 ",2795964754,CFD," 0,00 "
22/08/2024 19:26:33,Edit Stop Loss,-,"(5,00)",-," 0,00 "," 1.273,20 "," 48,25 ",2795937480,-," 0,00 "
22/08/2024 19:26:43,Edit Stop Loss,-,"(5,00)",-," 0,00 "," 1.273,20 "," 43,25 ",2795961586,-," 0,00 "
22/08/2024 19:26:56,Edit Stop Loss,-,"(5,00)",-," 0,00 "," 1.273,20 "," 38,25 ",2795965514,-," 0,00 "
22/08/2024 19:27:08,Edit Stop Loss,-,"(7,00)",-," 0,00 "," 1.273,20 "," 31,25 ",2796013135,-," 0,00 "
23/08/2024 00:48:42,Overnight fee,Daily,"(0,51)",-,"(0,51)"," 1.272,69 "," 30,74 ",2795871386,CFD," 0,00 "
23/08/2024 00:48:42,Overnight fee,Daily,"(2,06)",-,"(2,06)"," 1.270,63 "," 28,68 ",2795877331,CFD," 0,00 "
23/08/2024 00:48:42,Overnight fee,Daily,"(0,36)",-,"(0,36)"," 1.270,27 "," 28,32 ",2795967754,CFD," 0,00 "
23/08/2024 00:48:42,Overnight fee,Daily,"(0,26)",-,"(0,26)"," 1.270,01 "," 28,06 ",2795963322,CFD," 0,00 "
23/08/2024 00:48:42,Overnight fee,Daily,"(0,26)",-,"(0,26)"," 1.269,75 "," 27,80 ",2796013442,CFD," 0,00 "
23/08/2024 00:48:42,Overnight fee,Daily,"(0,26)",-,"(0,26)"," 1.269,49 "," 27,54 ",2795871370,CFD," 0,00 "
23/08/2024 00:48:42,Overnight fee,Daily,"(1,06)",-,"(1,06)"," 1.268,43 "," 26,48 ",2796294062,CFD," 0,00 "
23/08/2024 00:48:42,Overnight fee,Daily,"(0,26)",-,"(0,26)"," 1.268,17 "," 26,22 ",2795965514,CFD," 0,00 "
23/08/2024 00:48:42,Overnight fee,Daily,"(0,48)",-,"(0,48)"," 1.267,69 "," 25,74 ",2796135242,CFD," 0,00 "
23/08/2024 00:48:42,Overnight fee,Daily,"(0,26)",-,"(0,26)"," 1.267,43 "," 25,48 ",2795937480,CFD," 0,00 "
23/08/2024 00:48:42,Overnight fee,Daily,"(0,32)",-,"(0,32)"," 1.267,11 "," 25,16 ",2796013135,CFD," 0,00 "
23/08/2024 00:48:42,Overnight fee,Daily,"(0,26)",-,"(0,26)"," 1.266,85 "," 24,90 ",2795961586,CFD," 0,00 "
23/08/2024 06:42:25,Position closed,XAU/USD," 73,50 ",0.562858," 3,52 "," 1.270,37 "," 98,40 ",2795967754,CFD," 0,00 "
23/08/2024 09:20:25,Position closed,XAU/USD," 49,64 ",0.399833,"(0,36)"," 1.270,01 "," 148,04 ",2795871370,CFD," 0,00 "
23/08/2024 09:20:25,Position closed,XAU/USD," 56,00 ",0.402375," 6,00 "," 1.276,01 "," 204,04 ",2795963322,CFD," 0,00 "
23/08/2024 09:20:25,Position closed,XAU/USD," 99,27 ",0.799664,"(0,72)"," 1.275,29 "," 303,31 ",2795871386,CFD," 0,00 "
23/08/2024 09:20:25,Position closed,XAU/USD," 422,49 ",3.208869," 22,49 "," 1.297,78 "," 725,80 ",2795877331,CFD," 0,00 "
23/08/2024 09:20:25,Position closed,XAU/USD," 54,37 ",0.401725," 4,37 "," 1.302,15 "," 780,17 ",2796013442,CFD," 0,00 "
23/08/2024 09:21:25,Open Position,NSDQ100/USD," 300,00 ",0.305876," 0,00 "," 1.302,15 "," 480,17 ",2796590672,CFD," 0,00 "
23/08/2024 09:30:14,Open Position,NSDQ100/USD," 149,99 ",0.152818," 0,00 "," 1.302,15 "," 330,18 ",2796592112,CFD," 0,00 "
23/08/2024 09:30:33,Open Position,NSDQ100/USD," 100,00 ",0.101875," 0,00 "," 1.302,15 "," 230,18 ",2796592154,CFD," 0,00 "
23/08/2024 11:12:12,Open Position,NSDQ100/USD," 100,00 ",0.101704," 0,00 "," 1.302,15 "," 130,18 ",2796608663,CFD," 0,00 "
23/08/2024 13:30:43,Open Position,NVDA/USD," 99,95 ",3.969476," 0,00 "," 1.302,15 "," 30,23 ",2796673050,CFD," 0,00 "
23/08/2024 14:03:33,Position closed,NVDA/USD," 109,00 ",3.969476," 9,05 "," 1.311,20 "," 139,23 ",2796673050,CFD," 0,00 "
23/08/2024 14:04:58,Position closed,NSDQ100/USD," 48,28 ",0.050254,"(6,72)"," 1.304,48 "," 187,51 ",2795961586,CFD," 0,00 "
23/08/2024 14:04:58,Position closed,NSDQ100/USD," 48,92 ",0.050283,"(6,07)"," 1.298,41 "," 236,43 ",2795965514,CFD," 0,00 "
23/08/2024 14:04:58,Position closed,NSDQ100/USD," 47,41 ",0.050210,"(7,59)"," 1.290,82 "," 283,84 ",2795937480,CFD," 0,00 "
23/08/2024 14:04:58,Position closed,NSDQ100/USD," 60,49 ",0.060383,"(6,51)"," 1.284,31 "," 344,33 ",2796013135,CFD," 0,00 "
23/08/2024 14:04:58,Position closed,NSDQ100/USD," 345,67 ",0.305876," 45,67 "," 1.329,98 "," 690,00 ",2796590672,CFD," 0,00 "
23/08/2024 14:04:58,Position closed,NSDQ100/USD," 84,95 ",0.090814,"(5,04)"," 1.324,94 "," 774,95 ",2796135242,CFD," 0,00 "
23/08/2024 14:04:58,Position closed,NSDQ100/USD," 205,07 ",0.202633," 5,07 "," 1.330,01 "," 980,02 ",2796294062,CFD," 0,00 "
23/08/2024 14:04:58,Position closed,NSDQ100/USD," 170,47 ",0.152818," 20,48 "," 1.350,49 "," 1.150,49 ",2796592112,CFD," 0,00 "
23/08/2024 14:04:58,Position closed,NSDQ100/USD," 110,27 ",0.101704," 10,27 "," 1.360,76 "," 1.260,76 ",2796608663,CFD," 0,00 "
23/08/2024 14:04:58,Position closed,NSDQ100/USD," 113,58 ",0.101875," 13,58 "," 1.374,34 "," 1.374,34 ",2796592154,CFD," 0,00 "
23/08/2024 14:06:32,Open Position,NSDQ100/USD," 99,99 ",0.101470," 0,00 "," 1.374,34 "," 1.274,35 ",2796925765,CFD," 0,00 "
23/08/2024 14:06:47,Open Position,NSDQ100/USD," 50,00 ",0.050684," 0,00 "," 1.374,34 "," 1.224,35 ",2796926710,CFD," 0,00 "
23/08/2024 14:07:22,Open Position,NSDQ100/USD," 50,00 ",0.050627," 0,00 "," 1.374,34 "," 1.174,35 ",2796928463,CFD," 0,00 "
23/08/2024 14:07:35,Open Position,NSDQ100/USD," 50,00 ",0.050641," 0,00 "," 1.374,34 "," 1.124,35 ",2796928960,CFD," 0,00 "
23/08/2024 14:08:40,Position closed,NSDQ100/USD," 50,29 ",0.050627," 0,29 "," 1.374,63 "," 1.174,64 ",2796928463,CFD," 0,00 "
23/08/2024 14:08:41,Position closed,NSDQ100/USD," 51,42 ",0.050684," 1,42 "," 1.376,05 "," 1.226,06 ",2796926710,CFD," 0,00 "
23/08/2024 14:08:41,Position closed,NSDQ100/USD," 104,81 ",0.101470," 4,82 "," 1.380,87 "," 1.330,87 ",2796925765,CFD," 0,00 "
23/08/2024 14:08:41,Position closed,NSDQ100/USD," 50,56 ",0.050641," 0,56 "," 1.381,43 "," 1.381,43 ",2796928960,CFD," 0,00 "
23/08/2024 14:09:09,Open Position,NSDQ100/USD," 50,00 ",0.050597," 0,00 "," 1.381,43 "," 1.331,43 ",2796932781,CFD," 0,00 "
23/08/2024 14:09:50,Open Position,NSDQ100/USD," 50,00 ",0.050544," 0,00 "," 1.381,43 "," 1.281,43 ",2796933937,CFD," 0,00 "
23/08/2024 14:10:05,Open Position,NSDQ100/USD," 99,98 ",0.101100," 0,00 "," 1.381,43 "," 1.181,45 ",2796935509,CFD," 0,00 "
23/08/2024 14:10:37,Open Position,NSDQ100/USD," 99,99 ",0.100999," 0,00 "," 1.381,43 "," 1.081,46 ",2796936550,CFD," 0,00 "
23/08/2024 14:10:59,Open Position,NSDQ100/USD," 279,99 ",0.282726," 0,00 "," 1.381,43 "," 801,47 ",2796937253,CFD," 0,00 "
23/08/2024 14:15:26,Open Position,NSDQ100/USD," 50,00 ",0.050518," 0,00 "," 1.381,43 "," 751,47 ",2796945555,CFD," 0,00 "
23/08/2024 14:16:24,Position closed,NSDQ100/USD," 51,74 ",0.050597," 1,74 "," 1.383,17 "," 803,21 ",2796932781,CFD," 0,00 "
23/08/2024 14:16:24,Position closed,NSDQ100/USD," 101,80 ",0.101100," 1,82 "," 1.384,99 "," 905,01 ",2796935509,CFD," 0,00 "
23/08/2024 14:16:24,Position closed,NSDQ100/USD," 50,68 ",0.050544," 0,68 "," 1.385,67 "," 955,69 ",2796933937,CFD," 0,00 "
23/08/2024 14:16:24,Position closed,NSDQ100/USD," 99,61 ",0.100999,"(0,38)"," 1.385,29 "," 1.055,30 ",2796936550,CFD," 0,00 "
23/08/2024 14:16:24,Position closed,NSDQ100/USD," 277,49 ",0.282726,"(2,50)"," 1.382,79 "," 1.332,79 ",2796937253,CFD," 0,00 "
23/08/2024 14:16:24,Position closed,NSDQ100/USD," 50,17 ",0.050518," 0,17 "," 1.382,96 "," 1.382,96 ",2796945555,CFD," 0,00 "
23/08/2024 14:17:19,Open Position,NSDQ100/USD," 99,99 ",0.101362," 0,00 "," 1.382,96 "," 1.282,97 ",2796949114,CFD," 0,00 "
23/08/2024 14:17:39,Open Position,NSDQ100/USD," 99,99 ",0.101475," 0,00 "," 1.382,96 "," 1.182,98 ",2796949693,CFD," 0,00 "
23/08/2024 14:17:48,Open Position,NSDQ100/USD," 200,00 ",0.202685," 0,00 "," 1.382,96 "," 982,98 ",2796949880,CFD," 0,00 "
23/08/2024 14:17:58,Open Position,NSDQ100/USD," 99,99 ",0.101327," 0,00 "," 1.382,96 "," 882,99 ",2796950147,CFD," 0,00 "
23/08/2024 14:18:10,Open Position,NSDQ100/USD," 50,00 ",0.050636," 0,00 "," 1.382,96 "," 832,99 ",2796950606,CFD," 0,00 "
23/08/2024 14:18:29,Open Position,NSDQ100/USD," 99,99 ",0.101321," 0,00 "," 1.382,96 "," 733,00 ",2796951190,CFD," 0,00 "
23/08/2024 14:18:59,Open Position,NSDQ100/USD," 190,00 ",0.192461," 0,00 "," 1.382,96 "," 543,00 ",2796951814,CFD," 0,00 "
23/08/2024 14:19:34,Open Position,NSDQ100/USD," 50,00 ",0.050648," 0,00 "," 1.382,96 "," 493,00 ",2796953084,CFD," 0,00 "
23/08/2024 14:20:23,Open Position,NSDQ100/USD," 129,99 ",0.131645," 0,00 "," 1.382,96 "," 363,01 ",2796954432,CFD," 0,00 "
23/08/2024 14:22:09,Open Position,NSDQ100/USD," 50,00 ",0.050661," 0,00 "," 1.382,96 "," 313,01 ",2796956591,CFD," 0,00 "
23/08/2024 14:22:53,Position closed,NSDQ100/USD," 205,89 ",0.202685," 5,89 "," 1.388,85 "," 518,90 ",2796949880,CFD," 0,00 "
23/08/2024 14:22:53,Position closed,NSDQ100/USD," 105,55 ",0.101475," 5,56 "," 1.394,41 "," 624,45 ",2796949693,CFD," 0,00 "
23/08/2024 14:22:53,Position closed,NSDQ100/USD," 103,32 ",0.101362," 3,33 "," 1.397,74 "," 727,77 ",2796949114,CFD," 0,00 "
23/08/2024 14:22:53,Position closed,NSDQ100/USD," 193,82 ",0.192461," 3,82 "," 1.401,56 "," 921,59 ",2796951814,CFD," 0,00 "
23/08/2024 14:22:53,Position closed,NSDQ100/USD," 102,63 ",0.101327," 2,64 "," 1.404,20 "," 1.024,22 ",2796950147,CFD," 0,00 "
23/08/2024 14:22:53,Position closed,NSDQ100/USD," 102,51 ",0.101321," 2,52 "," 1.406,72 "," 1.126,73 ",2796951190,CFD," 0,00 "
23/08/2024 14:22:53,Position closed,NSDQ100/USD," 50,79 ",0.050636," 0,79 "," 1.407,51 "," 1.177,52 ",2796950606,CFD," 0,00 "
23/08/2024 14:22:53,Position closed,NSDQ100/USD," 50,98 ",0.050648," 0,98 "," 1.408,49 "," 1.228,50 ",2796953084,CFD," 0,00 "
23/08/2024 14:22:53,Position closed,NSDQ100/USD," 131,84 ",0.131645," 1,85 "," 1.410,34 "," 1.360,34 ",2796954432,CFD," 0,00 "
23/08/2024 14:22:53,Position closed,NSDQ100/USD," 51,28 ",0.050661," 1,28 "," 1.411,62 "," 1.411,62 ",2796956591,CFD," 0,00 "
23/08/2024 14:23:33,Open Position,NSDQ100/USD," 50,00 ",0.050534," 0,00 "," 1.411,62 "," 1.361,62 ",2796993145,CFD," 0,00 "
23/08/2024 14:24:28,Open Position,NSDQ100/USD," 50,00 ",0.050511," 0,00 "," 1.411,62 "," 1.311,62 ",2797007378,CFD," 0,00 "
23/08/2024 14:25:13,Open Position,NSDQ100/USD," 50,00 ",0.050528," 0,00 "," 1.411,62 "," 1.261,62 ",2797008739,CFD," 0,00 "
23/08/2024 14:25:55,Open Position,NSDQ100/USD," 50,00 ",0.050522," 0,00 "," 1.411,62 "," 1.211,62 ",2797009901,CFD," 0,00 "
23/08/2024 14:26:20,Open Position,NSDQ100/USD," 50,00 ",0.050512," 0,00 "," 1.411,62 "," 1.161,62 ",2797010545,CFD," 0,00 "
23/08/2024 14:27:31,Open Position,NSDQ100/USD," 50,00 ",0.050502," 0,00 "," 1.411,62 "," 1.111,62 ",2797012437,CFD," 0,00 "
23/08/2024 14:27:47,Open Position,NSDQ100/USD," 149,99 ",0.151510," 0,00 "," 1.411,62 "," 961,63 ",2797012711,CFD," 0,00 "
23/08/2024 14:28:35,Position closed,NSDQ100/USD," 51,49 ",0.050528," 1,49 "," 1.413,11 "," 1.013,12 ",2797008739,CFD," 0,00 "
23/08/2024 14:28:35,Position closed,NSDQ100/USD," 51,14 ",0.050511," 1,14 "," 1.414,25 "," 1.064,26 ",2797007378,CFD," 0,00 "
23/08/2024 14:28:35,Position closed,NSDQ100/USD," 51,61 ",0.050534," 1,61 "," 1.415,86 "," 1.115,87 ",2796993145,CFD," 0,00 "
23/08/2024 14:28:35,Position closed,NSDQ100/USD," 51,37 ",0.050522," 1,37 "," 1.417,23 "," 1.167,24 ",2797009901,CFD," 0,00 "
23/08/2024 14:28:35,Position closed,NSDQ100/USD," 50,97 ",0.050502," 0,97 "," 1.418,20 "," 1.218,21 ",2797012437,CFD," 0,00 "
23/08/2024 14:28:35,Position closed,NSDQ100/USD," 152,98 ",0.151510," 2,99 "," 1.421,19 "," 1.371,19 ",2797012711,CFD," 0,00 "
23/08/2024 14:28:35,Position closed,NSDQ100/USD," 51,18 ",0.050512," 1,18 "," 1.422,37 "," 1.422,37 ",2797010545,CFD," 0,00 "
23/08/2024 14:29:30,Open Position,NSDQ100/USD," 50,00 ",0.050472," 0,00 "," 1.422,37 "," 1.372,37 ",2797015233,CFD," 0,00 "
23/08/2024 14:29:43,Open Position,NSDQ100/USD," 50,00 ",0.050466," 0,00 "," 1.422,37 "," 1.322,37 ",2797015674,CFD," 0,00 "
23/08/2024 14:30:11,Open Position,NSDQ100/USD," 50,00 ",0.050478," 0,00 "," 1.422,37 "," 1.272,37 ",2797016673,CFD," 0,00 "
23/08/2024 14:30:33,Open Position,NSDQ100/USD," 50,00 ",0.050491," 0,00 "," 1.422,37 "," 1.222,37 ",2797017529,CFD," 0,00 "
23/08/2024 14:30:44,Open Position,NSDQ100/USD," 99,99 ",0.101038," 0,00 "," 1.422,37 "," 1.122,38 ",2797017971,CFD," 0,00 "
23/08/2024 14:31:45,Position closed,NSDQ100/USD," 49,33 ",0.050472,"(0,67)"," 1.421,70 "," 1.171,71 ",2797015233,CFD," 0,00 "
23/08/2024 14:31:45,Position closed,NSDQ100/USD," 49,46 ",0.050478,"(0,54)"," 1.421,16 "," 1.221,17 ",2797016673,CFD," 0,00 "
23/08/2024 14:31:45,Position closed,NSDQ100/USD," 49,70 ",0.050491,"(0,30)"," 1.420,86 "," 1.270,87 ",2797017529,CFD," 0,00 "
23/08/2024 14:31:46,Position closed,NSDQ100/USD," 49,21 ",0.050466,"(0,79)"," 1.420,07 "," 1.320,08 ",2797015674,CFD," 0,00 "
23/08/2024 14:31:46,Position closed,NSDQ100/USD," 100,63 ",0.101038," 0,64 "," 1.420,71 "," 1.420,71 ",2797017971,CFD," 0,00 "
23/08/2024 14:45:55,Open Position,NSDQ100/USD," 149,99 ",0.152037," 0,00 "," 1.420,71 "," 1.270,72 ",2797047323,CFD," 0,00 "
23/08/2024 14:46:08,Open Position,NSDQ100/USD," 149,99 ",0.152118," 0,00 "," 1.420,71 "," 1.120,73 ",2797047624,CFD," 0,00 "
23/08/2024 14:47:24,Open Position,NSDQ100/USD," 289,98 ",0.294962," 0,00 "," 1.420,71 "," 830,75 ",2797049258,CFD," 0,00 "
23/08/2024 14:48:45,Open Position,NSDQ100/USD," 149,99 ",0.153197," 0,00 "," 1.420,71 "," 680,76 ",2797052159,CFD," 0,00 "
23/08/2024 14:50:05,Open Position,NSDQ100/USD," 50,00 ",0.051024," 0,00 "," 1.420,71 "," 630,76 ",2797054358,CFD," 0,00 "
23/08/2024 14:54:37,Open Position,NSDQ100/USD," 159,99 ",0.163398," 0,00 "," 1.420,71 "," 470,77 ",2797102149,CFD," 0,00 "
23/08/2024 14:57:31,Open Position,NSDQ100/USD," 119,99 ",0.122181," 0,00 "," 1.420,71 "," 350,78 ",2797105564,CFD," 0,00 "
23/08/2024 15:23:38,Position closed,NSDQ100/USD," 302,32 ",0.294962," 12,34 "," 1.433,05 "," 653,10 ",2797049258,CFD," 0,00 "
23/08/2024 15:23:38,Position closed,NSDQ100/USD," 147,43 ",0.152118,"(2,56)"," 1.430,49 "," 800,53 ",2797047624,CFD," 0,00 "
23/08/2024 15:23:38,Position closed,NSDQ100/USD," 145,83 ",0.152037,"(4,16)"," 1.426,33 "," 946,36 ",2797047323,CFD," 0,00 "
23/08/2024 15:23:38,Position closed,NSDQ100/USD," 168,70 ",0.153197," 18,71 "," 1.445,04 "," 1.115,06 ",2797052159,CFD," 0,00 "
23/08/2024 15:23:38,Position closed,NSDQ100/USD," 179,70 ",0.163398," 19,71 "," 1.464,75 "," 1.294,76 ",2797102149,CFD," 0,00 "
23/08/2024 15:23:38,Position closed,NSDQ100/USD," 55,42 ",0.051024," 5,42 "," 1.470,17 "," 1.350,18 ",2797054358,CFD," 0,00 "
23/08/2024 15:23:38,Position closed,NSDQ100/USD," 127,55 ",0.122181," 7,56 "," 1.477,73 "," 1.477,73 ",2797105564,CFD," 0,00 "
23/08/2024 15:28:30,Open Position,NSDQ100/USD," 50,00 ",0.050786," 0,00 "," 1.477,73 "," 1.427,73 ",2797158329,CFD," 0,00 "
23/08/2024 15:28:49,Open Position,NSDQ100/USD," 50,00 ",0.050767," 0,00 "," 1.477,73 "," 1.377,73 ",2797158644,CFD," 0,00 "
23/08/2024 15:29:17,Open Position,NSDQ100/USD," 50,00 ",0.050774," 0,00 "," 1.477,73 "," 1.327,73 ",2797159096,CFD," 0,00 "
23/08/2024 15:31:12,Open Position,NSDQ100/USD," 50,00 ",0.050770," 0,00 "," 1.477,73 "," 1.277,73 ",2797160404,CFD," 0,00 "
23/08/2024 15:31:32,Open Position,NSDQ100/USD," 50,00 ",0.050760," 0,00 "," 1.477,73 "," 1.227,73 ",2797160555,CFD," 0,00 "
23/08/2024 15:33:38,Open Position,NSDQ100/USD," 50,00 ",0.050759," 0,00 "," 1.477,73 "," 1.177,73 ",2797161988,CFD," 0,00 "
23/08/2024 15:36:36,Open Position,NSDQ100/USD," 50,00 ",0.050779," 0,00 "," 1.477,73 "," 1.127,73 ",2797164038,CFD," 0,00 "
23/08/2024 15:39:34,Open Position,NSDQ100/USD," 99,98 ",0.101480," 0,00 "," 1.477,73 "," 1.027,75 ",2797168694,CFD," 0,00 "
23/08/2024 15:45:34,Open Position,NSDQ100/USD," 99,99 ",0.101806," 0,00 "," 1.477,73 "," 927,76 ",2797173841,CFD," 0,00 "
23/08/2024 15:45:51,Open Position,NSDQ100/USD," 60,00 ",0.061087," 0,00 "," 1.477,73 "," 867,76 ",2797174009,CFD," 0,00 "
23/08/2024 15:46:00,Open Position,NSDQ100/USD," 50,00 ",0.050908," 0,00 "," 1.477,73 "," 817,76 ",2797174095,CFD," 0,00 "
23/08/2024 15:46:17,Open Position,NSDQ100/USD," 99,99 ",0.101835," 0,00 "," 1.477,73 "," 717,77 ",2797174263,CFD," 0,00 "
23/08/2024 15:46:34,Open Position,NSDQ100/USD," 50,00 ",0.050875," 0,00 "," 1.477,73 "," 667,77 ",2797174611,CFD," 0,00 "
23/08/2024 15:46:49,Open Position,NSDQ100/USD," 50,00 ",0.050871," 0,00 "," 1.477,73 "," 617,77 ",2797175164,CFD," 0,00 "
23/08/2024 15:48:41,Open Position,NSDQ100/USD," 50,00 ",0.050825," 0,00 "," 1.477,73 "," 567,77 ",2797176307,CFD," 0,00 "
23/08/2024 15:49:36,Open Position,NSDQ100/USD," 50,00 ",0.050814," 0,00 "," 1.477,73 "," 517,77 ",2797176819,CFD," 0,00 "
23/08/2024 15:50:13,Open Position,NSDQ100/USD," 50,00 ",0.050843," 0,00 "," 1.477,73 "," 467,77 ",2797177196,CFD," 0,00 "
23/08/2024 15:50:32,Open Position,NSDQ100/USD," 119,99 ",0.122086," 0,00 "," 1.477,73 "," 347,78 ",2797177622,CFD," 0,00 "
23/08/2024 15:50:50,Open Position,NSDQ100/USD," 89,99 ",0.091573," 0,00 "," 1.477,73 "," 257,79 ",2797177713,CFD," 0,00 "
23/08/2024 15:51:19,Open Position,NSDQ100/USD," 50,00 ",0.050899," 0,00 "," 1.477,73 "," 207,79 ",2797177902,CFD," 0,00 "
23/08/2024 15:53:37,Open Position,NSDQ100/USD," 50,00 ",0.050879," 0,00 "," 1.477,73 "," 157,79 ",2797179199,CFD," 0,00 "
23/08/2024 16:01:12,Open Position,NSDQ100/USD," 50,00 ",0.050998," 0,00 "," 1.477,73 "," 107,79 ",2797186305,CFD," 0,00 "
23/08/2024 18:45:39,Position closed,NSDQ100/USD," 49,00 ",0.050770,"(1,00)"," 1.476,73 "," 156,79 ",2797160404,CFD," 0,00 "
23/08/2024 18:45:39,Position closed,NSDQ100/USD," 49,08 ",0.050774,"(0,92)"," 1.475,81 "," 205,87 ",2797159096,CFD," 0,00 "
23/08/2024 18:45:39,Position closed,NSDQ100/USD," 49,31 ",0.050786,"(0,69)"," 1.475,12 "," 255,18 ",2797158329,CFD," 0,00 "
23/08/2024 18:45:39,Position closed,NSDQ100/USD," 48,93 ",0.050767,"(1,07)"," 1.474,05 "," 304,11 ",2797158644,CFD," 0,00 "
23/08/2024 18:45:39,Position closed,NSDQ100/USD," 97,01 ",0.101480,"(2,97)"," 1.471,08 "," 401,12 ",2797168694,CFD," 0,00 "
23/08/2024 18:45:39,Position closed,NSDQ100/USD," 48,80 ",0.050760,"(1,20)"," 1.469,88 "," 449,92 ",2797160555,CFD," 0,00 "
23/08/2024 18:45:39,Position closed,NSDQ100/USD," 49,18 ",0.050779,"(0,82)"," 1.469,06 "," 499,10 ",2797164038,CFD," 0,00 "
23/08/2024 18:45:39,Position closed,NSDQ100/USD," 103,24 ",0.101806," 3,25 "," 1.472,31 "," 602,34 ",2797173841,CFD," 0,00 "
23/08/2024 18:45:39,Position closed,NSDQ100/USD," 48,79 ",0.050759,"(1,21)"," 1.471,10 "," 651,13 ",2797161988,CFD," 0,00 "
23/08/2024 18:45:39,Position closed,NSDQ100/USD," 62,01 ",0.061087," 2,01 "," 1.473,11 "," 713,14 ",2797174009,CFD," 0,00 "
23/08/2024 18:45:39,Position closed,NSDQ100/USD," 103,80 ",0.101835," 3,81 "," 1.476,92 "," 816,94 ",2797174263,CFD," 0,00 "
23/08/2024 18:45:39,Position closed,NSDQ100/USD," 51,08 ",0.050875," 1,08 "," 1.478,00 "," 868,02 ",2797174611,CFD," 0,00 "
23/08/2024 18:45:39,Position closed,NSDQ100/USD," 49,87 ",0.050814,"(0,13)"," 1.477,87 "," 917,89 ",2797176819,CFD," 0,00 "
23/08/2024 18:45:39,Position closed,NSDQ100/USD," 51,00 ",0.050871," 1,00 "," 1.478,87 "," 968,89 ",2797175164,CFD," 0,00 "
23/08/2024 18:45:39,Position closed,NSDQ100/USD," 51,54 ",0.050899," 1,54 "," 1.480,41 "," 1.020,43 ",2797177902,CFD," 0,00 "
23/08/2024 18:45:39,Position closed,NSDQ100/USD," 50,45 ",0.050843," 0,45 "," 1.480,86 "," 1.070,88 ",2797177196,CFD," 0,00 "
23/08/2024 18:45:39,Position closed,NSDQ100/USD," 51,73 ",0.050908," 1,73 "," 1.482,59 "," 1.122,61 ",2797174095,CFD," 0,00 "
23/08/2024 18:45:39,Position closed,NSDQ100/USD," 122,28 ",0.122086," 2,29 "," 1.484,88 "," 1.244,89 ",2797177622,CFD," 0,00 "
23/08/2024 18:45:39,Position closed,NSDQ100/USD," 51,16 ",0.050879," 1,16 "," 1.486,04 "," 1.296,05 ",2797179199,CFD," 0,00 "
23/08/2024 18:45:39,Position closed,NSDQ100/USD," 50,09 ",0.050825," 0,09 "," 1.486,13 "," 1.346,14 ",2797176307,CFD," 0,00 "
23/08/2024 18:45:39,Position closed,NSDQ100/USD," 53,49 ",0.050998," 3,49 "," 1.489,62 "," 1.399,63 ",2797186305,CFD," 0,00 "
23/08/2024 18:45:39,Position closed,NSDQ100/USD," 91,86 ",0.091573," 1,87 "," 1.491,49 "," 1.491,49 ",2797177713,CFD," 0,00 "
25/08/2024 22:24:57,Open Position,NSDQ100/USD," 150,00 ",0.151970," 0,00 "," 1.491,49 "," 1.341,49 ",2797376273,CFD," 0,00 "
25/08/2024 22:26:05,Open Position,USD/JPY," 340,00 ",10200.000000," 0,00 "," 1.491,49 "," 1.001,49 ",2797376337,CFD," 0,00 "
25/08/2024 22:43:54,Position closed,NSDQ100/USD," 161,63 ",0.151970," 11,63 "," 1.503,12 "," 1.163,12 ",2797376273,CFD," 0,00 "
26/08/2024 02:54:44,Open Position,NSDQ100/USD," 300,00 ",0.304215," 0,00 "," 1.503,12 "," 863,12 ",2797393436,CFD," 0,00 "
26/08/2024 05:27:29,Open Position,NSDQ100/USD," 207,99 ",0.211130," 0,00 "," 1.503,12 "," 655,13 ",2797403308,CFD," 0,00 "
26/08/2024 07:16:53,Open Position,NSDQ100/USD," 300,00 ",0.304036," 0,00 "," 1.503,12 "," 355,13 ",2797433452,CFD," 0,00 "
26/08/2024 07:35:15,Position closed,NSDQ100/USD," 306,21 ",0.304036," 6,21 "," 1.509,33 "," 661,34 ",2797433452,CFD," 0,00 "
26/08/2024 07:35:15,Position closed,NSDQ100/USD," 218,85 ",0.211130," 10,86 "," 1.520,19 "," 880,19 ",2797403308,CFD," 0,00 "
26/08/2024 07:35:15,Position closed,NSDQ100/USD," 309,75 ",0.304215," 9,75 "," 1.529,94 "," 1.189,94 ",2797393436,CFD," 0,00 "
26/08/2024 07:38:48,Open Position,NSDQ100/USD," 50,00 ",0.050636," 0,00 "," 1.529,94 "," 1.139,94 ",2797451213,CFD," 0,00 "
26/08/2024 07:39:04,Open Position,NSDQ100/USD," 50,00 ",0.050636," 0,00 "," 1.529,94 "," 1.089,94 ",2797451299,CFD," 0,00 "
26/08/2024 07:45:20,Open Position,NSDQ100/USD," 149,99 ",0.151961," 0,00 "," 1.529,94 "," 939,95 ",2797452737,CFD," 0,00 "
26/08/2024 07:45:38,Open Position,NSDQ100/USD," 50,00 ",0.050655," 0,00 "," 1.529,94 "," 889,95 ",2797452766,CFD," 0,00 "
26/08/2024 07:46:09,Open Position,NSDQ100/USD," 70,00 ",0.070923," 0,00 "," 1.529,94 "," 819,95 ",2797452821,CFD," 0,00 "
26/08/2024 07:46:56,Open Position,NSDQ100/USD," 50,00 ",0.050656," 0,00 "," 1.529,94 "," 769,95 ",2797452913,CFD," 0,00 "
26/08/2024 07:47:30,Open Position,NSDQ100/USD," 149,99 ",0.151983," 0,00 "," 1.529,94 "," 619,96 ",2797452963,CFD," 0,00 "
26/08/2024 07:47:50,Open Position,NSDQ100/USD," 50,00 ",0.050660," 0,00 "," 1.529,94 "," 569,96 ",2797453070,CFD," 0,00 "
26/08/2024 07:49:32,Open Position,NSDQ100/USD," 100,00 ",0.101306," 0,00 "," 1.529,94 "," 469,96 ",2797453330,CFD," 0,00 "
26/08/2024 07:53:23,Open Position,NSDQ100/USD," 100,00 ",0.101287," 0,00 "," 1.529,94 "," 369,96 ",2797454136,CFD," 0,00 "
26/08/2024 07:58:44,Open Position,NSDQ100/USD," 100,00 ",0.101230," 0,00 "," 1.529,94 "," 269,96 ",2797455159,CFD," 0,00 "
26/08/2024 07:59:28,Position closed,NSDQ100/USD," 50,21 ",0.050636," 0,21 "," 1.530,15 "," 320,17 ",2797451213,CFD," 0,00 "
26/08/2024 07:59:28,Position closed,NSDQ100/USD," 50,57 ",0.050655," 0,57 "," 1.530,72 "," 370,74 ",2797452766,CFD," 0,00 "
26/08/2024 07:59:28,Position closed,NSDQ100/USD," 50,20 ",0.050636," 0,20 "," 1.530,92 "," 420,94 ",2797451299,CFD," 0,00 "
26/08/2024 07:59:28,Position closed,NSDQ100/USD," 151,64 ",0.151961," 1,65 "," 1.532,57 "," 572,58 ",2797452737,CFD," 0,00 "
26/08/2024 07:59:28,Position closed,NSDQ100/USD," 50,60 ",0.050656," 0,60 "," 1.533,17 "," 623,18 ",2797452913,CFD," 0,00 "
26/08/2024 07:59:28,Position closed,NSDQ100/USD," 50,68 ",0.050660," 0,68 "," 1.533,85 "," 673,86 ",2797453070,CFD," 0,00 "
26/08/2024 07:59:28,Position closed,NSDQ100/USD," 70,92 ",0.070923," 0,92 "," 1.534,77 "," 744,78 ",2797452821,CFD," 0,00 "
26/08/2024 07:59:28,Position closed,NSDQ100/USD," 152,08 ",0.151983," 2,09 "," 1.536,86 "," 896,86 ",2797452963,CFD," 0,00 "
26/08/2024 07:59:28,Position closed,NSDQ100/USD," 99,58 ",0.101230,"(0,42)"," 1.536,44 "," 996,44 ",2797455159,CFD," 0,00 "
26/08/2024 07:59:28,Position closed,NSDQ100/USD," 101,09 ",0.101306," 1,09 "," 1.537,53 "," 1.097,53 ",2797453330,CFD," 0,00 "
26/08/2024 07:59:28,Position closed,NSDQ100/USD," 100,71 ",0.101287," 0,71 "," 1.538,24 "," 1.198,24 ",2797454136,CFD," 0,00 "
26/08/2024 08:00:55,Open Position,NSDQ100/USD," 100,00 ",0.101289," 0,00 "," 1.538,24 "," 1.098,24 ",2797455695,CFD," 0,00 "
26/08/2024 08:01:07,Open Position,NSDQ100/USD," 50,00 ",0.050651," 0,00 "," 1.538,24 "," 1.048,24 ",2797455729,CFD," 0,00 "
26/08/2024 08:01:31,Open Position,NSDQ100/USD," 100,00 ",0.101286," 0,00 "," 1.538,24 "," 948,24 ",2797455795,CFD," 0,00 "
26/08/2024 08:01:45,Open Position,NSDQ100/USD," 50,00 ",0.050647," 0,00 "," 1.538,24 "," 898,24 ",2797455835,CFD," 0,00 "
26/08/2024 08:02:05,Open Position,NSDQ100/USD," 100,00 ",0.101274," 0,00 "," 1.538,24 "," 798,24 ",2797455889,CFD," 0,00 "
26/08/2024 08:02:36,Open Position,NSDQ100/USD," 50,00 ",0.050628," 0,00 "," 1.538,24 "," 748,24 ",2797455989,CFD," 0,00 "
26/08/2024 08:02:46,Open Position,NSDQ100/USD," 100,00 ",0.101246," 0,00 "," 1.538,24 "," 648,24 ",2797456021,CFD," 0,00 "
26/08/2024 08:03:01,Open Position,NSDQ100/USD," 50,00 ",0.050619," 0,00 "," 1.538,24 "," 598,24 ",2797456065,CFD," 0,00 "
26/08/2024 08:04:34,Open Position,NSDQ100/USD," 149,99 ",0.151861," 0,00 "," 1.538,24 "," 448,25 ",2797456351,CFD," 0,00 "
26/08/2024 08:15:16,Position closed,NSDQ100/USD," 51,10 ",0.050651," 1,10 "," 1.539,34 "," 499,35 ",2797455729,CFD," 0,00 "
26/08/2024 08:15:16,Position closed,NSDQ100/USD," 101,93 ",0.101289," 1,93 "," 1.541,27 "," 601,28 ",2797455695,CFD," 0,00 "
26/08/2024 08:15:16,Position closed,NSDQ100/USD," 101,87 ",0.101286," 1,87 "," 1.543,14 "," 703,15 ",2797455795,CFD," 0,00 "
26/08/2024 08:15:16,Position closed,NSDQ100/USD," 51,01 ",0.050647," 1,01 "," 1.544,15 "," 754,16 ",2797455835,CFD," 0,00 "
26/08/2024 08:15:16,Position closed,NSDQ100/USD," 50,47 ",0.050619," 0,47 "," 1.544,62 "," 804,63 ",2797456065,CFD," 0,00 "
26/08/2024 08:15:16,Position closed,NSDQ100/USD," 50,63 ",0.050628," 0,63 "," 1.545,25 "," 855,26 ",2797455989,CFD," 0,00 "
26/08/2024 08:15:16,Position closed,NSDQ100/USD," 101,63 ",0.101274," 1,63 "," 1.546,88 "," 956,89 ",2797455889,CFD," 0,00 "
26/08/2024 08:15:16,Position closed,NSDQ100/USD," 101,08 ",0.101246," 1,08 "," 1.547,96 "," 1.057,97 ",2797456021,CFD," 0,00 "
26/08/2024 08:15:16,Position closed,NSDQ100/USD," 151,45 ",0.151861," 1,46 "," 1.549,42 "," 1.209,42 ",2797456351,CFD," 0,00 "
26/08/2024 08:17:20,Open Position,NSDQ100/USD," 100,00 ",0.101177," 0,00 "," 1.549,42 "," 1.109,42 ",2797458799,CFD," 0,00 "
26/08/2024 08:18:25,Open Position,NSDQ100/USD," 50,00 ",0.050587," 0,00 "," 1.549,42 "," 1.059,42 ",2797458964,CFD," 0,00 "
26/08/2024 08:23:18,Open Position,NSDQ100/USD," 149,99 ",0.151858," 0,00 "," 1.549,42 "," 909,43 ",2797459999,CFD," 0,00 "
26/08/2024 08:23:34,Open Position,NSDQ100/USD," 100,00 ",0.101241," 0,00 "," 1.549,42 "," 809,43 ",2797460036,CFD," 0,00 "
26/08/2024 08:24:45,Open Position,NSDQ100/USD," 209,99 ",0.212621," 0,00 "," 1.549,42 "," 599,44 ",2797460223,CFD," 0,00 "
26/08/2024 08:25:05,Open Position,NSDQ100/USD," 149,99 ",0.151868," 0,00 "," 1.549,42 "," 449,45 ",2797460297,CFD," 0,00 "
26/08/2024 08:25:26,Open Position,NSDQ100/USD," 50,00 ",0.050627," 0,00 "," 1.549,42 "," 399,45 ",2797460348,CFD," 0,00 "
26/08/2024 08:26:15,Open Position,NSDQ100/USD," 50,00 ",0.050622," 0,00 "," 1.549,42 "," 349,45 ",2797460450,CFD," 0,00 "
26/08/2024 08:27:49,Open Position,NSDQ100/USD," 90,00 ",0.091096," 0,00 "," 1.549,42 "," 259,45 ",2797460656,CFD," 0,00 "
26/08/2024 08:29:27,Open Position,NSDQ100/USD," 70,00 ",0.070850," 0,00 "," 1.549,42 "," 189,45 ",2797460888,CFD," 0,00 "
26/08/2024 08:31:39,Open Position,NSDQ100/USD," 50,00 ",0.050612," 0,00 "," 1.549,42 "," 139,45 ",2797461133,CFD," 0,00 "
26/08/2024 08:39:14,Position closed,NSDQ100/USD," 49,88 ",0.050587,"(0,12)"," 1.549,30 "," 189,33 ",2797458964,CFD," 0,00 "
26/08/2024 08:39:14,Position closed,NSDQ100/USD," 99,82 ",0.101177,"(0,18)"," 1.549,12 "," 289,15 ",2797458799,CFD," 0,00 "
26/08/2024 08:39:14,Position closed,NSDQ100/USD," 151,55 ",0.151858," 1,56 "," 1.550,68 "," 440,70 ",2797459999,CFD," 0,00 "
26/08/2024 08:39:14,Position closed,NSDQ100/USD," 101,10 ",0.101241," 1,10 "," 1.551,78 "," 541,80 ",2797460036,CFD," 0,00 "
26/08/2024 08:39:14,Position closed,NSDQ100/USD," 212,57 ",0.212621," 2,58 "," 1.554,36 "," 754,37 ",2797460223,CFD," 0,00 "
26/08/2024 08:39:14,Position closed,NSDQ100/USD," 50,68 ",0.050627," 0,68 "," 1.555,04 "," 805,05 ",2797460348,CFD," 0,00 "
26/08/2024 08:39:14,Position closed,NSDQ100/USD," 151,76 ",0.151868," 1,77 "," 1.556,81 "," 956,81 ",2797460297,CFD," 0,00 "
26/08/2024 08:39:14,Position closed,NSDQ100/USD," 50,39 ",0.050612," 0,39 "," 1.557,20 "," 1.007,20 ",2797461133,CFD," 0,00 "
26/08/2024 08:39:14,Position closed,NSDQ100/USD," 70,41 ",0.070850," 0,41 "," 1.557,61 "," 1.077,61 ",2797460888,CFD," 0,00 "
26/08/2024 08:39:14,Position closed,NSDQ100/USD," 90,57 ",0.091096," 0,57 "," 1.558,18 "," 1.168,18 ",2797460656,CFD," 0,00 "
26/08/2024 08:39:14,Position closed,NSDQ100/USD," 50,59 ",0.050622," 0,59 "," 1.558,77 "," 1.218,77 ",2797460450,CFD," 0,00 "
26/08/2024 08:40:39,Open Position,NSDQ100/USD," 110,00 ",0.101199," 0,00 "," 1.558,77 "," 1.118,77 ",2797462326,CFD," 0,00 "
26/08/2024 08:40:56,Open Position,NSDQ100/USD," 50,00 ",0.050596," 0,00 "," 1.558,77 "," 1.068,77 ",2797462351,CFD," 0,00 "
26/08/2024 08:42:17,Open Position,NSDQ100/USD," 50,00 ",0.050596," 0,00 "," 1.558,77 "," 1.018,77 ",2797462645,CFD," 0,00 "
26/08/2024 08:42:32,Open Position,NSDQ100/USD," 50,00 ",0.050600," 0,00 "," 1.558,77 "," 968,77 ",2797462678,CFD," 0,00 "
26/08/2024 08:46:39,Open Position,NSDQ100/USD," 50,00 ",0.050588," 0,00 "," 1.558,77 "," 918,77 ",2797463435,CFD," 0,00 "
26/08/2024 08:46:57,Open Position,NSDQ100/USD," 110,00 ",0.101170," 0,00 "," 1.558,77 "," 818,77 ",2797463485,CFD," 0,00 "
26/08/2024 08:50:53,Open Position,NSDQ100/USD," 209,99 ",0.212525," 0,00 "," 1.558,77 "," 608,78 ",2797464304,CFD," 0,00 "
26/08/2024 09:00:03,Open Position,NSDQ100/USD," 50,00 ",0.050579," 0,00 "," 1.558,77 "," 558,78 ",2797465632,CFD," 0,00 "
26/08/2024 09:04:33,Open Position,NSDQ100/USD," 139,99 ",0.141704," 0,00 "," 1.558,77 "," 418,79 ",2797466241,CFD," 0,00 "
26/08/2024 09:05:03,Open Position,NSDQ100/USD," 110,00 ",0.111330," 0,00 "," 1.558,77 "," 308,79 ",2797466351,CFD," 0,00 "
26/08/2024 09:07:58,Open Position,NSDQ100/USD," 80,00 ",0.080974," 0,00 "," 1.558,77 "," 228,79 ",2797466634,CFD," 0,00 "
26/08/2024 09:12:59,Open Position,NSDQ100/USD," 199,99 ",0.202499," 0,00 "," 1.558,77 "," 28,80 ",2797467104,CFD," 0,00 "
26/08/2024 11:12:27,Position closed,USD/JPY," 314,78 ",10200.000000,"(25,22)"," 1.533,55 "," 343,58 ",2797376337,CFD," 0,00 "
26/08/2024 11:13:03,Open Position,NSDQ100/USD," 300,00 ",0.304187," 0,00 "," 1.533,55 "," 43,58 ",2797485498,CFD," 0,00 "
26/08/2024 13:09:19,Deposit Conversion Fee,-,"(12,00)",-," 0,00 "," 1.929,86 "," 439,89 ",-,-," 0,00 "
26/08/2024 13:09:19,Deposit,1820.00 USDRON CreditCard," 396,31 ",-," 396,31 "," 1.929,86 "," 439,89 ",-,-," 0,00 "
26/08/2024 13:10:20,Open Position,NSDQ100/USD," 399,99 ",0.406083," 0,00 "," 1.929,86 "," 39,90 ",2797511858,CFD," 0,00 "
26/08/2024 14:34:36,Deposit Conversion Fee,-,"(12,00)",-," 0,00 "," 2.811,76 "," 921,80 ",-,-," 0,00 "
26/08/2024 14:34:36,Deposit,800.00 EUR CreditCard," 881,90 ",-," 881,90 "," 2.811,76 "," 921,80 ",-,-," 0,00 "
26/08/2024 14:35:01,Open Position,NSDQ100/USD," 799,99 ",0.821443," 0,00 "," 2.811,76 "," 121,81 ",2797840866,CFD," 0,00 "
26/08/2024 14:35:33,Edit Stop Loss,-,"(10,00)",-," 0,00 "," 2.811,76 "," 111,81 ",2797462326,-," 0,00 "
26/08/2024 14:35:51,Edit Stop Loss,-,"(10,00)",-," 0,00 "," 2.811,76 "," 101,81 ",2797463485,-," 0,00 "
26/08/2024 18:27:47,Open Position,TSLA/USD," 99,99 ",2.353182," 0,00 "," 2.811,76 "," 1,82 ",2798045675,CFD," 0,00 "
26/08/2024 18:30:52,Deposit Conversion Fee,-,"(4,08)",-," 0,00 "," 3.111,41 "," 301,47 ",-,-," 0,00 "
26/08/2024 18:30:52,Deposit,272.00 EUR CreditCard," 299,65 ",-," 299,65 "," 3.111,41 "," 301,47 ",-,-," 0,00 "
26/08/2024 18:32:21,Open Position,TSLA/USD," 199,99 ",4.702596," 0,00 "," 3.111,41 "," 101,48 ",2798048955,CFD," 0,00 "
27/08/2024 00:48:36,Overnight fee,Daily,"(0,32)",-,"(0,32)"," 3.111,09 "," 101,16 ",2798048955,CFD," 0,00 "
27/08/2024 00:48:36,Overnight fee,Daily,"(0,16)",-,"(0,16)"," 3.110,93 "," 101,00 ",2798045675,CFD," 0,00 "
27/08/2024 00:48:36,Overnight fee,Daily,"(4,34)",-,"(4,34)"," 3.106,59 "," 96,66 ",2797840866,CFD," 0,00 "
27/08/2024 00:48:36,Overnight fee,Daily,"(1,61)",-,"(1,61)"," 3.104,98 "," 95,05 ",2797485498,CFD," 0,00 "
27/08/2024 00:48:36,Overnight fee,Daily,"(0,75)",-,"(0,75)"," 3.104,23 "," 94,30 ",2797466241,CFD," 0,00 "
27/08/2024 00:48:36,Overnight fee,Daily,"(0,27)",-,"(0,27)"," 3.103,96 "," 94,03 ",2797462645,CFD," 0,00 "
27/08/2024 00:48:36,Overnight fee,Daily,"(0,43)",-,"(0,43)"," 3.103,53 "," 93,60 ",2797466634,CFD," 0,00 "
27/08/2024 00:48:36,Overnight fee,Daily,"(0,53)",-,"(0,53)"," 3.103,00 "," 93,07 ",2797462326,CFD," 0,00 "
27/08/2024 00:48:36,Overnight fee,Daily,"(0,27)",-,"(0,27)"," 3.102,73 "," 92,80 ",2797463435,CFD," 0,00 "
27/08/2024 00:48:36,Overnight fee,Daily,"(0,53)",-,"(0,53)"," 3.102,20 "," 92,27 ",2797463485,CFD," 0,00 "
27/08/2024 00:48:36,Overnight fee,Daily,"(0,27)",-,"(0,27)"," 3.101,93 "," 92,00 ",2797465632,CFD," 0,00 "
27/08/2024 00:48:36,Overnight fee,Daily,"(0,27)",-,"(0,27)"," 3.101,66 "," 91,73 ",2797462678,CFD," 0,00 "
27/08/2024 00:48:36,Overnight fee,Daily,"(0,59)",-,"(0,59)"," 3.101,07 "," 91,14 ",2797466351,CFD," 0,00 "
27/08/2024 00:48:36,Overnight fee,Daily,"(0,27)",-,"(0,27)"," 3.100,80 "," 90,87 ",2797462351,CFD," 0,00 "
27/08/2024 00:48:36,Overnight fee,Daily,"(2,14)",-,"(2,14)"," 3.098,66 "," 88,73 ",2797511858,CFD," 0,00 "
27/08/2024 00:48:36,Overnight fee,Daily,"(1,07)",-,"(1,07)"," 3.097,59 "," 87,66 ",2797467104,CFD," 0,00 "
27/08/2024 00:48:36,Overnight fee,Daily,"(1,12)",-,"(1,12)"," 3.096,47 "," 86,54 ",2797464304,CFD," 0,00 "
27/08/2024 13:15:04,Deposit Conversion Fee,-,"(30,36)",-," 0,00 "," 4.098,54 "," 1.088,61 ",-,-," 0,00 "
27/08/2024 13:15:04,Deposit,4600.00 USDRON CreditCard," 1.002,07 ",-," 1.002,07 "," 4.098,54 "," 1.088,61 ",-,-," 0,00 "
27/08/2024 13:15:29,Open Position,NSDQ100/USD," 999,95 ",1.029868," 0,00 "," 4.098,54 "," 88,66 ",2798273413,CFD," 0,00 "
27/08/2024 17:36:57,Position closed,NSDQ100/USD," 41,82 ",0.050596,"(8,18)"," 4.090,36 "," 130,48 ",2797462351,CFD," 0,00 "
27/08/2024 17:36:57,Position closed,NSDQ100/USD," 93,79 ",0.101199,"(16,21)"," 4.074,15 "," 224,27 ",2797462326,CFD," 0,00 "
27/08/2024 17:36:57,Position closed,NSDQ100/USD," 93,21 ",0.101170,"(16,79)"," 4.057,36 "," 317,48 ",2797463485,CFD," 0,00 "
27/08/2024 17:36:57,Position closed,NSDQ100/USD," 41,82 ",0.050596,"(8,18)"," 4.049,18 "," 359,30 ",2797462645,CFD," 0,00 "
27/08/2024 17:36:57,Position closed,NSDQ100/USD," 41,91 ",0.050600,"(8,09)"," 4.041,09 "," 401,21 ",2797462678,CFD," 0,00 "
27/08/2024 17:36:57,Position closed,NSDQ100/USD," 41,68 ",0.050588,"(8,32)"," 4.032,77 "," 442,89 ",2797463435,CFD," 0,00 "
27/08/2024 17:36:57,Position closed,NSDQ100/USD," 92,38 ",0.111330,"(17,62)"," 4.015,15 "," 535,27 ",2797466351,CFD," 0,00 "
27/08/2024 17:36:57,Position closed,NSDQ100/USD," 41,49 ",0.050579,"(8,51)"," 4.006,64 "," 576,76 ",2797465632,CFD," 0,00 "
27/08/2024 17:36:57,Position closed,NSDQ100/USD," 176,05 ",0.212525,"(33,94)"," 3.972,70 "," 752,81 ",2797464304,CFD," 0,00 "
27/08/2024 17:36:57,Position closed,NSDQ100/USD," 169,51 ",0.202499,"(30,48)"," 3.942,22 "," 922,32 ",2797467104,CFD," 0,00 "
27/08/2024 17:36:57,Position closed,NSDQ100/USD," 360,32 ",0.406083,"(39,67)"," 3.902,55 "," 1.282,64 ",2797511858,CFD," 0,00 "
27/08/2024 17:36:57,Position closed,NSDQ100/USD," 117,77 ",0.141704,"(22,22)"," 3.880,33 "," 1.400,41 ",2797466241,CFD," 0,00 "
27/08/2024 17:36:57,Position closed,NSDQ100/USD," 67,31 ",0.080974,"(12,69)"," 3.867,64 "," 1.467,72 ",2797466634,CFD," 0,00 "
27/08/2024 17:36:57,Position closed,NSDQ100/USD," 902,48 ",0.821443," 102,49 "," 3.970,13 "," 2.370,20 ",2797840866,CFD," 0,00 "
27/08/2024 17:36:57,Position closed,NSDQ100/USD," 262,89 ",0.304187,"(37,11)"," 3.933,02 "," 2.633,09 ",2797485498,CFD," 0,00 "
27/08/2024 17:36:57,Position closed,NSDQ100/USD," 1.188,86 ",1.029868," 188,91 "," 4.121,93 "," 3.821,95 ",2798273413,CFD," 0,00 "
27/08/2024 17:46:13,Open Position,NSDQ100/USD," 149,99 ",0.153118," 0,00 "," 4.121,93 "," 3.671,96 ",2798686947,CFD," 0,00 "
27/08/2024 17:52:23,Position closed,NSDQ100/USD," 153,02 ",0.153118," 3,03 "," 4.124,96 "," 3.824,98 ",2798686947,CFD," 0,00 "
27/08/2024 17:53:45,Open Position,NSDQ100/USD," 50,00 ",0.050977," 0,00 "," 4.124,96 "," 3.774,98 ",2798689876,CFD," 0,00 "
27/08/2024 18:05:30,Open Position,NSDQ100/USD," 50,00 ",0.050996," 0,00 "," 4.124,96 "," 3.724,98 ",2798710575,CFD," 0,00 "
27/08/2024 18:14:30,Open Position,NSDQ100/USD," 99,99 ",0.102050," 0,00 "," 4.124,96 "," 3.624,99 ",2798717610,CFD," 0,00 "
28/08/2024 00:48:52,Overnight fee,Daily,"(0,16)",-,"(0,16)"," 4.124,80 "," 3.624,83 ",2798045675,CFD," 0,00 "
28/08/2024 00:48:52,Overnight fee,Daily,"(0,31)",-,"(0,31)"," 4.124,49 "," 3.624,52 ",2798048955,CFD," 0,00 "
28/08/2024 00:48:52,Overnight fee,Daily,"(0,54)",-,"(0,54)"," 4.123,95 "," 3.623,98 ",2798717610,CFD," 0,00 "
28/08/2024 00:48:52,Overnight fee,Daily,"(0,27)",-,"(0,27)"," 4.123,68 "," 3.623,71 ",2798689876,CFD," 0,00 "
28/08/2024 00:48:52,Overnight fee,Daily,"(0,27)",-,"(0,27)"," 4.123,41 "," 3.623,44 ",2798710575,CFD," 0,00 "
28/08/2024 02:04:13,Open Position,NSDQ100/USD," 499,99 ",0.511879," 0,00 "," 4.123,41 "," 3.123,45 ",2798801764,CFD," 0,00 "
28/08/2024 02:04:37,Open Position,NSDQ100/USD," 50,00 ",0.051188," 0,00 "," 4.123,41 "," 3.073,45 ",2798801777,CFD," 0,00 "
28/08/2024 02:06:03,Open Position,NSDQ100/USD," 100,00 ",0.102377," 0,00 "," 4.123,41 "," 2.973,45 ",2798801830,CFD," 0,00 "
28/08/2024 05:54:41,Position closed,NSDQ100/USD," 96,52 ",0.102050,"(3,47)"," 4.119,94 "," 3.069,97 ",2798717610,CFD," 0,00 "
28/08/2024 05:54:41,Position closed,NSDQ100/USD," 47,71 ",0.050996,"(2,29)"," 4.117,65 "," 3.117,68 ",2798710575,CFD," 0,00 "
28/08/2024 05:54:41,Position closed,NSDQ100/USD," 47,33 ",0.050977,"(2,67)"," 4.114,98 "," 3.165,01 ",2798689876,CFD," 0,00 "
28/08/2024 05:54:41,Position closed,NSDQ100/USD," 514,51 ",0.511879," 14,52 "," 4.129,50 "," 3.679,52 ",2798801764,CFD," 0,00 "
28/08/2024 05:54:41,Position closed,NSDQ100/USD," 102,94 ",0.102377," 2,94 "," 4.132,44 "," 3.782,46 ",2798801830,CFD," 0,00 "
28/08/2024 05:54:41,Position closed,NSDQ100/USD," 51,46 ",0.051188," 1,46 "," 4.133,90 "," 3.833,92 ",2798801777,CFD," 0,00 "
28/08/2024 06:05:41,Open Position,NSDQ100/USD," 959,99 ",0.981029," 0,00 "," 4.133,90 "," 2.873,93 ",2798816864,CFD," 0,00 "
28/08/2024 06:35:08,Position closed,NSDQ100/USD," 965,05 ",0.981029," 5,06 "," 4.138,96 "," 3.838,98 ",2798816864,CFD," 0,00 "
28/08/2024 06:45:48,Open Position,NSDQ100/USD," 1.499,99 ",1.532459," 0,00 "," 4.138,96 "," 2.338,99 ",2798821013,CFD," 0,00 "
28/08/2024 06:52:54,Position closed,NSDQ100/USD," 1.505,14 ",1.532459," 5,15 "," 4.144,11 "," 3.844,13 ",2798821013,CFD," 0,00 "
28/08/2024 06:53:27,Open Position,NSDQ100/USD," 1.600,00 ",1.634081," 0,00 "," 4.144,11 "," 2.244,13 ",2798821783,CFD," 0,00 "
28/08/2024 07:33:20,Position closed,NSDQ100/USD," 1.578,69 ",1.634081,"(21,31)"," 4.122,80 "," 3.822,82 ",2798821783,CFD," 0,00 "
28/08/2024 07:37:53,Open Position,NSDQ100/USD," 499,99 ",0.511055," 0,00 "," 4.122,80 "," 3.322,83 ",2798858904,CFD," 0,00 "
28/08/2024 07:48:24,Position closed,NSDQ100/USD," 495,58 ",0.511055,"(4,41)"," 4.118,39 "," 3.818,41 ",2798858904,CFD," 0,00 "
28/08/2024 07:51:59,Open Position,NSDQ100/USD," 959,99 ",0.981175," 0,00 "," 4.118,39 "," 2.858,42 ",2798871499,CFD," 0,00 "
28/08/2024 08:11:15,Open Position,NSDQ100/USD," 499,99 ",0.511070," 0,00 "," 4.118,39 "," 2.358,43 ",2798891719,CFD," 0,00 "
28/08/2024 08:12:43,Open Position,NSDQ100/USD," 590,00 ",0.603143," 0,00 "," 4.118,39 "," 1.768,43 ",2798891935,CFD," 0,00 "
28/08/2024 08:19:40,Position closed,NSDQ100/USD," 964,47 ",0.981175," 4,48 "," 4.122,87 "," 2.732,90 ",2798871499,CFD," 0,00 "
28/08/2024 08:19:40,Position closed,NSDQ100/USD," 595,29 ",0.603143," 5,29 "," 4.128,16 "," 3.328,19 ",2798891935,CFD," 0,00 "
28/08/2024 08:19:40,Position closed,NSDQ100/USD," 503,14 ",0.511070," 3,15 "," 4.131,31 "," 3.831,33 ",2798891719,CFD," 0,00 "
28/08/2024 08:23:11,Open Position,NSDQ100/USD," 100,00 ",0.102144," 0,00 "," 4.131,31 "," 3.731,33 ",2798894616,CFD," 0,00 "
28/08/2024 08:31:15,Position closed,NSDQ100/USD," 100,84 ",0.102144," 0,84 "," 4.132,15 "," 3.832,17 ",2798894616,CFD," 0,00 "
28/08/2024 08:52:13,Open Position,NSDQ100/USD," 979,99 ",0.978649," 0,00 "," 4.132,15 "," 2.872,18 ",2798904379,CFD," 0,00 "
28/08/2024 09:25:27,Open Position,NSDQ100/USD," 519,99 ",0.509809," 0,00 "," 4.132,15 "," 2.372,19 ",2798912582,CFD," 0,00 "
28/08/2024 09:34:52,Open Position,NSDQ100/USD," 600,00 ",0.611999," 0,00 "," 4.132,15 "," 1.772,19 ",2798914341,CFD," 0,00 "
28/08/2024 09:41:12,Open Position,NSDQ100/USD," 100,00 ",0.102021," 0,00 "," 4.132,15 "," 1.672,19 ",2798915210,CFD," 0,00 "
28/08/2024 09:43:52,Open Position,NSDQ100/USD," 100,00 ",0.102049," 0,00 "," 4.132,15 "," 1.572,19 ",2798915532,CFD," 0,00 "
28/08/2024 09:52:09,Open Position,NSDQ100/USD," 50,00 ",0.051019," 0,00 "," 4.132,15 "," 1.522,19 ",2798917443,CFD," 0,00 "
28/08/2024 10:11:20,Open Position,NSDQ100/USD," 499,99 ",0.510225," 0,00 "," 4.132,15 "," 1.022,20 ",2798920969,CFD," 0,00 "
28/08/2024 11:09:19,Open Position,NSDQ100/USD," 260,00 ",0.265492," 0,00 "," 4.132,15 "," 762,20 ",2798939747,CFD," 0,00 "
28/08/2024 11:45:00,Open Position,NSDQ100/USD," 300,00 ",0.306424," 0,00 "," 4.132,15 "," 462,20 ",2798945865,CFD," 0,00 "
28/08/2024 11:50:10,Open Position,NSDQ100/USD," 119,99 ",0.122634," 0,00 "," 4.132,15 "," 342,21 ",2798946738,CFD," 0,00 "
28/08/2024 11:52:40,Open Position,NSDQ100/USD," 299,99 ",0.204492," 0,00 "," 4.132,15 "," 142,22 ",2798947054,CFD," 0,00 "
28/08/2024 11:57:21,Open Position,NSDQ100/USD," 65,00 ",0.051138," 0,00 "," 4.132,15 "," 92,22 ",2798948835,CFD," 0,00 "
28/08/2024 14:09:59,Deposit Conversion Fee,-,"(30,14)",-," 0,00 "," 5.130,64 "," 1.090,71 ",-,-," 0,00 "
28/08/2024 14:09:59,Deposit,4600.00 USDRON CreditCard," 998,49 ",-," 998,49 "," 5.130,64 "," 1.090,71 ",-,-," 0,00 "
28/08/2024 14:10:54,Open Position,NSDQ100/USD," 1.295,35 ",1.119968," 0,00 "," 5.130,64 "," 0,00 ",2799138807,CFD," 0,00 "
28/08/2024 15:33:54,Deposit Conversion Fee,-,"(19,68)",-," 0,00 "," 5.782,22 "," 651,58 ",-,-," 0,00 "
28/08/2024 15:33:54,Deposit,3000.00 USDRON CreditCard," 651,58 ",-," 651,58 "," 5.782,22 "," 651,58 ",-,-," 0,00 "
28/08/2024 15:36:23,Open Position,NSDQ100/USD," 650,00 ",0.620642," 0,00 "," 5.782,22 "," 51,58 ",2799341231,CFD," 0,00 "
28/08/2024 15:36:59,Position closed,TSLA/USD," 82,75 ",2.353182,"(17,24)"," 5.764,98 "," 134,33 ",2798045675,CFD," 0,00 "
28/08/2024 15:37:06,Position closed,TSLA/USD," 164,69 ",4.702596,"(35,30)"," 5.729,68 "," 299,02 ",2798048955,CFD," 0,00 "
28/08/2024 15:37:27,Open Position,NSDQ100/USD," 275,00 ",0.258692," 0,00 "," 5.729,68 "," 49,02 ",2799342043,CFD," 0,00 "
28/08/2024 21:18:57,Edit Stop Loss,-,"(20,00)",-," 0,00 "," 5.729,68 "," 29,02 ",2798904379,-," 0,00 "
28/08/2024 21:19:23,Edit Stop Loss,-,"(20,00)",-," 0,00 "," 5.729,68 "," 9,02 ",2798912582,-," 0,00 "
28/08/2024 22:42:07,Position closed,NSDQ100/USD," 299,88 ",0.611999,"(300,12)"," 5.429,56 "," 308,90 ",2798914341,CFD," 0,00 "
28/08/2024 22:42:07,Position closed,NSDQ100/USD," 49,61 ",0.102021,"(50,39)"," 5.379,17 "," 358,51 ",2798915210,CFD," 0,00 "
28/08/2024 22:42:07,Position closed,NSDQ100/USD," 24,97 ",0.051019,"(25,03)"," 5.354,14 "," 383,48 ",2798917443,CFD," 0,00 "
28/08/2024 22:42:11,Position closed,NSDQ100/USD," 246,31 ",0.510225,"(253,68)"," 5.100,46 "," 629,79 ",2798920969,CFD," 0,00 "
28/08/2024 22:42:11,Position closed,NSDQ100/USD," 474,13 ",0.978649,"(505,86)"," 4.594,60 "," 1.103,92 ",2798904379,CFD," 0,00 "
28/08/2024 22:42:11,Position closed,NSDQ100/USD," 49,34 ",0.102049,"(50,66)"," 4.543,94 "," 1.153,26 ",2798915532,CFD," 0,00 "
28/08/2024 22:45:44,Position closed,NSDQ100/USD," 129,96 ",0.265492,"(130,04)"," 4.413,90 "," 1.283,22 ",2798939747,CFD," 0,00 "
28/08/2024 22:46:07,Position closed,NSDQ100/USD," 148,14 ",0.306424,"(151,86)"," 4.262,04 "," 1.431,36 ",2798945865,CFD," 0,00 "
28/08/2024 22:46:07,Position closed,NSDQ100/USD," 249,74 ",0.509809,"(270,25)"," 3.991,79 "," 1.681,10 ",2798912582,CFD," 0,00 "
28/08/2024 22:46:07,Position closed,NSDQ100/USD," 59,83 ",0.122634,"(60,16)"," 3.931,63 "," 1.740,93 ",2798946738,CFD," 0,00 "
28/08/2024 23:24:54,Edit Stop Loss,-,"(54,64)",-," 0,00 "," 3.931,63 "," 1.686,29 ",2799138807,-," 0,00 "
28/08/2024 23:25:36,Edit Stop Loss,-,"(15,00)",-," 0,00 "," 3.931,63 "," 1.671,29 ",2798948835,-," 0,00 "
28/08/2024 23:25:50,Edit Stop Loss,-,"(100,00)",-," 0,00 "," 3.931,63 "," 1.571,29 ",2798947054,-," 0,00 "
28/08/2024 23:26:00,Edit Stop Loss,-,"(25,00)",-," 0,00 "," 3.931,63 "," 1.546,29 ",2799342043,-," 0,00 "
28/08/2024 23:26:09,Edit Stop Loss,-,"(50,00)",-," 0,00 "," 3.931,63 "," 1.496,29 ",2799341231,-," 0,00 "
28/08/2024 23:26:20,Edit Stop Loss,-,"(150,00)",-," 0,00 "," 3.931,63 "," 1.346,29 ",2799138807,-," 0,00 "
28/08/2024 23:27:06,Open Position,NSDQ100/USD," 1.100,00 ",1.150234," 0,00 "," 3.931,63 "," 246,29 ",2799541934,CFD," 0,00 "
29/08/2024 00:48:59,Overnight fee,Daily,"(1,08)",-,"(1,08)"," 3.930,55 "," 245,21 ",2798947054,CFD," 0,00 "
29/08/2024 00:48:59,Overnight fee,Daily,"(0,54)",-,"(0,54)"," 3.930,01 "," 244,67 ",2798915532,CFD," 0,00 "
29/08/2024 00:48:59,Overnight fee,Daily,"(0,27)",-,"(0,27)"," 3.929,74 "," 244,40 ",2798948835,CFD," 0,00 "
29/08/2024 00:48:59,Overnight fee,Daily,"(0,65)",-,"(0,65)"," 3.929,09 "," 243,75 ",2798946738,CFD," 0,00 "
29/08/2024 00:48:59,Overnight fee,Daily,"(2,69)",-,"(2,69)"," 3.926,40 "," 241,06 ",2798912582,CFD," 0,00 "
29/08/2024 00:48:59,Overnight fee,Daily,"(1,62)",-,"(1,62)"," 3.924,78 "," 239,44 ",2798945865,CFD," 0,00 "
29/08/2024 00:48:59,Overnight fee,Daily,"(1,40)",-,"(1,40)"," 3.923,38 "," 238,04 ",2798939747,CFD," 0,00 "
29/08/2024 00:48:59,Overnight fee,Daily,"(3,28)",-,"(3,28)"," 3.920,10 "," 234,76 ",2799341231,CFD," 0,00 "
29/08/2024 00:48:59,Overnight fee,Daily,"(5,91)",-,"(5,91)"," 3.914,19 "," 228,85 ",2799138807,CFD," 0,00 "
29/08/2024 00:48:59,Overnight fee,Daily,"(1,37)",-,"(1,37)"," 3.912,82 "," 227,48 ",2799342043,CFD," 0,00 "
29/08/2024 00:48:59,Overnight fee,Daily,"(5,17)",-,"(5,17)"," 3.907,65 "," 222,31 ",2798904379,CFD," 0,00 "
29/08/2024 00:48:59,Overnight fee,Daily,"(2,69)",-,"(2,69)"," 3.904,96 "," 219,62 ",2798920969,CFD," 0,00 "
29/08/2024 00:48:59,Overnight fee,Daily,"(0,27)",-,"(0,27)"," 3.904,69 "," 219,35 ",2798917443,CFD," 0,00 "
29/08/2024 00:48:59,Overnight fee,Daily,"(0,54)",-,"(0,54)"," 3.904,15 "," 218,81 ",2798915210,CFD," 0,00 "
29/08/2024 00:48:59,Overnight fee,Daily,"(3,23)",-,"(3,23)"," 3.900,92 "," 215,58 ",2798914341,CFD," 0,00 "
29/08/2024 07:54:59,Open Position,NSDQ100/USD," 199,99 ",0.207074," 0,00 "," 3.900,92 "," 15,59 ",2799639419,CFD," 0,00 "
29/08/2024 13:33:54,Position closed,NSDQ100/USD," 754,08 ",0.620642," 104,08 "," 4.005,00 "," 769,67 ",2799341231,CFD," 0,00 "
29/08/2024 13:33:54,Position closed,NSDQ100/USD," 62,33 ",0.051138,"(2,67)"," 4.002,33 "," 832,00 ",2798948835,CFD," 0,00 "
29/08/2024 13:33:54,Position closed,NSDQ100/USD," 1.323,33 ",1.119968," 27,98 "," 4.030,31 "," 2.155,33 ",2799138807,CFD," 0,00 "
29/08/2024 13:33:54,Position closed,NSDQ100/USD," 288,09 ",0.204492,"(11,90)"," 4.018,41 "," 2.443,42 ",2798947054,CFD," 0,00 "
29/08/2024 13:33:54,Position closed,NSDQ100/USD," 238,45 ",0.207074," 38,46 "," 4.056,87 "," 2.681,87 ",2799639419,CFD," 0,00 "
29/08/2024 13:33:54,Position closed,NSDQ100/USD," 320,14 ",0.258692," 45,14 "," 4.102,01 "," 3.002,01 ",2799342043,CFD," 0,00 "
29/08/2024 13:33:54,Position closed,NSDQ100/USD," 1.532,43 ",1.150234," 432,43 "," 4.534,44 "," 4.534,44 ",2799541934,CFD," 0,00 "
29/08/2024 13:35:19,Open Position,NSDQ100/USD," 459,91 ",0.470951," 0,00 "," 4.534,44 "," 4.074,53 ",2799783301,CFD," 0,00 "
29/08/2024 13:35:58,Open Position,NSDQ100/USD," 999,99 ",1.023875," 0,00 "," 4.534,44 "," 3.074,54 ",2799784885,CFD," 0,00 "
29/08/2024 13:36:24,Open Position,NSDQ100/USD," 769,99 ",0.788452," 0,00 "," 4.534,44 "," 2.304,55 ",2799786144,CFD," 0,00 "
29/08/2024 13:37:03,Position closed,NSDQ100/USD," 1.015,20 ",1.023875," 15,21 "," 4.549,65 "," 3.319,75 ",2799784885,CFD," 0,00 "
29/08/2024 13:37:03,Position closed,NSDQ100/USD," 467,90 ",0.470951," 7,99 "," 4.557,64 "," 3.787,65 ",2799783301,CFD," 0,00 "
29/08/2024 13:37:03,Position closed,NSDQ100/USD," 783,05 ",0.788452," 13,06 "," 4.570,70 "," 4.570,70 ",2799786144,CFD," 0,00 "
29/08/2024 13:37:31,Open Position,NSDQ100/USD," 1.499,89 ",1.535515," 0,00 "," 4.570,70 "," 3.070,81 ",2799788171,CFD," 0,00 "
29/08/2024 13:38:03,Open Position,NSDQ100/USD," 770,00 ",0.788836," 0,00 "," 4.570,70 "," 2.300,81 ",2799789017,CFD," 0,00 "
29/08/2024 13:38:44,Position closed,NSDQ100/USD," 1.493,26 ",1.535515,"(6,63)"," 4.564,07 "," 3.794,07 ",2799788171,CFD," 0,00 "
29/08/2024 13:38:44,Position closed,NSDQ100/USD," 777,31 ",0.788836," 7,31 "," 4.571,38 "," 4.571,38 ",2799789017,CFD," 0,00 "
29/08/2024 13:39:03,Open Position,NSDQ100/USD," 999,99 ",1.024531," 0,00 "," 4.571,38 "," 3.571,39 ",2799790646,CFD," 0,00 "
29/08/2024 13:39:16,Open Position,NSDQ100/USD," 999,99 ",1.024930," 0,00 "," 4.571,38 "," 2.571,40 ",2799791157,CFD," 0,00 "
29/08/2024 13:39:41,Open Position,NSDQ100/USD," 299,99 ",0.307493," 0,00 "," 4.571,38 "," 2.271,41 ",2799791815,CFD," 0,00 "
29/08/2024 13:40:13,Position closed,NSDQ100/USD," 1.015,95 ",1.024930," 15,96 "," 4.587,34 "," 3.287,36 ",2799791157,CFD," 0,00 "
29/08/2024 13:40:13,Position closed,NSDQ100/USD," 305,05 ",0.307493," 5,06 "," 4.592,40 "," 3.592,41 ",2799791815,CFD," 0,00 "
29/08/2024 13:40:13,Position closed,NSDQ100/USD," 1.008,16 ",1.024531," 8,17 "," 4.600,57 "," 4.600,57 ",2799790646,CFD," 0,00 "
29/08/2024 13:40:34,Open Position,NSDQ100/USD," 999,99 ",1.023719," 0,00 "," 4.600,57 "," 3.600,58 ",2799792960,CFD," 0,00 "
29/08/2024 13:40:56,Open Position,NSDQ100/USD," 910,00 ",0.932070," 0,00 "," 4.600,57 "," 2.690,58 ",2799793532,CFD," 0,00 "
29/08/2024 13:41:20,Open Position,NSDQ100/USD," 679,99 ",0.696634," 0,00 "," 4.600,57 "," 2.010,59 ",2799793992,CFD," 0,00 "
29/08/2024 13:41:39,Open Position,NSDQ100/USD," 999,98 ",1.025282," 0,00 "," 4.600,57 "," 1.010,61 ",2799794287,CFD," 0,00 "
29/08/2024 13:42:05,Open Position,NSDQ100/USD," 599,99 ",0.615696," 0,00 "," 4.600,57 "," 410,62 ",2799794837,CFD," 0,00 "
29/08/2024 13:46:04,Open Position,NSDQ100/USD," 109,99 ",0.112757," 0,00 "," 4.600,57 "," 300,63 ",2799801233,CFD," 0,00 "
29/08/2024 13:48:06,Position closed,NSDQ100/USD," 1.027,93 ",1.025282," 27,95 "," 4.628,52 "," 1.328,56 ",2799794287,CFD," 0,00 "
29/08/2024 13:48:06,Position closed,NSDQ100/USD," 916,95 ",0.932070," 6,95 "," 4.635,47 "," 2.245,51 ",2799793532,CFD," 0,00 "
29/08/2024 13:48:06,Position closed,NSDQ100/USD," 112,58 ",0.112757," 2,59 "," 4.638,06 "," 2.358,09 ",2799801233,CFD," 0,00 "
29/08/2024 13:48:06,Position closed,NSDQ100/USD," 687,97 ",0.696634," 7,98 "," 4.646,04 "," 3.046,06 ",2799793992,CFD," 0,00 "
29/08/2024 13:48:06,Position closed,NSDQ100/USD," 997,20 ",1.023719,"(2,79)"," 4.643,25 "," 4.043,26 ",2799792960,CFD," 0,00 "
29/08/2024 13:48:06,Position closed,NSDQ100/USD," 626,94 ",0.615696," 26,95 "," 4.670,20 "," 4.670,20 ",2799794837,CFD," 0,00 "
29/08/2024 13:48:41,Open Position,NSDQ100/USD," 469,99 ",0.480842," 0,00 "," 4.670,20 "," 4.200,21 ",2799877898,CFD," 0,00 "
29/08/2024 13:49:31,Position closed,NSDQ100/USD," 473,92 ",0.480842," 3,93 "," 4.674,13 "," 4.674,13 ",2799877898,CFD," 0,00 "
29/08/2024 13:50:28,Open Position,NSDQ100/USD," 999,99 ",1.024064," 0,00 "," 4.674,13 "," 3.674,14 ",2799898426,CFD," 0,00 "
29/08/2024 13:50:39,Open Position,NSDQ100/USD," 920,00 ",0.942515," 0,00 "," 4.674,13 "," 2.754,14 ",2799898830,CFD," 0,00 "
29/08/2024 13:50:58,Open Position,NSDQ100/USD," 689,99 ",0.707147," 0,00 "," 4.674,13 "," 2.064,15 ",2799899199,CFD," 0,00 "
29/08/2024 13:51:13,Open Position,NSDQ100/USD," 999,98 ",1.025882," 0,00 "," 4.674,13 "," 1.064,17 ",2799907024,CFD," 0,00 "
29/08/2024 13:52:10,Open Position,NSDQ100/USD," 499,99 ",0.512751," 0,00 "," 4.674,13 "," 564,18 ",2799933783,CFD," 0,00 "
29/08/2024 13:53:04,Open Position,NSDQ100/USD," 299,99 ",0.307617," 0,00 "," 4.674,13 "," 264,19 ",2799936372,CFD," 0,00 "
29/08/2024 13:54:52,Position closed,NSDQ100/USD," 692,30 ",0.707147," 2,31 "," 4.676,44 "," 956,49 ",2799899199,CFD," 0,00 "
29/08/2024 13:54:52,Position closed,NSDQ100/USD," 916,30 ",0.942515,"(3,70)"," 4.672,74 "," 1.872,79 ",2799898830,CFD," 0,00 "
29/08/2024 13:54:52,Position closed,NSDQ100/USD," 1.023,76 ",1.025882," 23,78 "," 4.696,52 "," 2.896,55 ",2799907024,CFD," 0,00 "
29/08/2024 13:54:52,Position closed,NSDQ100/USD," 304,32 ",0.307617," 4,33 "," 4.700,85 "," 3.200,87 ",2799936372,CFD," 0,00 "
29/08/2024 13:54:52,Position closed,NSDQ100/USD," 988,49 ",1.024064,"(11,50)"," 4.689,35 "," 4.189,36 ",2799898426,CFD," 0,00 "
29/08/2024 13:54:52,Position closed,NSDQ100/USD," 508,28 ",0.512751," 8,29 "," 4.697,64 "," 4.697,64 ",2799933783,CFD," 0,00 "
29/08/2024 13:55:14,Open Position,NSDQ100/USD," 499,99 ",0.512029," 0,00 "," 4.697,64 "," 4.197,65 ",2799939504,CFD," 0,00 "
29/08/2024 13:55:50,Open Position,NSDQ100/USD," 499,99 ",0.512320," 0,00 "," 4.697,64 "," 3.697,66 ",2799940316,CFD," 0,00 "
29/08/2024 13:56:01,Position closed,NSDQ100/USD," 522,10 ",0.512320," 22,11 "," 4.719,75 "," 4.219,76 ",2799940316,CFD," 0,00 "
29/08/2024 13:56:01,Position closed,NSDQ100/USD," 516,41 ",0.512029," 16,42 "," 4.736,17 "," 4.736,17 ",2799939504,CFD," 0,00 "
29/08/2024 13:56:15,Open Position,NSDQ100/USD," 479,99 ",0.490090," 0,00 "," 4.736,17 "," 4.256,18 ",2799941063,CFD," 0,00 "
29/08/2024 13:57:04,Open Position,NSDQ100/USD," 600,00 ",0.613051," 0,00 "," 4.736,17 "," 3.656,18 ",2799942318,CFD," 0,00 "
29/08/2024 13:57:43,Open Position,NSDQ100/USD," 400,00 ",0.408527," 0,00 "," 4.736,17 "," 3.256,18 ",2799943270,CFD," 0,00 "
29/08/2024 13:58:48,Open Position,NSDQ100/USD," 499,99 ",0.510883," 0,00 "," 4.736,17 "," 2.756,19 ",2799944981,CFD," 0,00 "
29/08/2024 13:59:34,Position closed,NSDQ100/USD," 401,25 ",0.408527," 1,25 "," 4.737,42 "," 3.157,44 ",2799943270,CFD," 0,00 "
29/08/2024 13:59:34,Position closed,NSDQ100/USD," 606,96 ",0.613051," 6,96 "," 4.744,38 "," 3.764,40 ",2799942318,CFD," 0,00 "
29/08/2024 13:59:34,Position closed,NSDQ100/USD," 478,70 ",0.490090,"(1,29)"," 4.743,09 "," 4.243,10 ",2799941063,CFD," 0,00 "
29/08/2024 13:59:34,Position closed,NSDQ100/USD," 505,95 ",0.510883," 5,96 "," 4.749,05 "," 4.749,05 ",2799944981,CFD," 0,00 "
29/08/2024 13:59:47,Open Position,NSDQ100/USD," 479,99 ",0.490335," 0,00 "," 4.749,05 "," 4.269,06 ",2799946125,CFD," 0,00 "
29/08/2024 14:00:09,Position closed,NSDQ100/USD," 498,06 ",0.490335," 18,07 "," 4.767,12 "," 4.767,12 ",2799946125,CFD," 0,00 "
29/08/2024 14:00:44,Open Position,NSDQ100/USD," 479,99 ",0.489655," 0,00 "," 4.767,12 "," 4.287,13 ",2799949811,CFD," 0,00 "
29/08/2024 14:01:10,Open Position,NSDQ100/USD," 1.100,00 ",1.122035," 0,00 "," 4.767,12 "," 3.187,13 ",2799950504,CFD," 0,00 "
29/08/2024 14:01:48,Open Position,NSDQ100/USD," 799,99 ",0.816138," 0,00 "," 4.767,12 "," 2.387,14 ",2799951597,CFD," 0,00 "
29/08/2024 14:02:18,Open Position,NSDQ100/USD," 600,00 ",0.612228," 0,00 "," 4.767,12 "," 1.787,14 ",2799952317,CFD," 0,00 "
29/08/2024 14:03:03,Open Position,NSDQ100/USD," 449,99 ",0.459743," 0,00 "," 4.767,12 "," 1.337,15 ",2799953394,CFD," 0,00 "
29/08/2024 14:03:21,Open Position,NSDQ100/USD," 339,99 ",0.347493," 0,00 "," 4.767,12 "," 997,16 ",2799953672,CFD," 0,00 "
29/08/2024 14:05:22,Open Position,NSDQ100/USD," 499,99 ",0.511072," 0,00 "," 4.767,12 "," 497,17 ",2799957145,CFD," 0,00 "
29/08/2024 14:06:30,Open Position,NSDQ100/USD," 299,99 ",0.306873," 0,00 "," 4.767,12 "," 197,18 ",2799958847,CFD," 0,00 "
29/08/2024 14:18:05,Open Position,NSDQ100/USD," 149,99 ",0.153715," 0,00 "," 4.767,12 "," 47,19 ",2799973778,CFD," 0,00 "
29/08/2024 14:29:14,Position closed,NSDQ100/USD," 152,69 ",0.153715," 2,70 "," 4.769,82 "," 199,88 ",2799973778,CFD," 0,00 "
29/08/2024 14:34:44,Position closed,NSDQ100/USD," 303,08 ",0.306873," 3,09 "," 4.772,91 "," 502,96 ",2799958847,CFD," 0,00 "
29/08/2024 14:36:08,Position closed,NSDQ100/USD," 341,02 ",0.347493," 1,03 "," 4.773,94 "," 843,98 ",2799953672,CFD," 0,00 "
29/08/2024 14:36:15,Position closed,NSDQ100/USD," 502,07 ",0.511072," 2,08 "," 4.776,02 "," 1.346,05 ",2799957145,CFD," 0,00 "
29/08/2024 14:48:56,Position closed,NSDQ100/USD," 607,08 ",0.612228," 7,08 "," 4.783,10 "," 1.953,13 ",2799952317,CFD," 0,00 "
29/08/2024 14:48:56,Position closed,NSDQ100/USD," 483,15 ",0.489655," 3,16 "," 4.786,26 "," 2.436,28 ",2799949811,CFD," 0,00 "
29/08/2024 14:48:56,Position closed,NSDQ100/USD," 806,16 ",0.816138," 6,17 "," 4.792,43 "," 3.242,44 ",2799951597,CFD," 0,00 "
29/08/2024 14:48:56,Position closed,NSDQ100/USD," 1.105,45 ",1.122035," 5,45 "," 4.797,88 "," 4.347,89 ",2799950504,CFD," 0,00 "
29/08/2024 14:48:56,Position closed,NSDQ100/USD," 466,57 ",0.459743," 16,58 "," 4.814,46 "," 4.814,46 ",2799953394,CFD," 0,00 "
29/08/2024 14:52:40,Open Position,NSDQ100/USD," 489,99 ",0.499408," 0,00 "," 4.814,46 "," 4.324,47 ",2800031965,CFD," 0,00 "
29/08/2024 15:19:13,Open Position,NSDQ100/USD," 499,99 ",0.510745," 0,00 "," 4.814,46 "," 3.824,48 ",2800138895,CFD," 0,00 "
29/08/2024 15:28:16,Open Position,NSDQ100/USD," 299,99 ",0.306701," 0,00 "," 4.814,46 "," 3.524,49 ",2800146867,CFD," 0,00 "
29/08/2024 15:31:09,Position closed,NSDQ100/USD," 305,59 ",0.306701," 5,60 "," 4.820,06 "," 3.830,08 ",2800146867,CFD," 0,00 "
29/08/2024 15:36:38,Open Position,NSDQ100/USD," 499,99 ",0.510962," 0,00 "," 4.820,06 "," 3.330,09 ",2800167272,CFD," 0,00 "
29/08/2024 15:45:55,Open Position,NSDQ100/USD," 99,99 ",0.102191," 0,00 "," 4.820,06 "," 3.230,10 ",2800172671,CFD," 0,00 "
29/08/2024 16:02:52,Position closed,NSDQ100/USD," 508,86 ",0.510962," 8,87 "," 4.828,93 "," 3.738,96 ",2800167272,CFD," 0,00 "
29/08/2024 16:02:52,Position closed,NSDQ100/USD," 472,54 ",0.499408,"(17,45)"," 4.811,48 "," 4.211,50 ",2800031965,CFD," 0,00 "
29/08/2024 16:02:52,Position closed,NSDQ100/USD," 504,72 ",0.510745," 4,73 "," 4.816,21 "," 4.716,22 ",2800138895,CFD," 0,00 "
29/08/2024 16:02:52,Position closed,NSDQ100/USD," 101,74 ",0.102191," 1,75 "," 4.817,96 "," 4.817,96 ",2800172671,CFD," 0,00 "
29/08/2024 16:05:11,Open Position,NSDQ100/USD," 50,00 ",0.051024," 0,00 "," 4.817,96 "," 4.767,96 ",2800184355,CFD," 0,00 "
29/08/2024 16:07:37,Position closed,NSDQ100/USD," 50,48 ",0.051024," 0,48 "," 4.818,44 "," 4.818,44 ",2800184355,CFD," 0,00 "
29/08/2024 16:08:37,Open Position,NSDQ100/USD," 99,99 ",0.101970," 0,00 "," 4.818,44 "," 4.718,45 ",2800186455,CFD," 0,00 "
29/08/2024 16:11:16,Position closed,NSDQ100/USD," 100,11 ",0.101970," 0,12 "," 4.818,56 "," 4.818,56 ",2800186455,CFD," 0,00 "
29/08/2024 16:18:32,Open Position,NSDQ100/USD," 400,00 ",0.408262," 0,00 "," 4.818,56 "," 4.418,56 ",2800192192,CFD," 0,00 "
29/08/2024 16:20:48,Position closed,NSDQ100/USD," 400,51 ",0.408262," 0,51 "," 4.819,07 "," 4.819,07 ",2800192192,CFD," 0,00 "
29/08/2024 16:21:42,Open Position,NSDQ100/USD," 99,99 ",0.102035," 0,00 "," 4.819,07 "," 4.719,08 ",2800193845,CFD," 0,00 "
29/08/2024 16:25:46,Position closed,NSDQ100/USD," 100,99 ",0.102035," 1,00 "," 4.820,07 "," 4.820,07 ",2800193845,CFD," 0,00 "
29/08/2024 16:27:53,Open Position,NSDQ100/USD," 999,99 ",1.020297," 0,00 "," 4.820,07 "," 3.820,08 ",2800197485,CFD," 0,00 "
29/08/2024 16:29:47,Position closed,NSDQ100/USD," 1.002,60 ",1.020297," 2,61 "," 4.822,68 "," 4.822,68 ",2800197485,CFD," 0,00 "
29/08/2024 16:31:26,Open Position,NSDQ100/USD," 489,99 ",0.499716," 0,00 "," 4.822,68 "," 4.332,69 ",2800199921,CFD," 0,00 "
29/08/2024 16:32:31,Position closed,NSDQ100/USD," 491,72 ",0.499716," 1,73 "," 4.824,41 "," 4.824,41 ",2800199921,CFD," 0,00 "
29/08/2024 16:36:10,Open Position,NSDQ100/USD," 489,98 ",0.499482," 0,00 "," 4.824,41 "," 4.334,43 ",2800203352,CFD," 0,00 "
29/08/2024 16:37:42,Position closed,NSDQ100/USD," 485,61 ",0.499482,"(4,37)"," 4.820,04 "," 4.820,04 ",2800203352,CFD," 0,00 "
29/08/2024 16:41:22,Open Position,NSDQ100/USD," 50,00 ",0.050974," 0,00 "," 4.820,04 "," 4.770,04 ",2800207343,CFD," 0,00 "
29/08/2024 16:52:47,Open Position,NSDQ100/USD," 499,98 ",0.510802," 0,00 "," 4.820,04 "," 4.270,06 ",2800216281,CFD," 0,00 "
29/08/2024 16:57:30,Position closed,NSDQ100/USD," 506,50 ",0.510802," 6,52 "," 4.826,56 "," 4.776,56 ",2800216281,CFD," 0,00 "
29/08/2024 16:57:37,Position closed,NSDQ100/USD," 48,46 ",0.050974,"(1,54)"," 4.825,02 "," 4.825,02 ",2800207343,CFD," 0,00 "
29/08/2024 17:02:32,Open Position,NSDQ100/USD," 489,99 ",0.500574," 0,00 "," 4.825,02 "," 4.335,03 ",2800222606,CFD," 0,00 "
29/08/2024 17:11:56,Open Position,NSDQ100/USD," 1.100,00 ",1.125514," 0,00 "," 4.825,02 "," 3.235,03 ",2800227529,CFD," 0,00 "
29/08/2024 17:24:02,Position closed,NSDQ100/USD," 481,86 ",0.500574,"(8,13)"," 4.816,89 "," 3.716,89 ",2800222606,CFD," 0,00 "
29/08/2024 17:24:02,Position closed,NSDQ100/USD," 1.116,51 ",1.125514," 16,51 "," 4.833,40 "," 4.833,40 ",2800227529,CFD," 0,00 "
29/08/2024 17:29:44,Open Position,NSDQ100/USD," 489,99 ",0.501122," 0,00 "," 4.833,40 "," 4.343,41 ",2800235162,CFD," 0,00 "
29/08/2024 17:31:22,Position closed,NSDQ100/USD," 491,18 ",0.501122," 1,19 "," 4.834,59 "," 4.834,59 ",2800235162,CFD," 0,00 "
29/08/2024 17:31:54,Open Position,XAU/USD," 489,99 ",3.878039," 0,00 "," 4.834,59 "," 4.344,60 ",2800236137,CFD," 0,00 "
29/08/2024 17:32:11,Open Position,XAU/USD," 1.100,00 ",8.705148," 0,00 "," 4.834,59 "," 3.244,60 ",2800236294,CFD," 0,00 "
29/08/2024 17:41:50,Open Position,XAU/USD," 1.999,99 ",15.837193," 0,00 "," 4.834,59 "," 1.244,61 ",2800240370,CFD," 0,00 "
29/08/2024 17:47:39,Open Position,XAU/USD," 320,00 ",2.536220," 0,00 "," 4.834,59 "," 924,61 ",2800242063,CFD," 0,00 "
29/08/2024 17:53:21,Open Position,XAU/USD," 800,00 ",6.337261," 0,00 "," 4.834,59 "," 124,61 ",2800244753,CFD," 0,00 "
29/08/2024 17:55:13,Position closed,XAU/USD," 1.113,93 ",8.705148," 13,93 "," 4.848,52 "," 1.238,54 ",2800236294,CFD," 0,00 "
29/08/2024 17:55:13,Position closed,XAU/USD," 495,46 ",3.878039," 5,47 "," 4.853,99 "," 1.734,00 ",2800236137,CFD," 0,00 "
29/08/2024 17:55:13,Position closed,XAU/USD," 794,36 ",6.337261,"(5,64)"," 4.848,35 "," 2.528,36 ",2800244753,CFD," 0,00 "
29/08/2024 17:55:13,Position closed,XAU/USD," 314,42 ",2.536220,"(5,58)"," 4.842,77 "," 2.842,78 ",2800242063,CFD," 0,00 "
29/08/2024 17:55:13,Position closed,XAU/USD," 2.000,94 ",15.837193," 0,95 "," 4.843,72 "," 4.843,72 ",2800240370,CFD," 0,00 "
29/08/2024 17:56:40,Open Position,XAU/USD," 1.999,99 ",15.840894," 0,00 "," 4.843,72 "," 2.843,73 ",2800246682,CFD," 0,00 "
29/08/2024 17:56:52,Open Position,XAU/USD," 1.499,99 ",11.880717," 0,00 "," 4.843,72 "," 1.343,74 ",2800246775,CFD," 0,00 "
29/08/2024 19:17:52,Open Position,XAU/USD," 499,98 ",3.962482," 0,00 "," 4.843,72 "," 843,76 ",2800292935,CFD," 0,00 "
29/08/2024 19:39:02,Position closed,XAU/USD," 1.521,02 ",11.880717," 21,03 "," 4.864,75 "," 2.364,78 ",2800246775,CFD," 0,00 "
29/08/2024 19:39:02,Position closed,XAU/USD," 2.028,19 ",15.840894," 28,20 "," 4.892,95 "," 4.392,97 ",2800246682,CFD," 0,00 "
29/08/2024 19:39:02,Position closed,XAU/USD," 501,13 ",3.962482," 1,15 "," 4.894,10 "," 4.894,10 ",2800292935,CFD," 0,00 "
29/08/2024 19:44:43,Open Position,XAU/USD," 4.000,00 ",31.719221," 0,00 "," 4.894,10 "," 894,10 ",2800316440,CFD," 0,00 "
29/08/2024 22:17:36,Position closed,XAU/USD," 4.016,18 ",31.719221," 16,18 "," 4.910,28 "," 4.910,28 ",2800316440,CFD," 0,00 "
29/08/2024 22:18:14,Open Position,NSDQ100/USD," 49,99 ",0.051605," 0,00 "," 4.910,28 "," 4.860,29 ",2800333780,CFD," 0,00 "
29/08/2024 22:18:55,Open Position,XAU/USD," 75,00 ",0.595001," 0,00 "," 4.910,28 "," 4.785,29 ",2800333817,CFD," 0,00 "
29/08/2024 23:55:41,Position closed,XAU/USD," 75,67 ",0.595001," 0,67 "," 4.910,95 "," 4.860,96 ",2800333817,CFD," 0,00 "
29/08/2024 23:55:47,Position closed,NSDQ100/USD," 50,36 ",0.051605," 0,37 "," 4.911,32 "," 4.911,32 ",2800333780,CFD," 0,00 "
29/08/2024 23:57:02,Open Position,XAU/USD," 1.499,99 ",11.907407," 0,00 "," 4.911,32 "," 3.411,33 ",2800336550,CFD," 0,00 "
29/08/2024 23:57:34,Open Position,XAU/USD," 999,99 ",7.939091," 0,00 "," 4.911,32 "," 2.411,34 ",2800336556,CFD," 0,00 "
29/08/2024 23:59:03,Open Position,XAU/USD," 999,99 ",7.939248," 0,00 "," 4.911,32 "," 1.411,35 ",2800336580,CFD," 0,00 "
30/08/2024 00:01:23,Open Position,XAU/USD," 499,99 ",3.970664," 0,00 "," 4.911,32 "," 911,36 ",2800336735,CFD," 0,00 "
30/08/2024 00:48:20,Overnight refund,Daily," 2,81 ",-," 2,81 "," 4.914,13 "," 914,17 ",2800316440,CFD," 0,00 "
30/08/2024 06:34:54,Open Position,NSDQ100/USD," 899,99 ",0.926242," 0,00 "," 4.914,13 "," 14,18 ",2800356311,CFD," 0,00 "
30/08/2024 06:47:49,Position closed,XAU/USD," 1.506,42 ",11.907407," 6,43 "," 4.920,56 "," 1.520,60 ",2800336550,CFD," 0,00 "
30/08/2024 06:47:49,Position closed,XAU/USD," 1.002,21 ",7.939091," 2,22 "," 4.922,78 "," 2.522,81 ",2800336556,CFD," 0,00 "
30/08/2024 06:47:49,Position closed,XAU/USD," 1.001,74 ",7.939248," 1,75 "," 4.924,53 "," 3.524,55 ",2800336580,CFD," 0,00 "
30/08/2024 06:47:49,Position closed,XAU/USD," 498,28 ",3.970664,"(1,71)"," 4.922,82 "," 4.022,83 ",2800336735,CFD," 0,00 "
30/08/2024 06:49:14,Open Position,XAU/USD," 200,00 ",1.588789," 0,00 "," 4.922,82 "," 3.822,83 ",2800357845,CFD," 0,00 "
30/08/2024 06:50:54,Open Position,XAU/USD," 959,99 ",7.626583," 0,00 "," 4.922,82 "," 2.862,84 ",2800357958,CFD," 0,00 "
30/08/2024 07:13:07,Open Position,NSDQ100/USD," 499,99 ",0.514984," 0,00 "," 4.922,82 "," 2.362,85 ",2800379323,CFD," 0,00 "
30/08/2024 07:30:27,Position closed,NSDQ100/USD," 910,35 ",0.926242," 10,36 "," 4.933,18 "," 3.273,20 ",2800356311,CFD," 0,00 "
30/08/2024 07:31:07,Position closed,NSDQ100/USD," 510,80 ",0.514984," 10,81 "," 4.943,99 "," 3.784,00 ",2800379323,CFD," 0,00 "
30/08/2024 07:31:29,Open Position,NSDQ100/USD," 999,99 ",1.028644," 0,00 "," 4.943,99 "," 2.784,01 ",2800393897,CFD," 0,00 "
30/08/2024 07:32:11,Open Position,NSDQ100/USD," 999,99 ",1.028396," 0,00 "," 4.943,99 "," 1.784,02 ",2800393986,CFD," 0,00 "
30/08/2024 07:32:35,Open Position,NSDQ100/USD," 499,99 ",0.514211," 0,00 "," 4.943,99 "," 1.284,03 ",2800394100,CFD," 0,00 "
30/08/2024 07:39:08,Position closed,NSDQ100/USD," 1.012,72 ",1.028396," 12,73 "," 4.956,72 "," 2.296,75 ",2800393986,CFD," 0,00 "
30/08/2024 07:39:08,Position closed,NSDQ100/USD," 1.017,56 ",1.028644," 17,57 "," 4.974,29 "," 3.314,31 ",2800393897,CFD," 0,00 "
30/08/2024 07:39:08,Position closed,NSDQ100/USD," 506,61 ",0.514211," 6,62 "," 4.980,91 "," 3.820,92 ",2800394100,CFD," 0,00 "
30/08/2024 07:39:45,Open Position,NSDQ100/USD," 959,99 ",0.986083," 0,00 "," 4.980,91 "," 2.860,93 ",2800396067,CFD," 0,00 "
30/08/2024 08:09:10,Open Position,XAU/USD," 1.000,00 ",7.929019," 0,00 "," 4.980,91 "," 1.860,93 ",2800403085,CFD," 0,00 "
30/08/2024 08:09:37,Open Position,XAU/USD," 999,99 ",7.928956," 0,00 "," 4.980,91 "," 860,94 ",2800403199,CFD," 0,00 "
30/08/2024 08:09:56,Open Position,NSDQ100/USD," 399,99 ",0.411195," 0,00 "," 4.980,91 "," 460,95 ",2800403237,CFD," 0,00 "
30/08/2024 08:34:55,Open Position,XAU/USD," 300,00 ",2.375381," 0,00 "," 4.980,91 "," 160,95 ",2800415198,CFD," 0,00 "
30/08/2024 10:35:31,Position closed,XAU/USD," 1.030,37 ",7.929019," 30,37 "," 5.011,28 "," 1.191,32 ",2800403085,CFD," 0,00 "
30/08/2024 10:35:31,Position closed,XAU/USD," 1.030,44 ",7.928956," 30,45 "," 5.041,73 "," 2.221,76 ",2800403199,CFD," 0,00 "
30/08/2024 10:35:31,Position closed,XAU/USD," 198,55 ",1.588789,"(1,45)"," 5.040,28 "," 2.420,31 ",2800357845,CFD," 0,00 "
30/08/2024 10:35:31,Position closed,XAU/USD," 952,06 ",7.626583,"(7,93)"," 5.032,35 "," 3.372,37 ",2800357958,CFD," 0,00 "
30/08/2024 10:35:31,Position closed,XAU/USD," 317,48 ",2.375381," 17,48 "," 5.049,83 "," 3.689,85 ",2800415198,CFD," 0,00 "
30/08/2024 11:00:03,Position closed,NSDQ100/USD," 979,79 ",0.986083," 19,80 "," 5.069,63 "," 4.669,64 ",2800396067,CFD," 0,00 "
30/08/2024 11:00:03,Position closed,NSDQ100/USD," 414,83 ",0.411195," 14,84 "," 5.084,47 "," 5.084,47 ",2800403237,CFD," 0,00 "
30/08/2024 11:25:02,Open Position,XAU/USD," 510,00 ",4.046703," 0,00 "," 5.084,47 "," 4.574,47 ",2800452977,CFD," 0,00 "
30/08/2024 11:44:01,Open Position,NSDQ100/USD," 1.199,99 ",1.232763," 0,00 "," 5.084,47 "," 3.374,48 ",2800455544,CFD," 0,00 "
30/08/2024 11:44:28,Open Position,NSDQ100/USD," 850,00 ",0.873234," 0,00 "," 5.084,47 "," 2.524,48 ",2800455602,CFD," 0,00 "
30/08/2024 11:45:48,Open Position,XAU/USD," 999,99 ",7.938051," 0,00 "," 5.084,47 "," 1.524,49 ",2800455859,CFD," 0,00 "
30/08/2024 11:46:01,Position closed,XAU/USD," 505,02 ",4.046703,"(4,98)"," 5.079,49 "," 2.029,51 ",2800452977,CFD," 0,00 "
30/08/2024 11:46:29,Open Position,XAU/USD," 509,99 ",4.048599," 0,00 "," 5.079,49 "," 1.519,52 ",2800456078,CFD," 0,00 "
30/08/2024 12:07:07,Position closed,NSDQ100/USD," 875,57 ",0.873234," 25,57 "," 5.105,06 "," 2.395,09 ",2800455602,CFD," 0,00 "
30/08/2024 12:07:07,Position closed,NSDQ100/USD," 1.235,35 ",1.232763," 35,36 "," 5.140,42 "," 3.630,44 ",2800455544,CFD," 0,00 "
30/08/2024 12:08:31,Open Position,NSDQ100/USD," 1.999,99 ",2.050643," 0,00 "," 5.140,42 "," 1.630,45 ",2800461627,CFD," 0,00 "
30/08/2024 12:17:04,Position closed,NSDQ100/USD," 2.009,77 ",2.050643," 9,78 "," 5.150,20 "," 3.640,22 ",2800461627,CFD," 0,00 "
30/08/2024 12:17:23,Open Position,XAU/USD," 919,99 ",7.297099," 0,00 "," 5.150,20 "," 2.720,23 ",2800464481,CFD," 0,00 "
30/08/2024 12:36:06,Position closed,XAU/USD," 512,50 ",4.048599," 2,51 "," 5.152,71 "," 3.232,73 ",2800456078,CFD," 0,00 "
30/08/2024 12:36:06,Position closed,XAU/USD," 940,28 ",7.297099," 20,29 "," 5.173,00 "," 4.173,01 ",2800464481,CFD," 0,00 "
30/08/2024 12:36:06,Position closed,XAU/USD," 1.005,86 ",7.938051," 5,87 "," 5.178,87 "," 5.178,87 ",2800455859,CFD," 0,00 "
30/08/2024 12:36:29,Open Position,XAU/USD," 999,98 ",7.937026," 0,00 "," 5.178,87 "," 4.178,89 ",2800469518,CFD," 0,00 "
30/08/2024 12:36:59,Open Position,NSDQ100/USD," 499,99 ",0.513690," 0,00 "," 5.178,87 "," 3.678,90 ",2800469633,CFD," 0,00 "
30/08/2024 13:01:09,Position closed,NSDQ100/USD," 506,61 ",0.513690," 6,62 "," 5.185,49 "," 4.185,51 ",2800469633,CFD," 0,00 "
30/08/2024 13:23:04,Open Position,NSDQ100/USD," 699,98 ",0.717700," 0,00 "," 5.185,49 "," 3.485,53 ",2800482859,CFD," 0,00 "
30/08/2024 13:23:43,Open Position,XAU/USD," 879,99 ",6.990257," 0,00 "," 5.185,49 "," 2.605,54 ",2800482977,CFD," 0,00 "
30/08/2024 13:47:43,Position closed,NSDQ100/USD," 699,35 ",0.717700,"(0,63)"," 5.184,86 "," 3.304,89 ",2800482859,CFD," 0,00 "
30/08/2024 13:57:11,Open Position,XAU/USD," 830,00 ",6.598403," 0,00 "," 5.184,86 "," 2.474,89 ",2800621179,CFD," 0,00 "
30/08/2024 13:57:30,Open Position,XAU/USD," 799,99 ",6.358870," 0,00 "," 5.184,86 "," 1.674,90 ",2800621514,CFD," 0,00 "
30/08/2024 13:57:59,Open Position,NSDQ100/USD," 420,00 ",0.429973," 0,00 "," 5.184,86 "," 1.254,90 ",2800622051,CFD," 0,00 "
30/08/2024 14:00:10,Position closed,NSDQ100/USD," 430,65 ",0.429973," 10,65 "," 5.195,51 "," 1.685,55 ",2800622051,CFD," 0,00 "
30/08/2024 14:00:49,Open Position,NSDQ100/USD," 50,00 ",0.051104," 0,00 "," 5.195,51 "," 1.635,55 ",2800627581,CFD," 0,00 "
30/08/2024 14:01:10,Position closed,NSDQ100/USD," 49,85 ",0.051104,"(0,15)"," 5.195,36 "," 1.685,40 ",2800627581,CFD," 0,00 "
30/08/2024 14:01:43,Open Position,NSDQ100/USD," 1.000,00 ",1.021963," 0,00 "," 5.195,36 "," 685,40 ",2800629062,CFD," 0,00 "
30/08/2024 14:02:09,Position closed,NSDQ100/USD," 1.002,83 ",1.021963," 2,83 "," 5.198,19 "," 1.688,23 ",2800629062,CFD," 0,00 "
30/08/2024 14:02:37,Open Position,NSDQ100/USD," 1.000,00 ",1.021858," 0,00 "," 5.198,19 "," 688,23 ",2800630303,CFD," 0,00 "
30/08/2024 14:04:19,Position closed,NSDQ100/USD," 1.006,51 ",1.021858," 6,51 "," 5.204,70 "," 1.694,74 ",2800630303,CFD," 0,00 "
30/08/2024 14:21:51,Open Position,NSDQ100/USD," 799,99 ",0.820343," 0,00 "," 5.204,70 "," 894,75 ",2800658903,CFD," 0,00 "
30/08/2024 14:32:25,Open Position,XAU/USD," 800,00 ",6.371658," 0,00 "," 5.204,70 "," 94,75 ",2800668729,CFD," 0,00 "
30/08/2024 14:32:30,Position closed,NSDQ100/USD," 804,23 ",0.820343," 4,24 "," 5.208,94 "," 898,98 ",2800658903,CFD," 0,00 "
30/08/2024 14:41:52,Open Position,XAU/USD," 299,99 ",2.387993," 0,00 "," 5.208,94 "," 598,99 ",2800677990,CFD," 0,00 "
30/08/2024 15:00:24,Open Position,NSDQ100/USD," 499,98 ",0.515134," 0,00 "," 5.208,94 "," 99,01 ",2800711936,CFD," 0,00 "
30/08/2024 15:59:46,Position closed,NSDQ100/USD," 500,39 ",0.515134," 0,41 "," 5.209,35 "," 599,40 ",2800711936,CFD," 0,00 "
30/08/2024 16:18:06,Open Position,XAU/USD," 500,00 ",3.993099," 0,00 "," 5.209,35 "," 99,40 ",2800773228,CFD," 0,00 "
31/08/2024 00:48:53,Overnight fee,Daily,"(1,53)",-,"(1,53)"," 5.207,82 "," 97,87 ",2800677990,CFD," 0,00 "
31/08/2024 00:48:53,Overnight fee,Daily,"(4,23)",-,"(4,23)"," 5.203,59 "," 93,64 ",2800621179,CFD," 0,00 "
31/08/2024 00:48:53,Overnight fee,Daily,"(4,08)",-,"(4,08)"," 5.199,51 "," 89,56 ",2800668729,CFD," 0,00 "
31/08/2024 00:48:53,Overnight fee,Daily,"(5,09)",-,"(5,09)"," 5.194,42 "," 84,47 ",2800469518,CFD," 0,00 "
31/08/2024 00:48:53,Overnight fee,Daily,"(4,08)",-,"(4,08)"," 5.190,34 "," 80,39 ",2800621514,CFD," 0,00 "
31/08/2024 00:48:53,Overnight fee,Daily,"(2,56)",-,"(2,56)"," 5.187,78 "," 77,83 ",2800773228,CFD," 0,00 "
31/08/2024 00:48:53,Overnight fee,Daily,"(4,48)",-,"(4,48)"," 5.183,30 "," 73,35 ",2800482977,CFD," 0,00 "
02/09/2024 15:57:05,Position closed,XAU/USD," 849,49 ",7.937026,"(150,49)"," 5.032,81 "," 922,84 ",2800469518,CFD," 0,00 "
02/09/2024 15:58:41,Open Position,XAU/USD," 900,00 ",7.198128," 0,00 "," 5.032,81 "," 22,84 ",2801224604,CFD," 0,00 "
02/09/2024 16:51:57,Position closed,XAU/USD," 904,75 ",7.198128," 4,75 "," 5.037,56 "," 927,59 ",2801224604,CFD," 0,00 "
02/09/2024 16:52:27,Open Position,XAU/USD," 240,00 ",1.919930," 0,00 "," 5.037,56 "," 687,59 ",2801228291,CFD," 0,00 "
02/09/2024 16:52:39,Open Position,XAU/USD," 679,99 ",5.439825," 0,00 "," 5.037,56 "," 7,60 ",2801228304,CFD," 0,00 "
02/09/2024 17:06:37,Position closed,XAU/USD," 240,48 ",1.919930," 0,48 "," 5.038,04 "," 248,08 ",2801228291,CFD," 0,00 "
02/09/2024 17:06:47,Position closed,XAU/USD," 681,89 ",5.439825," 1,90 "," 5.039,94 "," 929,97 ",2801228304,CFD," 0,00 "
02/09/2024 17:07:16,Open Position,XAU/USD," 900,00 ",7.198963," 0,00 "," 5.039,94 "," 29,97 ",2801229113,CFD," 0,00 "
02/09/2024 17:44:36,Position closed,XAU/USD," 901,80 ",7.198963," 1,80 "," 5.041,74 "," 931,77 ",2801229113,CFD," 0,00 "
02/09/2024 17:44:52,Open Position,XAU/USD," 899,99 ",7.199683," 0,00 "," 5.041,74 "," 31,78 ",2801230311,CFD," 0,00 "
03/09/2024 00:48:39,Overnight fee,Daily,"(4,48)",-,"(4,48)"," 5.037,26 "," 27,30 ",2800482977,CFD," 0,00 "
03/09/2024 00:48:39,Overnight fee,Daily,"(4,62)",-,"(4,62)"," 5.032,64 "," 22,68 ",2801230311,CFD," 0,00 "
03/09/2024 00:48:39,Overnight fee,Daily,"(2,56)",-,"(2,56)"," 5.030,08 "," 20,12 ",2800773228,CFD," 0,00 "
03/09/2024 00:48:39,Overnight fee,Daily,"(4,23)",-,"(4,23)"," 5.025,85 "," 15,89 ",2800621179,CFD," 0,00 "
03/09/2024 00:48:39,Overnight fee,Daily,"(4,08)",-,"(4,08)"," 5.021,77 "," 11,81 ",2800668729,CFD," 0,00 "
03/09/2024 00:48:39,Overnight fee,Daily,"(1,53)",-,"(1,53)"," 5.020,24 "," 10,28 ",2800677990,CFD," 0,00 "
03/09/2024 00:48:39,Overnight fee,Daily,"(4,08)",-,"(4,08)"," 5.016,16 "," 6,20 ",2800621514,CFD," 0,00 "
03/09/2024 07:33:03,Position closed,XAU/USD," 910,50 ",7.199683," 10,51 "," 5.026,67 "," 916,70 ",2801230311,CFD," 0,00 "
03/09/2024 07:34:49,Open Position,XAU/USD," 230,00 ",1.839529," 0,00 "," 5.026,67 "," 686,70 ",2801292735,CFD," 0,00 "
03/09/2024 07:35:48,Open Position,NSDQ100/USD," 200,00 ",0.204358," 0,00 "," 5.026,67 "," 486,70 ",2801292946,CFD," 0,00 "
03/09/2024 07:44:22,Position closed,XAU/USD," 231,12 ",1.839529," 1,12 "," 5.027,79 "," 717,82 ",2801292735,CFD," 0,00 "
03/09/2024 07:45:12,Open Position,XAU/USD," 500,00 ",3.999104," 0,00 "," 5.027,79 "," 217,82 ",2801294597,CFD," 0,00 "
03/09/2024 07:56:33,Position closed,NSDQ100/USD," 200,73 ",0.204358," 0,73 "," 5.028,52 "," 418,55 ",2801292946,CFD," 0,00 "
03/09/2024 08:05:17,Position closed,XAU/USD," 505,96 ",3.999104," 5,96 "," 5.034,48 "," 924,51 ",2801294597,CFD," 0,00 "
03/09/2024 08:05:31,Position closed,XAU/USD," 492,97 ",3.993099,"(7,03)"," 5.027,45 "," 1.417,48 ",2800773228,CFD," 0,00 "
03/09/2024 08:12:48,Open Position,XAU/USD," 399,99 ",3.196407," 0,00 "," 5.027,45 "," 1.017,49 ",2801299565,CFD," 0,00 "
03/09/2024 08:13:34,Open Position,NSDQ100/USD," 500,00 ",0.510995," 0,00 "," 5.027,45 "," 517,49 ",2801299698,CFD," 0,00 "
03/09/2024 08:14:46,Open Position,NSDQ100/USD," 500,00 ",0.511170," 0,00 "," 5.027,45 "," 17,49 ",2801300071,CFD," 0,00 "
03/09/2024 08:17:34,Position closed,NSDQ100/USD," 503,20 ",0.510995," 3,20 "," 5.030,65 "," 520,69 ",2801299698,CFD," 0,00 "
03/09/2024 08:17:36,Position closed,NSDQ100/USD," 499,98 ",0.511170,"(0,02)"," 5.030,63 "," 1.020,67 ",2801300071,CFD," 0,00 "
03/09/2024 08:18:10,Open Position,NSDQ100/USD," 1.150,28 ",0.715414," 0,00 "," 5.030,63 "," 320,68 ",2801301147,CFD," 0,00 "
03/09/2024 08:18:50,Position closed,XAU/USD," 401,11 ",3.196407," 1,12 "," 5.031,75 "," 721,79 ",2801299565,CFD," 0,00 "
03/09/2024 08:19:08,Open Position,NSDQ100/USD," 849,99 ",0.511013," 0,00 "," 5.031,75 "," 221,80 ",2801301319,CFD," 0,00 "
03/09/2024 08:19:37,Open Position,XAU/USD," 200,00 ",1.598152," 0,00 "," 5.031,75 "," 21,80 ",2801301405,CFD," 0,00 "
03/09/2024 08:27:39,Position closed,XAU/USD," 197,60 ",1.598152,"(2,40)"," 5.029,35 "," 219,40 ",2801301405,CFD," 0,00 "
03/09/2024 08:27:53,Open Position,NSDQ100/USD," 349,99 ",0.204685," 0,00 "," 5.029,35 "," 19,41 ",2801302886,CFD," 0,00 "
03/09/2024 08:28:19,Position closed,XAU/USD," 279,64 ",2.387993,"(20,35)"," 5.009,00 "," 299,05 ",2800677990,CFD," 0,00 "
03/09/2024 08:28:32,Open Position,NSDQ100/USD," 404,99 ",0.255872," 0,00 "," 5.009,00 "," 49,06 ",2801303001,CFD," 0,00 "
03/09/2024 08:29:00,Position closed,XAU/USD," 782,48 ",6.990257,"(97,51)"," 4.911,49 "," 831,54 ",2800482977,CFD," 0,00 "
03/09/2024 08:29:10,Open Position,NSDQ100/USD," 1.256,35 ",0.818562," 0,00 "," 4.911,49 "," 31,54 ",2801303077,CFD," 0,00 "
03/09/2024 08:30:07,Position closed,XAU/USD," 754,98 ",6.598403,"(75,02)"," 4.836,47 "," 786,52 ",2800621179,CFD," 0,00 "
03/09/2024 08:30:10,Position closed,XAU/USD," 725,08 ",6.358870,"(74,91)"," 4.761,56 "," 1.511,60 ",2800621514,CFD," 0,00 "
03/09/2024 08:30:23,Open Position,NSDQ100/USD," 754,56 ",0.511879," 0,00 "," 4.761,56 "," 1.011,61 ",2801303315,CFD," 0,00 "
03/09/2024 08:30:32,Open Position,NSDQ100/USD," 699,99 ",0.511797," 0,00 "," 4.761,56 "," 511,62 ",2801303336,CFD," 0,00 "
03/09/2024 08:32:38,Open Position,NSDQ100/USD," 450,00 ",0.307194," 0,00 "," 4.761,56 "," 211,62 ",2801303865,CFD," 0,00 "
03/09/2024 08:49:11,Open Position,NSDQ100/USD," 324,99 ",0.204924," 0,00 "," 4.761,56 "," 11,63 ",2801308551,CFD," 0,00 "
03/09/2024 09:06:11,Position closed,XAU/USD," 753,49 ",6.371658,"(46,51)"," 4.715,05 "," 765,12 ",2800668729,CFD," 0,00 "
03/09/2024 09:06:29,Open Position,NSDQ100/USD," 804,99 ",0.770714," 0,00 "," 4.715,05 "," 15,13 ",2801313432,CFD," 0,00 "
03/09/2024 13:49:58,Deposit Conversion Fee,-,"(29,84)",-," 0,00 "," 5.708,65 "," 1.008,73 ",-,-," 0,00 "
03/09/2024 13:49:58,Deposit,4600.00 USDRON CreditCard," 993,60 ",-," 993,60 "," 5.708,65 "," 1.008,73 ",-,-," 0,00 "
03/09/2024 13:50:13,Open Position,NSDQ100/USD," 950,00 ",0.981192," 0,00 "," 5.708,65 "," 58,73 ",2801647702,CFD," 0,00 "
03/09/2024 14:33:15,Deposit Conversion Fee,-,"(64,71)",-," 0,00 "," 7.865,85 "," 2.215,93 ",-,-," 0,00 "
03/09/2024 14:33:15,Deposit,10000.00 USDRON CreditCard," 2.157,20 ",-," 2.157,20 "," 7.865,85 "," 2.215,93 ",-,-," 0,00 "
03/09/2024 14:33:35,Open Position,NSDQ100/USD," 1.588,65 ",1.560988," 0,00 "," 7.865,85 "," 715,94 ",2802015460,CFD," 0,00 "
03/09/2024 14:34:09,Edit Stop Loss,-,"(50,99)",-," 0,00 "," 7.865,85 "," 664,95 ",2801301147,-," 0,00 "
03/09/2024 14:34:21,Edit Stop Loss,-,"(100,00)",-," 0,00 "," 7.865,85 "," 564,95 ",2801301319,-," 0,00 "
03/09/2024 14:34:31,Edit Stop Loss,-,"(50,00)",-," 0,00 "," 7.865,85 "," 514,95 ",2801302886,-," 0,00 "
03/09/2024 14:34:45,Edit Stop Loss,-,"(50,00)",-," 0,00 "," 7.865,85 "," 464,95 ",2801301147,-," 0,00 "
03/09/2024 14:34:59,Edit Stop Loss,-,"(50,00)",-," 0,00 "," 7.865,85 "," 414,95 ",2801303077,-," 0,00 "
03/09/2024 14:35:22,Edit Stop Loss,-,"(25,00)",-," 0,00 "," 7.865,85 "," 389,95 ",2801303001,-," 0,00 "
03/09/2024 14:35:37,Edit Stop Loss,-,"(50,00)",-," 0,00 "," 7.865,85 "," 339,95 ",2801303336,-," 0,00 "
03/09/2024 14:36:00,Edit Stop Loss,-,"(50,00)",-," 0,00 "," 7.865,85 "," 289,95 ",2801303865,-," 0,00 "
03/09/2024 14:36:11,Edit Stop Loss,-,"(50,00)",-," 0,00 "," 7.865,85 "," 239,95 ",2801303315,-," 0,00 "
03/09/2024 14:36:30,Edit Stop Loss,-,"(50,00)",-," 0,00 "," 7.865,85 "," 189,95 ",2801308551,-," 0,00 "
03/09/2024 14:49:49,Deposit,10000.00 USDRON CreditCard," 2.158,97 ",-," 2.158,97 "," 10.024,82 "," 2.348,92 ",-,-," 0,00 "
03/09/2024 14:49:49,Deposit Conversion Fee,-,"(64,81)",-," 0,00 "," 10.024,82 "," 2.348,92 ",-,-," 0,00 "
03/09/2024 14:50:14,Open Position,NSDQ100/USD," 1.499,99 ",1.567268," 0,00 "," 10.024,82 "," 848,93 ",2802064380,CFD," 0,00 "
03/09/2024 14:50:35,Edit Stop Loss,-,"(50,00)",-," 0,00 "," 10.024,82 "," 798,93 ",2801303336,-," 0,00 "
03/09/2024 14:50:49,Edit Stop Loss,-,"(50,00)",-," 0,00 "," 10.024,82 "," 748,93 ",2801301147,-," 0,00 "
03/09/2024 14:50:59,Edit Stop Loss,-,"(50,00)",-," 0,00 "," 10.024,82 "," 698,93 ",2801301319,-," 0,00 "
03/09/2024 14:51:08,Edit Stop Loss,-,"(25,00)",-," 0,00 "," 10.024,82 "," 673,93 ",2801302886,-," 0,00 "
03/09/2024 14:51:20,Edit Stop Loss,-,"(50,00)",-," 0,00 "," 10.024,82 "," 623,93 ",2801303077,-," 0,00 "
03/09/2024 14:51:42,Edit Stop Loss,-,"(25,00)",-," 0,00 "," 10.024,82 "," 598,93 ",2801303001,-," 0,00 "
03/09/2024 14:51:58,Edit Stop Loss,-,"(50,00)",-," 0,00 "," 10.024,82 "," 548,93 ",2801303315,-," 0,00 "
03/09/2024 14:52:10,Edit Stop Loss,-,"(50,00)",-," 0,00 "," 10.024,82 "," 498,93 ",2801303865,-," 0,00 "
03/09/2024 14:52:22,Edit Stop Loss,-,"(55,00)",-," 0,00 "," 10.024,82 "," 443,93 ",2801313432,-," 0,00 "
03/09/2024 15:42:02,Open Position,NSDQ100/USD," 299,99 ",0.313578," 0,00 "," 10.024,82 "," 143,94 ",2802208750,CFD," 0,00 "
03/09/2024 15:59:01,Edit Stop Loss,-,"(100,00)",-," 0,00 "," 10.024,82 "," 43,94 ",2801303077,-," 0,00 "
03/09/2024 15:59:42,Edit Stop Loss,-,"(43,94)",-," 0,00 "," 10.024,82 "," 0,00 ",2801301147,-," 0,00 "
03/09/2024 17:09:36,Deposit,4600.00 USDRON CreditCard," 992,05 ",-," 992,05 "," 11.016,87 "," 992,05 ",-,-," 0,00 "
03/09/2024 17:09:36,Deposit Conversion Fee,-,"(29,75)",-," 0,00 "," 11.016,87 "," 992,05 ",-,-," 0,00 "
03/09/2024 17:09:58,Open Position,NSDQ100/USD," 699,99 ",0.732535," 0,00 "," 11.016,87 "," 292,06 ",2802318035,CFD," 0,00 "
03/09/2024 17:10:33,Edit Stop Loss,-,"(56,00)",-," 0,00 "," 11.016,87 "," 236,06 ",2801301147,-," 0,00 "
03/09/2024 17:10:57,Edit Stop Loss,-,"(50,00)",-," 0,00 "," 11.016,87 "," 186,06 ",2801301319,-," 0,00 "
03/09/2024 17:11:18,Edit Stop Loss,-,"(25,00)",-," 0,00 "," 11.016,87 "," 161,06 ",2801302886,-," 0,00 "
03/09/2024 17:11:32,Edit Stop Loss,-,"(25,00)",-," 0,00 "," 11.016,87 "," 136,06 ",2801303001,-," 0,00 "
03/09/2024 17:12:00,Edit Stop Loss,-,"(50,00)",-," 0,00 "," 11.016,87 "," 86,06 ",2801303077,-," 0,00 "
03/09/2024 17:12:15,Edit Stop Loss,-,"(50,00)",-," 0,00 "," 11.016,87 "," 36,06 ",2801303336,-," 0,00 "
03/09/2024 17:22:03,Position closed,NSDQ100/USD," 712,54 ",0.732535," 12,55 "," 11.029,42 "," 748,60 ",2802318035,CFD," 0,00 "
03/09/2024 17:22:17,Position closed,NSDQ100/USD," 298,27 ",0.313578,"(1,72)"," 11.027,70 "," 1.046,87 ",2802208750,CFD," 0,00 "
03/09/2024 17:35:48,Open Position,NSDQ100/USD," 750,00 ",0.785559," 0,00 "," 11.027,70 "," 296,87 ",2802347870,CFD," 0,00 "
03/09/2024 17:47:32,Open Position,NSDQ100/USD," 250,00 ",0.262046," 0,00 "," 11.027,70 "," 46,87 ",2802355060,CFD," 0,00 "
03/09/2024 18:53:22,Edit Stop Loss,-,"(25,00)",-," 0,00 "," 11.027,70 "," 21,87 ",2801303315,-," 0,00 "
03/09/2024 19:46:01,Position closed,NSDQ100/USD," 374,68 ",0.770714,"(430,31)"," 10.597,39 "," 396,55 ",2801313432,CFD," 0,00 "
03/09/2024 19:46:51,Position closed,NSDQ100/USD," 476,11 ",0.981192,"(473,89)"," 10.123,50 "," 872,66 ",2801647702,CFD," 0,00 "
03/09/2024 19:50:30,Position closed,NSDQ100/USD," 206,28 ",0.262046,"(43,72)"," 10.079,78 "," 1.078,94 ",2802355060,CFD," 0,00 "
03/09/2024 19:50:44,Edit Stop Loss,-,"(50,00)",-," 0,00 "," 10.079,78 "," 1.028,94 ",2801303336,-," 0,00 "
03/09/2024 19:51:00,Edit Stop Loss,-,"(25,00)",-," 0,00 "," 10.079,78 "," 1.003,94 ",2801303001,-," 0,00 "
03/09/2024 19:51:36,Edit Stop Loss,-,"(25,00)",-," 0,00 "," 10.079,78 "," 978,94 ",2801303315,-," 0,00 "
03/09/2024 19:51:53,Edit Stop Loss,-,"(25,00)",-," 0,00 "," 10.079,78 "," 953,94 ",2801308551,-," 0,00 "
03/09/2024 19:52:24,Edit Stop Loss,-,"(150,00)",-," 0,00 "," 10.079,78 "," 803,94 ",2801301147,-," 0,00 "
03/09/2024 19:52:44,Edit Stop Loss,-,"(150,00)",-," 0,00 "," 10.079,78 "," 653,94 ",2801301319,-," 0,00 "
03/09/2024 19:52:58,Edit Stop Loss,-,"(50,00)",-," 0,00 "," 10.079,78 "," 603,94 ",2801303077,-," 0,00 "
03/09/2024 19:53:19,Edit Stop Loss,-,"(55,00)",-," 0,00 "," 10.079,78 "," 548,94 ",2801303001,-," 0,00 "
03/09/2024 19:53:42,Edit Stop Loss,-,"(25,00)",-," 0,00 "," 10.079,78 "," 523,94 ",2801308551,-," 0,00 "
03/09/2024 19:54:05,Edit Stop Loss,-,"(50,00)",-," 0,00 "," 10.079,78 "," 473,94 ",2801303865,-," 0,00 "
03/09/2024 19:54:26,Edit Stop Loss,-,"(25,00)",-," 0,00 "," 10.079,78 "," 448,94 ",2801308551,-," 0,00 "
03/09/2024 19:54:41,Edit Stop Loss,-,"(80,00)",-," 0,00 "," 10.079,78 "," 368,94 ",2801303315,-," 0,00 "
03/09/2024 19:55:47,Edit Stop Loss,-,"(50,00)",-," 0,00 "," 10.079,78 "," 318,94 ",2801302886,-," 0,00 "
03/09/2024 20:19:02,Edit Stop Loss,-,"(49,36)",-," 0,00 "," 10.079,78 "," 269,58 ",2801301147,-," 0,00 "
03/09/2024 20:19:35,Edit Stop Loss,-,"(156,35)",-," 0,00 "," 10.079,78 "," 113,23 ",2801303077,-," 0,00 "
03/09/2024 20:20:32,Edit Stop Loss,-,"(24,57)",-," 0,00 "," 10.079,78 "," 88,66 ",2801303315,-," 0,00 "
03/09/2024 23:15:56,Edit Stop Loss,-,"(88,66)",-," 0,00 "," 10.079,78 "," 0,00 ",2802015460,-," 0,00 "
04/09/2024 00:33:42,Dividend,NSDQ100/USD," 0,48 ",-," 0,48 "," 10.080,26 "," 0,48 ",2801301147,CFD," 0,00 "
04/09/2024 00:33:42,Dividend,NSDQ100/USD," 0,34 ",-," 0,34 "," 10.080,60 "," 0,82 ",2801301319,CFD," 0,00 "
04/09/2024 00:33:42,Dividend,NSDQ100/USD," 0,14 ",-," 0,14 "," 10.080,74 "," 0,96 ",2801302886,CFD," 0,00 "
04/09/2024 00:33:42,Dividend,NSDQ100/USD," 0,17 ",-," 0,17 "," 10.080,91 "," 1,13 ",2801303001,CFD," 0,00 "
04/09/2024 00:33:42,Dividend,NSDQ100/USD," 0,55 ",-," 0,55 "," 10.081,46 "," 1,68 ",2801303077,CFD," 0,00 "
04/09/2024 00:33:42,Dividend,NSDQ100/USD," 0,34 ",-," 0,34 "," 10.081,80 "," 2,02 ",2801303315,CFD," 0,00 "
04/09/2024 00:33:42,Dividend,NSDQ100/USD," 0,34 ",-," 0,34 "," 10.082,14 "," 2,36 ",2801303336,CFD," 0,00 "
04/09/2024 00:33:42,Dividend,NSDQ100/USD," 0,21 ",-," 0,21 "," 10.082,35 "," 2,57 ",2801303865,CFD," 0,00 "
04/09/2024 00:33:42,Dividend,NSDQ100/USD," 0,14 ",-," 0,14 "," 10.082,49 "," 2,71 ",2801308551,CFD," 0,00 "
04/09/2024 00:33:42,Dividend,NSDQ100/USD," 1,04 ",-," 1,04 "," 10.083,53 "," 3,75 ",2802015460,CFD," 0,00 "
04/09/2024 00:33:42,Dividend,NSDQ100/USD," 1,05 ",-," 1,05 "," 10.084,58 "," 4,80 ",2802064380,CFD," 0,00 "
04/09/2024 00:33:42,Dividend,NSDQ100/USD," 0,53 ",-," 0,53 "," 10.085,11 "," 5,33 ",2802347870,CFD," 0,00 "
04/09/2024 00:48:36,Overnight fee,Daily,"(4,25)",-,"(4,25)"," 10.080,86 "," 1,08 ",2801303077,CFD," 0,00 "
04/09/2024 00:48:36,Overnight fee,Daily,"(2,65)",-,"(2,65)"," 10.078,21 ","(1,57)",2801301319,CFD," 0,00 "
04/09/2024 00:48:36,Overnight fee,Daily,"(3,71)",-,"(3,71)"," 10.074,50 ","(5,28)",2801301147,CFD," 0,00 "
04/09/2024 00:48:36,Overnight fee,Daily,"(8,13)",-,"(8,13)"," 10.066,37 ","(13,41)",2802064380,CFD," 0,00 "
04/09/2024 00:48:36,Overnight fee,Daily,"(2,66)",-,"(2,66)"," 10.063,71 ","(16,07)",2801303315,CFD," 0,00 "
04/09/2024 00:48:36,Overnight fee,Daily,"(1,59)",-,"(1,59)"," 10.062,12 ","(17,66)",2801303865,CFD," 0,00 "
04/09/2024 00:48:36,Overnight fee,Daily,"(4,08)",-,"(4,08)"," 10.058,04 ","(21,74)",2802347870,CFD," 0,00 "
04/09/2024 00:48:36,Overnight fee,Daily,"(8,10)",-,"(8,10)"," 10.049,94 ","(29,84)",2802015460,CFD," 0,00 "
04/09/2024 00:48:36,Overnight fee,Daily,"(1,33)",-,"(1,33)"," 10.048,61 ","(31,17)",2801303001,CFD," 0,00 "
04/09/2024 00:48:36,Overnight fee,Daily,"(1,06)",-,"(1,06)"," 10.047,55 ","(32,23)",2801302886,CFD," 0,00 "
04/09/2024 00:48:36,Overnight fee,Daily,"(2,66)",-,"(2,66)"," 10.044,89 ","(34,89)",2801303336,CFD," 0,00 "
04/09/2024 00:48:36,Overnight fee,Daily,"(1,06)",-,"(1,06)"," 10.043,83 ","(35,95)",2801308551,CFD," 0,00 "
04/09/2024 07:35:57,Deposit Conversion Fee,-,"(14,93)",-," 0,00 "," 10.540,82 "," 461,04 ",-,-," 0,00 "
04/09/2024 07:35:57,Deposit,2300.00 USDRON CreditCard," 496,99 ",-," 496,99 "," 10.540,82 "," 461,04 ",-,-," 0,00 "
04/09/2024 07:37:32,Open Position,NSDQ100/USD," 300,00 ",0.318433," 0,00 "," 10.540,82 "," 161,04 ",2802655817,CFD," 0,00 "
04/09/2024 07:54:29,Position closed,NSDQ100/USD," 303,72 ",0.318433," 3,72 "," 10.544,54 "," 464,76 ",2802655817,CFD," 0,00 "
04/09/2024 07:57:51,Open Position,NSDQ100/USD," 119,99 ",0.127287," 0,00 "," 10.544,54 "," 344,77 ",2802660586,CFD," 0,00 "
04/09/2024 08:02:31,Position closed,NSDQ100/USD," 120,14 ",0.127287," 0,15 "," 10.544,69 "," 464,91 ",2802660586,CFD," 0,00 "
04/09/2024 08:03:06,Open Position,NSDQ100/USD," 300,00 ",0.318288," 0,00 "," 10.544,69 "," 164,91 ",2802664460,CFD," 0,00 "
04/09/2024 08:03:16,Position closed,NSDQ100/USD," 296,84 ",0.318288,"(3,16)"," 10.541,53 "," 461,75 ",2802664460,CFD," 0,00 "
04/09/2024 08:28:40,Open Position,NSDQ100/USD," 399,99 ",0.424335," 0,00 "," 10.541,53 "," 61,76 ",2802674342,CFD," 0,00 "
04/09/2024 08:31:50,Position closed,NSDQ100/USD," 409,86 ",0.424335," 9,87 "," 10.551,40 "," 471,62 ",2802674342,CFD," 0,00 "
04/09/2024 08:32:20,Open Position,NSDQ100/USD," 299,99 ",0.317839," 0,00 "," 10.551,40 "," 171,63 ",2802675207,CFD," 0,00 "
04/09/2024 08:34:09,Position closed,NSDQ100/USD," 359,60 ",0.511797,"(340,39)"," 10.211,01 "," 531,23 ",2801303336,CFD," 0,00 "
04/09/2024 08:34:46,Open Position,NSDQ100/USD," 500,00 ",0.529858," 0,00 "," 10.211,01 "," 31,23 ",2802675778,CFD," 0,00 "
04/09/2024 08:39:41,Position closed,NSDQ100/USD," 210,67 ",0.204685,"(139,32)"," 10.071,69 "," 241,90 ",2801302886,CFD," 0,00 "
04/09/2024 08:40:06,Position closed,NSDQ100/USD," 189,64 ",0.204924,"(135,35)"," 9.936,34 "," 431,54 ",2801308551,CFD," 0,00 "
04/09/2024 08:40:55,Open Position,NSDQ100/USD," 399,99 ",0.424250," 0,00 "," 9.936,34 "," 31,55 ",2802677017,CFD," 0,00 "
04/09/2024 08:42:13,Position closed,NSDQ100/USD," 401,29 ",0.424250," 1,30 "," 9.937,64 "," 432,84 ",2802677017,CFD," 0,00 "
04/09/2024 08:42:20,Position closed,NSDQ100/USD," 307,51 ",0.317839," 7,52 "," 9.945,16 "," 740,35 ",2802675207,CFD," 0,00 "
04/09/2024 08:42:27,Position closed,NSDQ100/USD," 509,99 ",0.529858," 9,99 "," 9.955,15 "," 1.250,34 ",2802675778,CFD," 0,00 "
04/09/2024 08:43:29,Open Position,NSDQ100/USD," 499,99 ",0.530427," 0,00 "," 9.955,15 "," 750,35 ",2802677596,CFD," 0,00 "
04/09/2024 08:43:46,Open Position,NSDQ100/USD," 499,99 ",0.530461," 0,00 "," 9.955,15 "," 250,36 ",2802677633,CFD," 0,00 "
04/09/2024 08:50:55,Position closed,NSDQ100/USD," 501,30 ",0.530461," 1,31 "," 9.956,46 "," 751,66 ",2802677633,CFD," 0,00 "
04/09/2024 08:51:03,Position closed,NSDQ100/USD," 500,40 ",0.530427," 0,41 "," 9.956,87 "," 1.252,06 ",2802677596,CFD," 0,00 "
04/09/2024 08:51:46,Open Position,NSDQ100/USD," 1.000,00 ",1.060760," 0,00 "," 9.956,87 "," 252,06 ",2802679350,CFD," 0,00 "
04/09/2024 08:57:32,Open Position,NSDQ100/USD," 200,00 ",0.212002," 0,00 "," 9.956,87 "," 52,06 ",2802680581,CFD," 0,00 "
04/09/2024 08:58:22,Position closed,NSDQ100/USD," 246,27 ",0.307194,"(203,73)"," 9.753,14 "," 298,33 ",2801303865,CFD," 0,00 "
04/09/2024 08:58:46,Open Position,NSDQ100/USD," 250,00 ",0.265049," 0,00 "," 9.753,14 "," 48,33 ",2802680955,CFD," 0,00 "
04/09/2024 09:01:22,Position closed,NSDQ100/USD," 1.000,60 ",1.060760," 0,60 "," 9.753,74 "," 1.048,93 ",2802679350,CFD," 0,00 "
04/09/2024 09:01:37,Position closed,NSDQ100/USD," 202,87 ",0.212002," 2,87 "," 9.756,61 "," 1.251,80 ",2802680581,CFD," 0,00 "
04/09/2024 09:01:44,Position closed,NSDQ100/USD," 250,97 ",0.265049," 0,97 "," 9.757,58 "," 1.502,77 ",2802680955,CFD," 0,00 "
04/09/2024 09:02:06,Open Position,NSDQ100/USD," 499,99 ",0.530300," 0,00 "," 9.757,58 "," 1.002,78 ",2802681934,CFD," 0,00 "
04/09/2024 09:02:21,Open Position,NSDQ100/USD," 499,99 ",0.530208," 0,00 "," 9.757,58 "," 502,79 ",2802681980,CFD," 0,00 "
04/09/2024 09:03:19,Position closed,NSDQ100/USD," 504,90 ",0.530300," 4,91 "," 9.762,49 "," 1.007,69 ",2802681934,CFD," 0,00 "
04/09/2024 09:03:26,Position closed,NSDQ100/USD," 501,51 ",0.530208," 1,52 "," 9.764,01 "," 1.509,20 ",2802681980,CFD," 0,00 "
04/09/2024 09:04:32,Open Position,NSDQ100/USD," 1.000,00 ",1.059491," 0,00 "," 9.764,01 "," 509,20 ",2802682540,CFD," 0,00 "
04/09/2024 09:06:09,Position closed,NSDQ100/USD," 1.009,81 ",1.059491," 9,81 "," 9.773,82 "," 1.519,01 ",2802682540,CFD," 0,00 "
04/09/2024 09:07:29,Open Position,NSDQ100/USD," 600,00 ",0.636293," 0,00 "," 9.773,82 "," 919,01 ",2802683459,CFD," 0,00 "
04/09/2024 09:11:32,Open Position,NSDQ100/USD," 229,99 ",0.243930," 0,00 "," 9.773,82 "," 689,02 ",2802684103,CFD," 0,00 "
04/09/2024 09:13:08,Position closed,NSDQ100/USD," 229,79 ",0.243930,"(0,20)"," 9.773,62 "," 918,81 ",2802684103,CFD," 0,00 "
04/09/2024 09:16:24,Position closed,NSDQ100/USD," 599,41 ",0.636293,"(0,59)"," 9.773,03 "," 1.518,22 ",2802683459,CFD," 0,00 "
04/09/2024 09:17:10,Open Position,NSDQ100/USD," 1.000,00 ",1.060277," 0,00 "," 9.773,03 "," 518,22 ",2802684976,CFD," 0,00 "
04/09/2024 09:17:51,Position closed,NSDQ100/USD," 231,98 ",0.255872,"(173,01)"," 9.600,02 "," 750,20 ",2801303001,CFD," 0,00 "
04/09/2024 09:18:12,Open Position,NSDQ100/USD," 700,00 ",0.741950," 0,00 "," 9.600,02 "," 50,20 ",2802685088,CFD," 0,00 "
04/09/2024 09:20:22,Position closed,NSDQ100/USD," 415,50 ",0.511879,"(339,06)"," 9.260,96 "," 465,70 ",2801303315,CFD," 0,00 "
04/09/2024 09:20:38,Open Position,NSDQ100/USD," 400,00 ",0.423837," 0,00 "," 9.260,96 "," 65,70 ",2802685581,CFD," 0,00 "
04/09/2024 09:24:49,Position closed,NSDQ100/USD," 995,73 ",1.060277,"(4,27)"," 9.256,69 "," 1.061,43 ",2802684976,CFD," 0,00 "
04/09/2024 09:25:19,Position closed,NSDQ100/USD," 404,81 ",0.423837," 4,81 "," 9.261,50 "," 1.466,24 ",2802685581,CFD," 0,00 "
04/09/2024 09:25:26,Position closed,NSDQ100/USD," 705,24 ",0.741950," 5,24 "," 9.266,74 "," 2.171,48 ",2802685088,CFD," 0,00 "
04/09/2024 09:28:56,Open Position,NSDQ100/USD," 999,99 ",1.060045," 0,00 "," 9.266,74 "," 1.171,49 ",2802687088,CFD," 0,00 "
04/09/2024 09:29:08,Open Position,NSDQ100/USD," 499,99 ",0.530025," 0,00 "," 9.266,74 "," 671,50 ",2802687109,CFD," 0,00 "
04/09/2024 09:36:59,Position closed,NSDQ100/USD," 503,63 ",0.530025," 3,64 "," 9.270,38 "," 1.175,13 ",2802687109,CFD," 0,00 "
04/09/2024 09:37:06,Position closed,NSDQ100/USD," 1.008,64 ",1.060045," 8,65 "," 9.279,03 "," 2.183,77 ",2802687088,CFD," 0,00 "
04/09/2024 09:38:44,Open Position,NSDQ100/USD," 1.000,00 ",1.059575," 0,00 "," 9.279,03 "," 1.183,77 ",2802688951,CFD," 0,00 "
04/09/2024 09:38:57,Open Position,NSDQ100/USD," 1.000,00 ",1.059665," 0,00 "," 9.279,03 "," 183,77 ",2802688979,CFD," 0,00 "
04/09/2024 09:41:19,Open Position,NSDQ100/USD," 150,00 ",0.158875," 0,00 "," 9.279,03 "," 33,77 ",2802689543,CFD," 0,00 "
04/09/2024 09:45:50,Position closed,NSDQ100/USD," 148,53 ",0.158875,"(1,47)"," 9.277,56 "," 182,30 ",2802689543,CFD," 0,00 "
04/09/2024 09:46:54,Open Position,NSDQ100/USD," 150,00 ",0.158836," 0,00 "," 9.277,56 "," 32,30 ",2802691027,CFD," 0,00 "
04/09/2024 09:49:10,Position closed,NSDQ100/USD," 150,68 ",0.158836," 0,68 "," 9.278,24 "," 182,98 ",2802691027,CFD," 0,00 "
04/09/2024 09:50:58,Position closed,NSDQ100/USD," 1.001,24 ",1.059575," 1,24 "," 9.279,48 "," 1.184,22 ",2802688951,CFD," 0,00 "
04/09/2024 09:51:15,Position closed,NSDQ100/USD," 1.001,77 ",1.059665," 1,77 "," 9.281,25 "," 2.185,99 ",2802688979,CFD," 0,00 "
04/09/2024 09:52:14,Open Position,NSDQ100/USD," 999,99 ",1.059877," 0,00 "," 9.281,25 "," 1.186,00 ",2802692086,CFD," 0,00 "
04/09/2024 09:53:21,Open Position,NSDQ100/USD," 999,99 ",1.060292," 0,00 "," 9.281,25 "," 186,01 ",2802692285,CFD," 0,00 "
04/09/2024 09:58:18,Position closed,NSDQ100/USD," 1.010,87 ",1.060292," 10,88 "," 9.292,13 "," 1.196,88 ",2802692285,CFD," 0,00 "
04/09/2024 09:58:26,Position closed,NSDQ100/USD," 1.005,58 ",1.059877," 5,59 "," 9.297,72 "," 2.202,46 ",2802692086,CFD," 0,00 "
04/09/2024 10:03:14,Open Position,NSDQ100/USD," 999,99 ",1.059641," 0,00 "," 9.297,72 "," 1.202,47 ",2802695541,CFD," 0,00 "
04/09/2024 10:05:05,Open Position,NSDQ100/USD," 499,99 ",0.529938," 0,00 "," 9.297,72 "," 702,48 ",2802695826,CFD," 0,00 "
04/09/2024 10:07:12,Open Position,NSDQ100/USD," 499,99 ",0.530047," 0,00 "," 9.297,72 "," 202,49 ",2802696101,CFD," 0,00 "
04/09/2024 10:10:26,Open Position,NSDQ100/USD," 199,99 ",0.212114," 0,00 "," 9.297,72 "," 2,50 ",2802696712,CFD," 0,00 "
04/09/2024 10:30:44,Position closed,NSDQ100/USD," 195,42 ",0.212114,"(4,57)"," 9.293,15 "," 197,92 ",2802696712,CFD," 0,00 "
04/09/2024 10:31:02,Open Position,NSDQ100/USD," 149,99 ",0.159193," 0,00 "," 9.293,15 "," 47,93 ",2802700988,CFD," 0,00 "
04/09/2024 12:27:14,Position closed,NSDQ100/USD," 943,81 ",1.059641,"(56,18)"," 9.236,97 "," 991,74 ",2802695541,CFD," 0,00 "
04/09/2024 12:27:21,Position closed,NSDQ100/USD," 474,70 ",0.529938,"(25,29)"," 9.211,68 "," 1.466,44 ",2802695826,CFD," 0,00 "
04/09/2024 12:27:31,Position closed,NSDQ100/USD," 477,08 ",0.530047,"(22,91)"," 9.188,77 "," 1.943,52 ",2802696101,CFD," 0,00 "
04/09/2024 12:27:38,Position closed,NSDQ100/USD," 146,47 ",0.159193,"(3,52)"," 9.185,25 "," 2.089,99 ",2802700988,CFD," 0,00 "
04/09/2024 12:27:58,Open Position,NSDQ100/USD," 1.500,00 ",1.593507," 0,00 "," 9.185,25 "," 589,99 ",2802739426,CFD," 0,00 "
04/09/2024 12:47:41,Open Position,NSDQ100/USD," 300,00 ",0.318097," 0,00 "," 9.185,25 "," 289,99 ",2802745020,CFD," 0,00 "
04/09/2024 13:22:04,Position closed,NSDQ100/USD," 677,16 ",0.818562,"(579,19)"," 8.606,06 "," 967,15 ",2801303077,CFD," 0,00 "
04/09/2024 13:22:25,Open Position,NSDQ100/USD," 899,99 ",0.955581," 0,00 "," 8.606,06 "," 67,16 ",2802753410,CFD," 0,00 "
04/09/2024 13:41:47,Position closed,NSDQ100/USD," 310,82 ",0.318097," 10,82 "," 8.616,88 "," 377,98 ",2802745020,CFD," 0,00 "
04/09/2024 13:46:16,Position closed,NSDQ100/USD," 682,80 ",0.715414,"(467,48)"," 8.149,40 "," 1.060,78 ",2801301147,CFD," 0,00 "
04/09/2024 13:46:46,Open Position,NSDQ100/USD," 500,00 ",0.528805," 0,00 "," 8.149,40 "," 560,78 ",2802864455,CFD," 0,00 "
04/09/2024 13:47:08,Position closed,NSDQ100/USD," 510,20 ",0.511013,"(339,79)"," 7.809,61 "," 1.070,98 ",2801301319,CFD," 0,00 "
04/09/2024 13:47:44,Open Position,NSDQ100/USD," 700,00 ",0.740574," 0,00 "," 7.809,61 "," 370,98 ",2802865904,CFD," 0,00 "
04/09/2024 13:49:44,Open Position,NSDQ100/USD," 300,00 ",0.316988," 0,00 "," 7.809,61 "," 70,98 ",2802869106,CFD," 0,00 "
04/09/2024 13:57:37,Position closed,NSDQ100/USD," 1.116,05 ",1.560988,"(472,60)"," 7.337,01 "," 1.187,03 ",2802015460,CFD," 0,00 "
04/09/2024 13:58:13,Open Position,NSDQ100/USD," 1.000,00 ",1.057382," 0,00 "," 7.337,01 "," 187,03 ",2803044734,CFD," 0,00 "
04/09/2024 14:00:16,Position closed,NSDQ100/USD," 1.094,18 ",1.057382," 94,18 "," 7.431,19 "," 1.281,21 ",2803044734,CFD," 0,00 "
04/09/2024 14:00:46,Position closed,NSDQ100/USD," 1.538,93 ",1.593507," 38,93 "," 7.470,12 "," 2.820,14 ",2802739426,CFD," 0,00 "
04/09/2024 14:00:52,Position closed,NSDQ100/USD," 336,57 ",0.316988," 36,57 "," 7.506,69 "," 3.156,71 ",2802869106,CFD," 0,00 "
04/09/2024 14:01:04,Position closed,NSDQ100/USD," 769,37 ",0.740574," 69,37 "," 7.576,06 "," 3.926,08 ",2802865904,CFD," 0,00 "
04/09/2024 14:01:11,Position closed,NSDQ100/USD," 550,01 ",0.528805," 50,01 "," 7.626,07 "," 4.476,09 ",2802864455,CFD," 0,00 "
04/09/2024 14:01:20,Position closed,NSDQ100/USD," 914,93 ",0.955581," 14,94 "," 7.641,01 "," 5.391,02 ",2802753410,CFD," 0,00 "
04/09/2024 14:02:55,Open Position,NSDQ100/USD," 1.399,99 ",1.482614," 0,00 "," 7.641,01 "," 3.991,03 ",2803069955,CFD," 0,00 "
04/09/2024 14:03:43,Position closed,NSDQ100/USD," 1.426,04 ",1.482614," 26,05 "," 7.667,06 "," 5.417,07 ",2803069955,CFD," 0,00 "
04/09/2024 14:05:06,Open Position,NSDQ100/USD," 1.399,99 ",1.484059," 0,00 "," 7.667,06 "," 4.017,08 ",2803077153,CFD," 0,00 "
04/09/2024 14:06:50,Position closed,NSDQ100/USD," 1.383,77 ",1.484059,"(16,22)"," 7.650,84 "," 5.400,85 ",2803077153,CFD," 0,00 "
04/09/2024 14:09:02,Open Position,NSDQ100/USD," 1.399,41 ",1.480413," 0,00 "," 7.650,84 "," 4.001,44 ",2803084712,CFD," 0,00 "
04/09/2024 14:09:15,Open Position,NSDQ100/USD," 1.099,98 ",1.163510," 0,00 "," 7.650,84 "," 2.901,46 ",2803084986,CFD," 0,00 "
04/09/2024 14:17:31,Open Position,NSDQ100/USD," 729,99 ",0.772698," 0,00 "," 7.650,84 "," 2.171,47 ",2803104663,CFD," 0,00 "
04/09/2024 14:17:49,Position closed,NSDQ100/USD," 737,15 ",0.772698," 7,16 "," 7.658,00 "," 2.908,62 ",2803104663,CFD," 0,00 "
04/09/2024 14:18:14,Position closed,NSDQ100/USD," 1.115,54 ",1.163510," 15,56 "," 7.673,56 "," 4.024,16 ",2803084986,CFD," 0,00 "
04/09/2024 14:18:32,Position closed,NSDQ100/USD," 1.436,38 ",1.480413," 36,97 "," 7.710,53 "," 5.460,54 ",2803084712,CFD," 0,00 "
04/09/2024 14:19:24,Open Position,NSDQ100/USD," 1.400,00 ",1.482192," 0,00 "," 7.710,53 "," 4.060,54 ",2803106837,CFD," 0,00 "
04/09/2024 14:20:14,Open Position,NSDQ100/USD," 1.099,99 ",1.164617," 0,00 "," 7.710,53 "," 2.960,55 ",2803107575,CFD," 0,00 "
04/09/2024 14:24:43,Open Position,NSDQ100/USD," 749,99 ",0.793099," 0,00 "," 7.710,53 "," 2.210,56 ",2803113458,CFD," 0,00 "
04/09/2024 14:26:02,Open Position,NSDQ100/USD," 559,99 ",0.592034," 0,00 "," 7.710,53 "," 1.650,57 ",2803115951,CFD," 0,00 "
04/09/2024 14:36:06,Position closed,NSDQ100/USD," 662,37 ",0.785559,"(87,63)"," 7.622,90 "," 2.312,94 ",2802347870,CFD," 0,00 "
04/09/2024 14:36:19,Open Position,NSDQ100/USD," 1.499,99 ",1.580350," 0,00 "," 7.622,90 "," 812,95 ",2803134592,CFD," 0,00 "
04/09/2024 14:36:44,Position closed,NSDQ100/USD," 1.270,98 ",1.482192,"(129,02)"," 7.493,88 "," 2.083,93 ",2803106837,CFD," 0,00 "
04/09/2024 14:37:02,Open Position,NSDQ100/USD," 1.000,00 ",1.054194," 0,00 "," 7.493,88 "," 1.083,93 ",2803135386,CFD," 0,00 "
04/09/2024 14:41:14,Open Position,NSDQ100/USD," 500,00 ",0.526185," 0,00 "," 7.493,88 "," 583,93 ",2803235336,CFD," 0,00 "
04/09/2024 14:42:57,Position closed,NSDQ100/USD," 506,91 ",0.526185," 6,91 "," 7.500,79 "," 1.090,84 ",2803235336,CFD," 0,00 "
04/09/2024 14:44:31,Open Position,NSDQ100/USD," 899,99 ",0.947038," 0,00 "," 7.500,79 "," 190,85 ",2803241550,CFD," 0,00 "
04/09/2024 14:46:43,Position closed,NSDQ100/USD," 908,65 ",0.947038," 8,66 "," 7.509,45 "," 1.099,50 ",2803241550,CFD," 0,00 "
04/09/2024 14:48:30,Position closed,NSDQ100/USD," 1.498,65 ",1.580350,"(1,34)"," 7.508,11 "," 2.598,15 ",2803134592,CFD," 0,00 "
04/09/2024 14:49:16,Open Position,NSDQ100/USD," 650,00 ",0.685161," 0,00 "," 7.508,11 "," 1.948,15 ",2803273763,CFD," 0,00 "
04/09/2024 14:50:16,Open Position,NSDQ100/USD," 1.000,00 ",1.053417," 0,00 "," 7.508,11 "," 948,15 ",2803287430,CFD," 0,00 "
04/09/2024 14:53:22,Open Position,NSDQ100/USD," 500,00 ",0.526331," 0,00 "," 7.508,11 "," 448,15 ",2803292275,CFD," 0,00 "
04/09/2024 14:55:30,Open Position,NSDQ100/USD," 399,98 ",0.420735," 0,00 "," 7.508,11 "," 48,17 ",2803295945,CFD," 0,00 "
04/09/2024 15:07:26,Position closed,NSDQ100/USD," 1.359,00 ",1.567268,"(140,99)"," 7.367,12 "," 1.407,17 ",2802064380,CFD," 0,00 "
04/09/2024 15:07:37,Open Position,NSDQ100/USD," 399,97 ",0.419922," 0,00 "," 7.367,12 "," 1.007,20 ",2803323474,CFD," 0,00 "
04/09/2024 15:15:36,Position closed,NSDQ100/USD," 400,46 ",0.420735," 0,48 "," 7.367,60 "," 1.407,66 ",2803295945,CFD," 0,00 "
04/09/2024 15:21:28,Position closed,NSDQ100/USD," 500,97 ",0.526331," 0,97 "," 7.368,57 "," 1.908,63 ",2803292275,CFD," 0,00 "
04/09/2024 15:21:34,Position closed,NSDQ100/USD," 421,19 ",0.419922," 21,22 "," 7.389,79 "," 2.329,82 ",2803323474,CFD," 0,00 "
04/09/2024 15:28:01,Open Position,NSDQ100/USD," 589,99 ",0.621375," 0,00 "," 7.389,79 "," 1.739,83 ",2803344437,CFD," 0,00 "
04/09/2024 15:28:25,Position closed,NSDQ100/USD," 1.003,84 ",1.053417," 3,84 "," 7.393,63 "," 2.743,67 ",2803287430,CFD," 0,00 "
04/09/2024 15:28:29,Position closed,NSDQ100/USD," 595,68 ",0.621375," 5,69 "," 7.399,32 "," 3.339,35 ",2803344437,CFD," 0,00 "
04/09/2024 15:29:18,Open Position,NSDQ100/USD," 1.000,00 ",1.053944," 0,00 "," 7.399,32 "," 2.339,35 ",2803345559,CFD," 0,00 "
04/09/2024 15:30:14,Position closed,NSDQ100/USD," 1.007,23 ",1.054194," 7,23 "," 7.406,55 "," 3.346,58 ",2803135386,CFD," 0,00 "
04/09/2024 15:30:39,Open Position,NSDQ100/USD," 840,00 ",0.886270," 0,00 "," 7.406,55 "," 2.506,58 ",2803346498,CFD," 0,00 "
04/09/2024 15:30:54,Open Position,NSDQ100/USD," 1.000,00 ",1.055919," 0,00 "," 7.406,55 "," 1.506,58 ",2803346722,CFD," 0,00 "
04/09/2024 15:31:39,Open Position,NSDQ100/USD," 1.000,00 ",1.055201," 0,00 "," 7.406,55 "," 506,58 ",2803347311,CFD," 0,00 "
04/09/2024 15:32:16,Position closed,NSDQ100/USD," 998,90 ",1.055201,"(1,10)"," 7.405,45 "," 1.505,48 ",2803347311,CFD," 0,00 "
04/09/2024 15:32:43,Position closed,NSDQ100/USD," 840,58 ",0.886270," 0,58 "," 7.406,03 "," 2.346,06 ",2803346498,CFD," 0,00 "
04/09/2024 15:33:58,Position closed,NSDQ100/USD," 652,09 ",0.685161," 2,09 "," 7.408,12 "," 2.998,15 ",2803273763,CFD," 0,00 "
04/09/2024 15:34:04,Position closed,NSDQ100/USD," 1.001,32 ",1.053944," 1,32 "," 7.409,44 "," 3.999,47 ",2803345559,CFD," 0,00 "
04/09/2024 15:34:12,Open Position,NSDQ100/USD," 1.000,00 ",1.054177," 0,00 "," 7.409,44 "," 2.999,47 ",2803348819,CFD," 0,00 "
04/09/2024 15:34:50,Position closed,NSDQ100/USD," 1.004,70 ",1.054177," 4,70 "," 7.414,14 "," 4.004,17 ",2803348819,CFD," 0,00 "
04/09/2024 15:35:15,Open Position,NSDQ100/USD," 1.099,99 ",1.160280," 0,00 "," 7.414,14 "," 2.904,18 ",2803349774,CFD," 0,00 "
04/09/2024 15:36:19,Open Position,NSDQ100/USD," 729,99 ",0.769712," 0,00 "," 7.414,14 "," 2.174,19 ",2803350415,CFD," 0,00 "
04/09/2024 15:37:15,Position closed,NSDQ100/USD," 736,42 ",0.769712," 6,43 "," 7.420,57 "," 2.910,61 ",2803350415,CFD," 0,00 "
04/09/2024 15:37:46,Open Position,NSDQ100/USD," 1.000,00 ",1.054333," 0,00 "," 7.420,57 "," 1.910,61 ",2803350941,CFD," 0,00 "
04/09/2024 15:38:15,Open Position,NSDQ100/USD," 700,00 ",0.737936," 0,00 "," 7.420,57 "," 1.210,61 ",2803351106,CFD," 0,00 "
04/09/2024 15:38:44,Position closed,NSDQ100/USD," 704,99 ",0.737936," 4,99 "," 7.425,56 "," 1.915,60 ",2803351106,CFD," 0,00 "
04/09/2024 15:38:47,Position closed,NSDQ100/USD," 1.003,54 ",1.054333," 3,54 "," 7.429,10 "," 2.919,14 ",2803350941,CFD," 0,00 "
04/09/2024 15:39:02,Position closed,NSDQ100/USD," 1.094,37 ",1.160280,"(5,62)"," 7.423,48 "," 4.013,51 ",2803349774,CFD," 0,00 "
04/09/2024 15:39:44,Open Position,NSDQ100/USD," 1.099,99 ",1.160850," 0,00 "," 7.423,48 "," 2.913,52 ",2803352058,CFD," 0,00 "
04/09/2024 15:41:01,Position closed,NSDQ100/USD," 997,42 ",1.055919,"(2,58)"," 7.420,90 "," 3.910,94 ",2803346722,CFD," 0,00 "
04/09/2024 15:41:07,Position closed,NSDQ100/USD," 1.105,40 ",1.160850," 5,41 "," 7.426,31 "," 5.016,34 ",2803352058,CFD," 0,00 "
04/09/2024 15:41:17,Open Position,NSDQ100/USD," 1.299,99 ",1.372420," 0,00 "," 7.426,31 "," 3.716,35 ",2803353181,CFD," 0,00 "
04/09/2024 15:41:38,Open Position,NSDQ100/USD," 929,99 ",0.981622," 0,00 "," 7.426,31 "," 2.786,36 ",2803353463,CFD," 0,00 "
04/09/2024 15:41:46,Position closed,NSDQ100/USD," 935,84 ",0.981622," 5,85 "," 7.432,16 "," 3.722,20 ",2803353463,CFD," 0,00 "
04/09/2024 15:41:50,Position closed,NSDQ100/USD," 1.300,76 ",1.372420," 0,77 "," 7.432,93 "," 5.022,96 ",2803353181,CFD," 0,00 "
04/09/2024 15:42:04,Open Position,NSDQ100/USD," 1.299,99 ",1.372268," 0,00 "," 7.432,93 "," 3.722,97 ",2803353644,CFD," 0,00 "
04/09/2024 15:42:15,Position closed,NSDQ100/USD," 1.308,44 ",1.372268," 8,45 "," 7.441,38 "," 5.031,41 ",2803353644,CFD," 0,00 "
04/09/2024 15:42:47,Open Position,NSDQ100/USD," 1.299,99 ",1.372666," 0,00 "," 7.441,38 "," 3.731,42 ",2803354340,CFD," 0,00 "
04/09/2024 15:43:10,Open Position,NSDQ100/USD," 939,99 ",0.992428," 0,00 "," 7.441,38 "," 2.791,43 ",2803354634,CFD," 0,00 "
04/09/2024 15:44:22,Open Position,NSDQ100/USD," 700,00 ",0.738660," 0,00 "," 7.441,38 "," 2.091,43 ",2803355792,CFD," 0,00 "
04/09/2024 15:45:00,Position closed,NSDQ100/USD," 941,34 ",0.992428," 1,35 "," 7.442,73 "," 3.032,77 ",2803354634,CFD," 0,00 "
04/09/2024 15:45:07,Position closed,NSDQ100/USD," 703,15 ",0.738660," 3,15 "," 7.445,88 "," 3.735,92 ",2803355792,CFD," 0,00 "
04/09/2024 15:45:26,Open Position,NSDQ100/USD," 939,99 ",0.991957," 0,00 "," 7.445,88 "," 2.795,93 ",2803356491,CFD," 0,00 "
04/09/2024 15:45:45,Open Position,NSDQ100/USD," 700,00 ",0.738469," 0,00 "," 7.445,88 "," 2.095,93 ",2803356676,CFD," 0,00 "
04/09/2024 15:46:55,Open Position,NSDQ100/USD," 530,00 ",0.558964," 0,00 "," 7.445,88 "," 1.565,93 ",2803358986,CFD," 0,00 "
04/09/2024 15:47:25,Open Position,NSDQ100/USD," 399,99 ",0.421853," 0,00 "," 7.445,88 "," 1.165,94 ",2803360048,CFD," 0,00 "
04/09/2024 15:52:10,Position closed,NSDQ100/USD," 531,32 ",0.558964," 1,32 "," 7.447,20 "," 1.697,26 ",2803358986,CFD," 0,00 "
04/09/2024 15:54:32,Open Position,NSDQ100/USD," 1.000,00 ",1.053505," 0,00 "," 7.447,20 "," 697,26 ",2803366484,CFD," 0,00 "
04/09/2024 15:56:51,Position closed,NSDQ100/USD," 1.043,89 ",1.053505," 43,89 "," 7.491,09 "," 1.741,15 ",2803366484,CFD," 0,00 "
04/09/2024 15:57:00,Position closed,NSDQ100/USD," 407,02 ",0.421853," 7,03 "," 7.498,12 "," 2.148,17 ",2803360048,CFD," 0,00 "
04/09/2024 15:57:05,Position closed,NSDQ100/USD," 943,12 ",0.991957," 3,13 "," 7.501,25 "," 3.091,29 ",2803356491,CFD," 0,00 "
04/09/2024 15:57:09,Position closed,NSDQ100/USD," 706,17 ",0.738469," 6,17 "," 7.507,42 "," 3.797,46 ",2803356676,CFD," 0,00 "
04/09/2024 15:58:18,Open Position,NSDQ100/USD," 949,99 ",1.002430," 0,00 "," 7.507,42 "," 2.847,47 ",2803370211,CFD," 0,00 "
04/09/2024 15:59:12,Open Position,NSDQ100/USD," 1.000,00 ",1.054511," 0,00 "," 7.507,42 "," 1.847,47 ",2803371020,CFD," 0,00 "
04/09/2024 16:00:35,Position closed,NSDQ100/USD," 1.009,34 ",1.054511," 9,34 "," 7.516,76 "," 2.856,81 ",2803371020,CFD," 0,00 "
04/09/2024 16:01:46,Open Position,NSDQ100/USD," 1.499,99 ",1.581767," 0,00 "," 7.516,76 "," 1.356,82 ",2803371970,CFD," 0,00 "
04/09/2024 16:02:30,Position closed,NSDQ100/USD," 1.521,76 ",1.581767," 21,77 "," 7.538,53 "," 2.878,58 ",2803371970,CFD," 0,00 "
04/09/2024 16:02:33,Position closed,NSDQ100/USD," 951,15 ",1.002430," 1,16 "," 7.539,69 "," 3.829,73 ",2803370211,CFD," 0,00 "
04/09/2024 16:03:51,Open Position,NSDQ100/USD," 1.999,99 ",2.109990," 0,00 "," 7.539,69 "," 1.829,74 ",2803372820,CFD," 0,00 "
04/09/2024 16:04:33,Position closed,NSDQ100/USD," 2.017,21 ",2.109990," 17,22 "," 7.556,91 "," 3.846,95 ",2803372820,CFD," 0,00 "
04/09/2024 16:04:45,Position closed,NSDQ100/USD," 1.296,09 ",1.372666,"(3,90)"," 7.553,01 "," 5.143,04 ",2803354340,CFD," 0,00 "
04/09/2024 16:05:54,Open Position,NSDQ100/USD," 1.299,99 ",1.372398," 0,00 "," 7.553,01 "," 3.843,05 ",2803373963,CFD," 0,00 "
04/09/2024 16:07:33,Open Position,NSDQ100/USD," 969,99 ",1.023588," 0,00 "," 7.553,01 "," 2.873,06 ",2803374490,CFD," 0,00 "
04/09/2024 16:10:28,Open Position,NSDQ100/USD," 1.499,99 ",1.582092," 0,00 "," 7.553,01 "," 1.373,07 ",2803376549,CFD," 0,00 "
04/09/2024 16:11:02,Open Position,NSDQ100/USD," 499,99 ",0.527188," 0,00 "," 7.553,01 "," 873,08 ",2803376946,CFD," 0,00 "
04/09/2024 16:12:15,Position closed,NSDQ100/USD," 969,03 ",1.023588,"(0,96)"," 7.552,05 "," 1.842,11 ",2803374490,CFD," 0,00 "
04/09/2024 16:12:22,Position closed,NSDQ100/USD," 1.515,43 ",1.582092," 15,44 "," 7.567,49 "," 3.357,54 ",2803376549,CFD," 0,00 "
04/09/2024 16:12:28,Position closed,NSDQ100/USD," 506,03 ",0.527188," 6,04 "," 7.573,53 "," 3.863,57 ",2803376946,CFD," 0,00 "
04/09/2024 16:26:20,Open Position,NSDQ100/USD," 1.499,99 ",1.578995," 0,00 "," 7.573,53 "," 2.363,58 ",2803384659,CFD," 0,00 "
04/09/2024 16:27:30,Open Position,NSDQ100/USD," 1.000,00 ",1.052580," 0,00 "," 7.573,53 "," 1.363,58 ",2803385526,CFD," 0,00 "
04/09/2024 16:29:29,Position closed,NSDQ100/USD," 1.508,74 ",1.578995," 8,75 "," 7.582,28 "," 2.872,32 ",2803384659,CFD," 0,00 "
04/09/2024 16:30:12,Open Position,NSDQ100/USD," 1.499,99 ",1.578189," 0,00 "," 7.582,28 "," 1.372,33 ",2803386905,CFD," 0,00 "
04/09/2024 16:31:12,Open Position,NSDQ100/USD," 500,00 ",0.525924," 0,00 "," 7.582,28 "," 872,33 ",2803387412,CFD," 0,00 "
04/09/2024 16:35:08,Open Position,NSDQ100/USD," 500,00 ",0.525314," 0,00 "," 7.582,28 "," 372,33 ",2803390242,CFD," 0,00 "
04/09/2024 16:46:31,Position closed,NSDQ100/USD," 1.021,73 ",1.052580," 21,73 "," 7.604,01 "," 1.394,06 ",2803385526,CFD," 0,00 "
04/09/2024 16:46:45,Position closed,NSDQ100/USD," 1.540,61 ",1.578189," 40,62 "," 7.644,63 "," 2.934,67 ",2803386905,CFD," 0,00 "
04/09/2024 16:46:54,Position closed,NSDQ100/USD," 514,90 ",0.525924," 14,90 "," 7.659,53 "," 3.449,57 ",2803387412,CFD," 0,00 "
04/09/2024 16:47:01,Position closed,NSDQ100/USD," 524,50 ",0.525314," 24,50 "," 7.684,03 "," 3.974,07 ",2803390242,CFD," 0,00 "
04/09/2024 16:52:19,Open Position,NSDQ100/USD," 1.000,00 ",1.052514," 0,00 "," 7.684,03 "," 2.974,07 ",2803399869,CFD," 0,00 "
04/09/2024 16:53:01,Open Position,NSDQ100/USD," 749,93 ",0.788974," 0,00 "," 7.684,03 "," 2.224,14 ",2803400394,CFD," 0,00 "
04/09/2024 16:55:05,Open Position,NSDQ100/USD," 700,00 ",0.736670," 0,00 "," 7.684,03 "," 1.524,14 ",2803404121,CFD," 0,00 "
04/09/2024 16:58:43,Open Position,NSDQ100/USD," 500,00 ",0.525778," 0,00 "," 7.684,03 "," 1.024,14 ",2803405364,CFD," 0,00 "
04/09/2024 17:19:41,Position closed,NSDQ100/USD," 1.003,83 ",1.052514," 3,83 "," 7.687,86 "," 2.027,97 ",2803399869,CFD," 0,00 "
04/09/2024 17:23:01,Open Position,NSDQ100/USD," 1.000,00 ",1.052038," 0,00 "," 7.687,86 "," 1.027,97 ",2803416158,CFD," 0,00 "
04/09/2024 17:24:21,Position closed,NSDQ100/USD," 704,89 ",0.736670," 4,89 "," 7.692,75 "," 1.732,86 ",2803404121,CFD," 0,00 "
04/09/2024 17:24:55,Position closed,NSDQ100/USD," 1.018,56 ",1.052038," 18,56 "," 7.711,31 "," 2.751,42 ",2803416158,CFD," 0,00 "
04/09/2024 17:25:02,Position closed,NSDQ100/USD," 512,90 ",0.525778," 12,90 "," 7.724,21 "," 3.264,32 ",2803405364,CFD," 0,00 "
04/09/2024 17:25:09,Position closed,NSDQ100/USD," 761,16 ",0.788974," 11,23 "," 7.735,44 "," 4.025,48 ",2803400394,CFD," 0,00 "
04/09/2024 17:29:30,Open Position,NSDQ100/USD," 1.099,99 ",1.159229," 0,00 "," 7.735,44 "," 2.925,49 ",2803419467,CFD," 0,00 "
04/09/2024 17:30:09,Open Position,NSDQ100/USD," 1.000,00 ",1.054155," 0,00 "," 7.735,44 "," 1.925,49 ",2803419842,CFD," 0,00 "
04/09/2024 17:31:06,Position closed,NSDQ100/USD," 1.104,45 ",1.159229," 4,46 "," 7.739,90 "," 3.029,94 ",2803419467,CFD," 0,00 "
04/09/2024 17:33:00,Open Position,NSDQ100/USD," 759,99 ",0.801141," 0,00 "," 7.739,90 "," 2.269,95 ",2803420732,CFD," 0,00 "
04/09/2024 17:36:19,Position closed,NSDQ100/USD," 1.001,11 ",1.054155," 1,11 "," 7.741,01 "," 3.271,06 ",2803419842,CFD," 0,00 "
04/09/2024 17:37:47,Open Position,NSDQ100/USD," 1.000,00 ",1.053567," 0,00 "," 7.741,01 "," 2.271,06 ",2803422003,CFD," 0,00 "
04/09/2024 17:38:21,Position closed,NSDQ100/USD," 1.010,06 ",1.053567," 10,06 "," 7.751,07 "," 3.281,12 ",2803422003,CFD," 0,00 "
04/09/2024 17:38:41,Position closed,NSDQ100/USD," 760,27 ",0.801141," 0,28 "," 7.751,35 "," 4.041,39 ",2803420732,CFD," 0,00 "
04/09/2024 17:43:07,Open Position,NSDQ100/USD," 499,98 ",0.527097," 0,00 "," 7.751,35 "," 3.541,41 ",2803423590,CFD," 0,00 "
04/09/2024 17:43:46,Position closed,NSDQ100/USD," 501,17 ",0.527097," 1,19 "," 7.752,54 "," 4.042,58 ",2803423590,CFD," 0,00 "
04/09/2024 17:44:09,Open Position,NSDQ100/USD," 1.099,99 ",1.160292," 0,00 "," 7.752,54 "," 2.942,59 ",2803423873,CFD," 0,00 "
04/09/2024 17:44:27,Open Position,NSDQ100/USD," 500,00 ",0.527255," 0,00 "," 7.752,54 "," 2.442,59 ",2803423957,CFD," 0,00 "
04/09/2024 17:46:51,Open Position,NSDQ100/USD," 1.000,00 ",1.054044," 0,00 "," 7.752,54 "," 1.442,59 ",2803425002,CFD," 0,00 "
04/09/2024 17:56:34,Position closed,NSDQ100/USD," 1.006,81 ",1.054044," 6,81 "," 7.759,35 "," 2.449,40 ",2803425002,CFD," 0,00 "
04/09/2024 18:05:31,Position closed,NSDQ100/USD," 1.304,05 ",1.372398," 4,06 "," 7.763,41 "," 3.753,45 ",2803373963,CFD," 0,00 "
04/09/2024 18:11:41,Position closed,NSDQ100/USD," 505,94 ",0.527255," 5,94 "," 7.769,35 "," 4.259,39 ",2803423957,CFD," 0,00 "
04/09/2024 18:12:17,Position closed,NSDQ100/USD," 1.107,37 ",1.160292," 7,38 "," 7.776,73 "," 5.366,76 ",2803423873,CFD," 0,00 "
04/09/2024 18:13:32,Open Position,NSDQ100/USD," 1.400,00 ",1.476245," 0,00 "," 7.776,73 "," 3.966,76 ",2803437259,CFD," 0,00 "
04/09/2024 18:14:03,Open Position,NSDQ100/USD," 1.000,00 ",1.054483," 0,00 "," 7.776,73 "," 2.966,76 ",2803437432,CFD," 0,00 "
04/09/2024 18:16:21,Open Position,NSDQ100/USD," 749,99 ",0.790629," 0,00 "," 7.776,73 "," 2.216,77 ",2803438053,CFD," 0,00 "
04/09/2024 18:17:06,Position closed,NSDQ100/USD," 756,99 ",0.790629," 7,00 "," 7.783,73 "," 2.973,76 ",2803438053,CFD," 0,00 "
04/09/2024 18:17:59,Open Position,NSDQ100/USD," 500,00 ",0.527325," 0,00 "," 7.783,73 "," 2.473,76 ",2803438697,CFD," 0,00 "
04/09/2024 18:18:19,Position closed,NSDQ100/USD," 1.420,61 ",1.476245," 20,61 "," 7.804,34 "," 3.894,37 ",2803437259,CFD," 0,00 "
04/09/2024 18:18:21,Position closed,NSDQ100/USD," 1.015,25 ",1.054483," 15,25 "," 7.819,59 "," 4.909,62 ",2803437432,CFD," 0,00 "
04/09/2024 18:19:07,Position closed,NSDQ100/USD," 508,68 ",0.527325," 8,68 "," 7.828,27 "," 5.418,30 ",2803438697,CFD," 0,00 "
04/09/2024 18:22:12,Open Position,NSDQ100/USD," 1.400,00 ",1.478006," 0,00 "," 7.828,27 "," 4.018,30 ",2803440386,CFD," 0,00 "
04/09/2024 18:26:55,Open Position,NSDQ100/USD," 1.099,99 ",1.159705," 0,00 "," 7.828,27 "," 2.918,31 ",2803442801,CFD," 0,00 "
04/09/2024 18:34:37,Position closed,NSDQ100/USD," 1.126,50 ",1.159705," 26,51 "," 7.854,78 "," 4.044,81 ",2803442801,CFD," 0,00 "
04/09/2024 18:35:06,Position closed,NSDQ100/USD," 1.423,15 ",1.478006," 23,15 "," 7.877,93 "," 5.467,96 ",2803440386,CFD," 0,00 "
04/09/2024 18:39:53,Open Position,NSDQ100/USD," 999,97 ",1.057175," 0,00 "," 7.877,93 "," 4.467,99 ",2803449376,CFD," 0,00 "
04/09/2024 18:40:15,Open Position,NSDQ100/USD," 1.200,00 ",1.268289," 0,00 "," 7.877,93 "," 3.267,99 ",2803449480,CFD," 0,00 "
04/09/2024 18:48:16,Open Position,NSDQ100/USD," 820,00 ",0.867278," 0,00 "," 7.877,93 "," 2.447,99 ",2803453829,CFD," 0,00 "
04/09/2024 18:51:43,Position closed,NSDQ100/USD," 571,45 ",0.592034," 11,46 "," 7.889,39 "," 3.019,44 ",2803115951,CFD," 0,00 "
04/09/2024 18:54:06,Position closed,NSDQ100/USD," 1.079,33 ",1.164617,"(20,66)"," 7.868,73 "," 4.098,77 ",2803107575,CFD," 0,00 "
04/09/2024 18:54:06,Position closed,NSDQ100/USD," 754,00 ",0.793099," 4,01 "," 7.872,74 "," 4.852,77 ",2803113458,CFD," 0,00 "
04/09/2024 18:54:06,Position closed,NSDQ100/USD," 1.219,10 ",1.268289," 19,10 "," 7.891,84 "," 6.071,87 ",2803449480,CFD," 0,00 "
04/09/2024 18:54:06,Position closed,NSDQ100/USD," 1.010,29 ",1.057175," 10,32 "," 7.902,16 "," 7.082,16 ",2803449376,CFD," 0,00 "
04/09/2024 18:54:06,Position closed,NSDQ100/USD," 821,44 ",0.867278," 1,44 "," 7.903,60 "," 7.903,60 ",2803453829,CFD," 0,00 "
04/09/2024 18:55:18,Open Position,NSDQ100/USD," 799,99 ",0.846259," 0,00 "," 7.903,60 "," 7.103,61 ",2803455944,CFD," 0,00 "
04/09/2024 19:03:51,Open Position,NSDQ100/USD," 500,00 ",0.529564," 0,00 "," 7.903,60 "," 6.603,61 ",2803460142,CFD," 0,00 "
04/09/2024 19:03:59,Position closed,NSDQ100/USD," 819,17 ",0.846259," 19,18 "," 7.922,78 "," 7.422,78 ",2803455944,CFD," 0,00 "
04/09/2024 19:08:52,Position closed,NSDQ100/USD," 506,29 ",0.529564," 6,29 "," 7.929,07 "," 7.929,07 ",2803460142,CFD," 0,00 "
04/09/2024 19:09:38,Open Position,NSDQ100/USD," 1.999,99 ",2.120201," 0,00 "," 7.929,07 "," 5.929,08 ",2803463595,CFD," 0,00 "
04/09/2024 19:20:28,Open Position,NSDQ100/USD," 500,00 ",0.529623," 0,00 "," 7.929,07 "," 5.429,08 ",2803471122,CFD," 0,00 "
04/09/2024 19:38:30,Open Position,NSDQ100/USD," 1.400,00 ",1.480038," 0,00 "," 7.929,07 "," 4.029,08 ",2803482897,CFD," 0,00 "
04/09/2024 19:39:22,Open Position,NSDQ100/USD," 1.099,99 ",1.163102," 0,00 "," 7.929,07 "," 2.929,09 ",2803483179,CFD," 0,00 "
04/09/2024 19:47:43,Open Position,NSDQ100/USD," 499,98 ",0.528272," 0,00 "," 7.929,07 "," 2.429,11 ",2803490532,CFD," 0,00 "
04/09/2024 20:25:43,Open Position,NSDQ100/USD," 609,98 ",0.645653," 0,00 "," 7.929,07 "," 1.819,13 ",2803503285,CFD," 0,00 "
04/09/2024 20:30:25,Open Position,NSDQ100/USD," 799,99 ",0.846302," 0,00 "," 7.929,07 "," 1.019,14 ",2803503661,CFD," 0,00 "
04/09/2024 20:32:32,Open Position,NSDQ100/USD," 500,00 ",0.528650," 0,00 "," 7.929,07 "," 519,14 ",2803503772,CFD," 0,00 "
04/09/2024 23:43:39,Position closed,NSDQ100/USD," 514,78 ",0.529623," 14,78 "," 7.943,85 "," 1.033,92 ",2803471122,CFD," 0,00 "
04/09/2024 23:43:39,Position closed,NSDQ100/USD," 2.026,94 ",2.120201," 26,95 "," 7.970,80 "," 3.060,86 ",2803463595,CFD," 0,00 "
04/09/2024 23:43:39,Position closed,NSDQ100/USD," 1.171,53 ",1.163102," 71,54 "," 8.042,34 "," 4.232,39 ",2803483179,CFD," 0,00 "
04/09/2024 23:43:39,Position closed,NSDQ100/USD," 1.496,22 ",1.480038," 96,22 "," 8.138,56 "," 5.728,61 ",2803482897,CFD," 0,00 "
04/09/2024 23:43:39,Position closed,NSDQ100/USD," 533,13 ",0.528650," 33,13 "," 8.171,69 "," 6.261,74 ",2803503772,CFD," 0,00 "
04/09/2024 23:43:39,Position closed,NSDQ100/USD," 844,47 ",0.846302," 44,48 "," 8.216,17 "," 7.106,21 ",2803503661,CFD," 0,00 "
04/09/2024 23:43:39,Position closed,NSDQ100/USD," 540,03 ",0.528272," 40,05 "," 8.256,22 "," 7.646,24 ",2803490532,CFD," 0,00 "
04/09/2024 23:43:39,Position closed,NSDQ100/USD," 637,14 ",0.645653," 27,16 "," 8.283,38 "," 8.283,38 ",2803503285,CFD," 0,00 "
05/09/2024 00:22:42,Dividend,NSDQ100/USD,"(2,65)",-,"(2,65)"," 8.280,73 "," 8.280,73 ",2803463595,CFD," 0,00 "
05/09/2024 00:22:42,Dividend,NSDQ100/USD,"(0,66)",-,"(0,66)"," 8.280,07 "," 8.280,07 ",2803471122,CFD," 0,00 "
05/09/2024 00:22:43,Dividend,NSDQ100/USD,"(1,85)",-,"(1,85)"," 8.278,22 "," 8.278,22 ",2803482897,CFD," 0,00 "
05/09/2024 00:22:43,Dividend,NSDQ100/USD,"(1,46)",-,"(1,46)"," 8.276,76 "," 8.276,76 ",2803483179,CFD," 0,00 "
05/09/2024 00:22:43,Dividend,NSDQ100/USD,"(0,66)",-,"(0,66)"," 8.276,10 "," 8.276,10 ",2803490532,CFD," 0,00 "
05/09/2024 00:48:55,Overnight refund,Daily," 0,23 ",-," 0,23 "," 8.276,33 "," 8.276,33 ",2803482897,CFD," 0,00 "
05/09/2024 00:48:55,Overnight refund,Daily," 0,08 ",-," 0,08 "," 8.276,41 "," 8.276,41 ",2803503772,CFD," 0,00 "
05/09/2024 00:48:55,Overnight refund,Daily," 0,13 ",-," 0,13 "," 8.276,54 "," 8.276,54 ",2803503661,CFD," 0,00 "
05/09/2024 00:48:55,Overnight refund,Daily," 0,18 ",-," 0,18 "," 8.276,72 "," 8.276,72 ",2803483179,CFD," 0,00 "
05/09/2024 00:48:55,Overnight refund,Daily," 0,34 ",-," 0,34 "," 8.277,06 "," 8.277,06 ",2803463595,CFD," 0,00 "
05/09/2024 00:48:55,Overnight refund,Daily," 0,08 ",-," 0,08 "," 8.277,14 "," 8.277,14 ",2803471122,CFD," 0,00 "
05/09/2024 00:48:55,Overnight refund,Daily," 0,08 ",-," 0,08 "," 8.277,22 "," 8.277,22 ",2803490532,CFD," 0,00 "
05/09/2024 00:48:55,Overnight refund,Daily," 0,10 ",-," 0,10 "," 8.277,32 "," 8.277,32 ",2803503285,CFD," 0,00 "
05/09/2024 07:19:03,Open Position,NSDQ100/USD," 829,99 ",0.877597," 0,00 "," 8.277,32 "," 7.447,33 ",2803554626,CFD," 0,00 "
05/09/2024 07:20:26,Open Position,NSDQ100/USD," 499,99 ",0.528367," 0,00 "," 8.277,32 "," 6.947,34 ",2803554857,CFD," 0,00 "
05/09/2024 07:28:02,Open Position,NSDQ100/USD," 500,00 ",0.528575," 0,00 "," 8.277,32 "," 6.447,34 ",2803568496,CFD," 0,00 "
05/09/2024 07:30:35,Position closed,NSDQ100/USD," 503,67 ",0.528367," 3,68 "," 8.281,00 "," 6.951,01 ",2803554857,CFD," 0,00 "
05/09/2024 07:31:37,Open Position,NSDQ100/USD," 1.000,00 ",1.056095," 0,00 "," 8.281,00 "," 5.951,01 ",2803573033,CFD," 0,00 "
05/09/2024 07:33:13,Open Position,NSDQ100/USD," 500,00 ",0.527861," 0,00 "," 8.281,00 "," 5.451,01 ",2803577014,CFD," 0,00 "
05/09/2024 07:40:29,Open Position,NSDQ100/USD," 700,00 ",0.738537," 0,00 "," 8.281,00 "," 4.751,01 ",2803578683,CFD," 0,00 "
05/09/2024 07:42:06,Position closed,NSDQ100/USD," 704,18 ",0.738537," 4,18 "," 8.285,18 "," 5.455,19 ",2803578683,CFD," 0,00 "
05/09/2024 07:44:57,Open Position,NSDQ100/USD," 500,00 ",0.527638," 0,00 "," 8.285,18 "," 4.955,19 ",2803580737,CFD," 0,00 "
05/09/2024 07:45:23,Position closed,NSDQ100/USD," 503,04 ",0.527638," 3,04 "," 8.288,22 "," 5.458,23 ",2803580737,CFD," 0,00 "
05/09/2024 07:46:24,Position closed,NSDQ100/USD," 502,57 ",0.527861," 2,57 "," 8.290,79 "," 5.960,80 ",2803577014,CFD," 0,00 "
05/09/2024 07:49:22,Open Position,NSDQ100/USD," 1.500,00 ",1.583065," 0,00 "," 8.290,79 "," 4.460,80 ",2803581463,CFD," 0,00 "
05/09/2024 07:51:17,Position closed,NSDQ100/USD," 1.512,44 ",1.583065," 12,44 "," 8.303,23 "," 5.973,24 ",2803581463,CFD," 0,00 "
05/09/2024 07:51:28,Position closed,NSDQ100/USD," 996,37 ",1.056095,"(3,63)"," 8.299,60 "," 6.969,61 ",2803573033,CFD," 0,00 "
05/09/2024 07:54:39,Open Position,NSDQ100/USD," 1.800,00 ",1.899948," 0,00 "," 8.299,60 "," 5.169,61 ",2803582411,CFD," 0,00 "
05/09/2024 07:55:04,Open Position,NSDQ100/USD," 1.299,99 ",1.371729," 0,00 "," 8.299,60 "," 3.869,62 ",2803582488,CFD," 0,00 "
05/09/2024 08:00:21,Position closed,NSDQ100/USD," 1.305,28 ",1.371729," 5,29 "," 8.304,89 "," 5.174,90 ",2803582488,CFD," 0,00 "
05/09/2024 08:00:47,Open Position,NSDQ100/USD," 1.300,00 ",1.372156," 0,00 "," 8.304,89 "," 3.874,90 ",2803584282,CFD," 0,00 "
05/09/2024 08:01:39,Position closed,NSDQ100/USD," 1.301,59 ",1.372156," 1,59 "," 8.306,48 "," 5.176,49 ",2803584282,CFD," 0,00 "
05/09/2024 08:01:44,Position closed,NSDQ100/USD," 1.806,00 ",1.899948," 6,00 "," 8.312,48 "," 6.982,49 ",2803582411,CFD," 0,00 "
05/09/2024 08:02:47,Open Position,NSDQ100/USD," 1.800,00 ",1.899878," 0,00 "," 8.312,48 "," 5.182,49 ",2803584620,CFD," 0,00 "
05/09/2024 08:03:41,Open Position,NSDQ100/USD," 1.300,00 ",1.371989," 0,00 "," 8.312,48 "," 3.882,49 ",2803584749,CFD," 0,00 "
05/09/2024 08:03:58,Position closed,NSDQ100/USD," 1.306,67 ",1.371989," 6,67 "," 8.319,15 "," 5.189,16 ",2803584749,CFD," 0,00 "
05/09/2024 08:04:03,Position closed,NSDQ100/USD," 1.805,62 ",1.899878," 5,62 "," 8.324,77 "," 6.994,78 ",2803584620,CFD," 0,00 "
05/09/2024 08:07:27,Open Position,NSDQ100/USD," 500,00 ",0.528148," 0,00 "," 8.324,77 "," 6.494,78 ",2803585421,CFD," 0,00 "
05/09/2024 08:08:34,Position closed,NSDQ100/USD," 501,30 ",0.528148," 1,30 "," 8.326,07 "," 6.996,08 ",2803585421,CFD," 0,00 "
05/09/2024 08:11:19,Open Position,NSDQ100/USD," 1.799,99 ",1.900797," 0,00 "," 8.326,07 "," 5.196,09 ",2803586171,CFD," 0,00 "
05/09/2024 08:13:12,Position closed,NSDQ100/USD," 1.805,05 ",1.900797," 5,06 "," 8.331,13 "," 7.001,14 ",2803586171,CFD," 0,00 "
05/09/2024 08:14:02,Open Position,NSDQ100/USD," 1.000,00 ",1.056140," 0,00 "," 8.331,13 "," 6.001,14 ",2803586683,CFD," 0,00 "
05/09/2024 08:14:13,Position closed,NSDQ100/USD," 1.004,39 ",1.056140," 4,39 "," 8.335,52 "," 7.005,53 ",2803586683,CFD," 0,00 "
05/09/2024 08:15:28,Open Position,NSDQ100/USD," 499,99 ",0.527976," 0,00 "," 8.335,52 "," 6.505,54 ",2803586958,CFD," 0,00 "
05/09/2024 08:16:24,Position closed,NSDQ100/USD," 500,29 ",0.527976," 0,30 "," 8.335,82 "," 7.005,83 ",2803586958,CFD," 0,00 "
05/09/2024 08:16:43,Open Position,NSDQ100/USD," 1.800,00 ",1.900711," 0,00 "," 8.335,82 "," 5.205,83 ",2803587393,CFD," 0,00 "
05/09/2024 08:17:24,Position closed,NSDQ100/USD," 1.801,06 ",1.900711," 1,06 "," 8.336,88 "," 7.006,89 ",2803587393,CFD," 0,00 "
05/09/2024 08:19:32,Open Position,NSDQ100/USD," 999,99 ",1.056428," 0,00 "," 8.336,88 "," 6.006,90 ",2803588015,CFD," 0,00 "
05/09/2024 08:20:14,Position closed,NSDQ100/USD," 1.002,17 ",1.056428," 2,18 "," 8.339,06 "," 7.009,07 ",2803588015,CFD," 0,00 "
05/09/2024 08:22:03,Open Position,NSDQ100/USD," 500,00 ",0.528279," 0,00 "," 8.339,06 "," 6.509,07 ",2803588661,CFD," 0,00 "
05/09/2024 08:24:51,Open Position,NSDQ100/USD," 1.000,00 ",1.056145," 0,00 "," 8.339,06 "," 5.509,07 ",2803589361,CFD," 0,00 "
05/09/2024 08:27:17,Open Position,NSDQ100/USD," 1.000,00 ",1.055900," 0,00 "," 8.339,06 "," 4.509,07 ",2803590107,CFD," 0,00 "
05/09/2024 08:32:24,Position closed,NSDQ100/USD," 1.008,09 ",1.055900," 8,09 "," 8.347,15 "," 5.517,16 ",2803590107,CFD," 0,00 "
05/09/2024 08:32:29,Position closed,NSDQ100/USD," 1.000,38 ",1.056145," 0,38 "," 8.347,53 "," 6.517,54 ",2803589361,CFD," 0,00 "
05/09/2024 08:33:14,Position closed,NSDQ100/USD," 499,98 ",0.528279,"(0,02)"," 8.347,51 "," 7.017,52 ",2803588661,CFD," 0,00 "
05/09/2024 08:34:12,Open Position,NSDQ100/USD," 1.800,00 ",1.901604," 0,00 "," 8.347,51 "," 5.217,52 ",2803591866,CFD," 0,00 "
05/09/2024 08:34:39,Position closed,NSDQ100/USD," 1.807,34 ",1.901604," 7,34 "," 8.354,85 "," 7.024,86 ",2803591866,CFD," 0,00 "
05/09/2024 08:35:06,Position closed,NSDQ100/USD," 495,54 ",0.528575,"(4,46)"," 8.350,39 "," 7.520,40 ",2803568496,CFD," 0,00 "
05/09/2024 08:35:29,Open Position,NSDQ100/USD," 999,99 ",1.056746," 0,00 "," 8.350,39 "," 6.520,41 ",2803592076,CFD," 0,00 "
05/09/2024 08:37:33,Position closed,NSDQ100/USD," 1.001,64 ",1.056746," 1,65 "," 8.352,04 "," 7.522,05 ",2803592076,CFD," 0,00 "
05/09/2024 08:40:53,Open Position,NSDQ100/USD," 499,99 ",0.528088," 0,00 "," 8.352,04 "," 7.022,06 ",2803593171,CFD," 0,00 "
05/09/2024 08:41:16,Open Position,NSDQ100/USD," 1.800,00 ",1.901514," 0,00 "," 8.352,04 "," 5.222,06 ",2803593245,CFD," 0,00 "
05/09/2024 08:44:13,Position closed,NSDQ100/USD," 1.804,11 ",1.901514," 4,11 "," 8.356,15 "," 7.026,17 ",2803593245,CFD," 0,00 "
05/09/2024 08:46:48,Open Position,NSDQ100/USD," 1.800,00 ",1.901966," 0,00 "," 8.356,15 "," 5.226,17 ",2803594073,CFD," 0,00 "
05/09/2024 08:50:48,Open Position,NSDQ100/USD," 1.000,00 ",1.056419," 0,00 "," 8.356,15 "," 4.226,17 ",2803595135,CFD," 0,00 "
05/09/2024 08:51:33,Position closed,NSDQ100/USD," 1.800,68 ",1.901966," 0,68 "," 8.356,83 "," 6.026,85 ",2803594073,CFD," 0,00 "
05/09/2024 08:51:37,Position closed,NSDQ100/USD," 1.005,66 ",1.056419," 5,66 "," 8.362,49 "," 7.032,51 ",2803595135,CFD," 0,00 "
05/09/2024 08:53:42,Open Position,NSDQ100/USD," 1.800,00 ",1.901253," 0,00 "," 8.362,49 "," 5.232,51 ",2803595643,CFD," 0,00 "
05/09/2024 08:53:49,Position closed,NSDQ100/USD," 499,76 ",0.528088,"(0,23)"," 8.362,26 "," 5.732,27 ",2803593171,CFD," 0,00 "
05/09/2024 08:55:54,Position closed,NSDQ100/USD," 1.807,34 ",1.901253," 7,34 "," 8.369,60 "," 7.539,61 ",2803595643,CFD," 0,00 "
05/09/2024 08:58:29,Open Position,NSDQ100/USD," 1.899,99 ",2.007482," 0,00 "," 8.369,60 "," 5.639,62 ",2803596453,CFD," 0,00 "
05/09/2024 09:00:35,Position closed,NSDQ100/USD," 1.911,35 ",2.007482," 11,36 "," 8.380,96 "," 7.550,97 ",2803596453,CFD," 0,00 "
05/09/2024 09:01:34,Position closed,NSDQ100/USD," 832,68 ",0.877597," 2,69 "," 8.383,65 "," 8.383,65 ",2803554626,CFD," 0,00 "
05/09/2024 09:01:56,Open Position,NSDQ100/USD," 839,99 ",0.888551," 0,00 "," 8.383,65 "," 7.543,66 ",2803596983,CFD," 0,00 "
05/09/2024 09:05:12,Position closed,NSDQ100/USD," 839,69 ",0.888551,"(0,30)"," 8.383,35 "," 8.383,35 ",2803596983,CFD," 0,00 "
05/09/2024 09:06:22,Open Position,NSDQ100/USD," 840,00 ",0.888389," 0,00 "," 8.383,35 "," 7.543,35 ",2803607950,CFD," 0,00 "
05/09/2024 09:10:56,Open Position,NSDQ100/USD," 800,00 ",0.846851," 0,00 "," 8.383,35 "," 6.743,35 ",2803608780,CFD," 0,00 "
05/09/2024 09:11:30,Open Position,NSDQ100/USD," 1.699,98 ",1.799828," 0,00 "," 8.383,35 "," 5.043,37 ",2803609004,CFD," 0,00 "
05/09/2024 09:14:18,Position closed,NSDQ100/USD," 1.696,69 ",1.799828,"(3,29)"," 8.380,06 "," 6.740,06 ",2803609004,CFD," 0,00 "
05/09/2024 09:17:00,Open Position,NSDQ100/USD," 1.700,00 ",1.799045," 0,00 "," 8.380,06 "," 5.040,06 ",2803610241,CFD," 0,00 "
05/09/2024 09:17:26,Open Position,NSDQ100/USD," 999,99 ",1.058234," 0,00 "," 8.380,06 "," 4.040,07 ",2803610298,CFD," 0,00 "
05/09/2024 09:21:27,Open Position,NSDQ100/USD," 1.100,00 ",1.164538," 0,00 "," 8.380,06 "," 2.940,07 ",2803611995,CFD," 0,00 "
05/09/2024 09:22:42,Open Position,NSDQ100/USD," 739,99 ",0.783785," 0,00 "," 8.380,06 "," 2.200,08 ",2803612192,CFD," 0,00 "
05/09/2024 09:24:13,Open Position,NSDQ100/USD," 559,99 ",0.593384," 0,00 "," 8.380,06 "," 1.640,09 ",2803612490,CFD," 0,00 "
05/09/2024 09:24:34,Position closed,NSDQ100/USD," 561,93 ",0.593384," 1,94 "," 8.382,00 "," 2.202,02 ",2803612490,CFD," 0,00 "
05/09/2024 09:25:08,Open Position,NSDQ100/USD," 999,98 ",1.060012," 0,00 "," 8.382,00 "," 1.202,04 ",2803612819,CFD," 0,00 "
05/09/2024 09:26:15,Open Position,NSDQ100/USD," 1.000,00 ",1.060142," 0,00 "," 8.382,00 "," 202,04 ",2803613205,CFD," 0,00 "
05/09/2024 09:59:00,Position closed,NSDQ100/USD," 968,59 ",1.060142,"(31,41)"," 8.350,59 "," 1.170,63 ",2803613205,CFD," 0,00 "
05/09/2024 09:59:17,Open Position,NSDQ100/USD," 999,99 ",1.058654," 0,00 "," 8.350,59 "," 170,64 ",2803618809,CFD," 0,00 "
05/09/2024 10:27:30,Position closed,NSDQ100/USD," 830,81 ",0.888389,"(9,19)"," 8.341,40 "," 1.001,45 ",2803607950,CFD," 0,00 "
05/09/2024 10:27:30,Position closed,NSDQ100/USD," 1.702,46 ",1.799045," 2,46 "," 8.343,86 "," 2.703,91 ",2803610241,CFD," 0,00 "
05/09/2024 10:27:30,Position closed,NSDQ100/USD," 805,73 ",0.846851," 5,73 "," 8.349,59 "," 3.509,64 ",2803608780,CFD," 0,00 "
05/09/2024 10:27:30,Position closed,NSDQ100/USD," 1.000,91 ",1.058234," 0,92 "," 8.350,51 "," 4.510,55 ",2803610298,CFD," 0,00 "
05/09/2024 10:27:30,Position closed,NSDQ100/USD," 1.110,10 ",1.164538," 10,10 "," 8.360,61 "," 5.620,65 ",2803611995,CFD," 0,00 "
05/09/2024 10:27:30,Position closed,NSDQ100/USD," 1.008,85 ",1.058654," 8,86 "," 8.369,47 "," 6.629,50 ",2803618809,CFD," 0,00 "
05/09/2024 10:27:30,Position closed,NSDQ100/USD," 1.034,71 ",1.060012," 34,73 "," 8.404,20 "," 7.664,21 ",2803612819,CFD," 0,00 "
05/09/2024 10:27:30,Position closed,NSDQ100/USD," 753,76 ",0.783785," 13,77 "," 8.417,97 "," 8.417,97 ",2803612192,CFD," 0,00 "
05/09/2024 10:28:49,Open Position,NSDQ100/USD," 850,00 ",0.899732," 0,00 "," 8.417,97 "," 7.567,97 ",2803630991,CFD," 0,00 "
05/09/2024 10:29:52,Open Position,NSDQ100/USD," 999,99 ",1.058469," 0,00 "," 8.417,97 "," 6.567,98 ",2803631129,CFD," 0,00 "
05/09/2024 10:36:27,Position closed,NSDQ100/USD," 1.007,90 ",1.058469," 7,91 "," 8.425,88 "," 7.575,88 ",2803631129,CFD," 0,00 "
05/09/2024 10:36:27,Position closed,NSDQ100/USD," 857,26 ",0.899732," 7,26 "," 8.433,14 "," 8.433,14 ",2803630991,CFD," 0,00 "
05/09/2024 10:43:26,Open Position,NSDQ100/USD," 500,00 ",0.528949," 0,00 "," 8.433,14 "," 7.933,14 ",2803634171,CFD," 0,00 "
05/09/2024 10:49:00,Position closed,NSDQ100/USD," 502,25 ",0.528949," 2,25 "," 8.435,39 "," 8.435,39 ",2803634171,CFD," 0,00 "
05/09/2024 10:49:29,Open Position,NSDQ100/USD," 849,99 ",0.899681," 0,00 "," 8.435,39 "," 7.585,40 ",2803635364,CFD," 0,00 "
05/09/2024 11:00:06,Open Position,NSDQ100/USD," 1.199,99 ",1.269510," 0,00 "," 8.435,39 "," 6.385,41 ",2803637952,CFD," 0,00 "
05/09/2024 11:12:22,Position closed,NSDQ100/USD," 857,15 ",0.899681," 7,16 "," 8.442,55 "," 7.242,56 ",2803635364,CFD," 0,00 "
05/09/2024 11:13:00,Open Position,NSDQ100/USD," 999,99 ",1.058973," 0,00 "," 8.442,55 "," 6.242,57 ",2803640208,CFD," 0,00 "
05/09/2024 11:31:05,Position closed,NSDQ100/USD," 1.220,76 ",1.269510," 20,77 "," 8.463,32 "," 7.463,33 ",2803637952,CFD," 0,00 "
05/09/2024 11:31:50,Position closed,NSDQ100/USD," 1.037,02 ",1.058973," 37,03 "," 8.500,35 "," 8.500,35 ",2803640208,CFD," 0,00 "
05/09/2024 11:43:14,Open Position,NSDQ100/USD," 1.199,99 ",1.269793," 0,00 "," 8.500,35 "," 7.300,36 ",2803645733,CFD," 0,00 "
05/09/2024 11:55:36,Open Position,NSDQ100/USD," 1.900,00 ",2.012241," 0,00 "," 8.500,35 "," 5.400,36 ",2803648763,CFD," 0,00 "
05/09/2024 11:57:00,Open Position,NSDQ100/USD," 999,99 ",1.059731," 0,00 "," 8.500,35 "," 4.400,37 ",2803648974,CFD," 0,00 "
05/09/2024 12:07:26,Open Position,NSDQ100/USD," 1.199,99 ",1.273073," 0,00 "," 8.500,35 "," 3.200,38 ",2803652504,CFD," 0,00 "
05/09/2024 12:19:12,Open Position,NSDQ100/USD," 499,99 ",0.531400," 0,00 "," 8.500,35 "," 2.700,39 ",2803660152,CFD," 0,00 "
05/09/2024 12:19:40,Open Position,NSDQ100/USD," 680,00 ",0.723089," 0,00 "," 8.500,35 "," 2.020,39 ",2803660366,CFD," 0,00 "
05/09/2024 12:20:04,Open Position,NSDQ100/USD," 509,99 ",0.542189," 0,00 "," 8.500,35 "," 1.510,40 ",2803661074,CFD," 0,00 "
05/09/2024 12:21:05,Position closed,NSDQ100/USD," 684,61 ",0.723089," 4,61 "," 8.504,96 "," 2.195,01 ",2803660366,CFD," 0,00 "
05/09/2024 12:21:48,Open Position,NSDQ100/USD," 550,00 ",0.585102," 0,00 "," 8.504,96 "," 1.645,01 ",2803662743,CFD," 0,00 "
05/09/2024 12:54:35,Open Position,NSDQ100/USD," 1.000,00 ",1.061690," 0,00 "," 8.504,96 "," 645,01 ",2803676592,CFD," 0,00 "
05/09/2024 12:58:04,Position closed,NSDQ100/USD," 583,05 ",0.585102," 33,05 "," 8.538,01 "," 1.228,06 ",2803662743,CFD," 0,00 "
05/09/2024 12:58:08,Position closed,NSDQ100/USD," 974,49 ",1.061690,"(25,51)"," 8.512,50 "," 2.202,55 ",2803676592,CFD," 0,00 "
05/09/2024 12:59:07,Position closed,NSDQ100/USD," 529,01 ",0.542189," 19,02 "," 8.531,52 "," 2.731,56 ",2803661074,CFD," 0,00 "
05/09/2024 12:59:13,Position closed,NSDQ100/USD," 515,50 ",0.531400," 15,51 "," 8.547,03 "," 3.247,06 ",2803660152,CFD," 0,00 "
05/09/2024 13:00:19,Open Position,NSDQ100/USD," 999,99 ",1.061333," 0,00 "," 8.547,03 "," 2.247,07 ",2803677768,CFD," 0,00 "
05/09/2024 13:01:02,Position closed,NSDQ100/USD," 1.003,67 ",1.061333," 3,68 "," 8.550,71 "," 3.250,74 ",2803677768,CFD," 0,00 "
05/09/2024 13:01:20,Position closed,NSDQ100/USD," 1.201,99 ",1.273073," 2,00 "," 8.552,71 "," 4.452,73 ",2803652504,CFD," 0,00 "
05/09/2024 13:03:49,Open Position,NSDQ100/USD," 1.199,99 ",1.272222," 0,00 "," 8.552,71 "," 3.252,74 ",2803679570,CFD," 0,00 "
05/09/2024 13:05:51,Open Position,NSDQ100/USD," 819,99 ",0.870086," 0,00 "," 8.552,71 "," 2.432,75 ",2803679967,CFD," 0,00 "
05/09/2024 13:26:00,Position closed,NSDQ100/USD," 814,05 ",0.870086,"(5,94)"," 8.546,77 "," 3.246,80 ",2803679967,CFD," 0,00 "
05/09/2024 13:27:05,Open Position,NSDQ100/USD," 999,99 ",1.060725," 0,00 "," 8.546,77 "," 2.246,81 ",2803686227,CFD," 0,00 "
05/09/2024 13:33:22,Position closed,NSDQ100/USD," 1.909,90 ",2.012241," 9,90 "," 8.556,67 "," 4.156,71 ",2803648763,CFD," 0,00 "
05/09/2024 13:33:22,Position closed,NSDQ100/USD," 1.185,54 ",1.269793,"(14,45)"," 8.542,22 "," 5.342,25 ",2803645733,CFD," 0,00 "
05/09/2024 13:33:22,Position closed,NSDQ100/USD," 1.231,43 ",1.272222," 31,44 "," 8.573,66 "," 6.573,68 ",2803679570,CFD," 0,00 "
05/09/2024 13:33:22,Position closed,NSDQ100/USD," 1.017,60 ",1.059731," 17,61 "," 8.591,27 "," 7.591,28 ",2803648974,CFD," 0,00 "
05/09/2024 13:33:22,Position closed,NSDQ100/USD," 1.036,38 ",1.060725," 36,39 "," 8.627,66 "," 8.627,66 ",2803686227,CFD," 0,00 "
05/09/2024 13:34:07,Open Position,NSDQ100/USD," 499,99 ",0.529465," 0,00 "," 8.627,66 "," 8.127,67 ",2803735360,CFD," 0,00 "
05/09/2024 13:34:35,Open Position,NSDQ100/USD," 499,99 ",0.529555," 0,00 "," 8.627,66 "," 7.627,68 ",2803736016,CFD," 0,00 "
05/09/2024 13:34:51,Open Position,NSDQ100/USD," 499,98 ",0.529581," 0,00 "," 8.627,66 "," 7.127,70 ",2803736439,CFD," 0,00 "
05/09/2024 13:35:17,Open Position,NSDQ100/USD," 499,99 ",0.529286," 0,00 "," 8.627,66 "," 6.627,71 ",2803737249,CFD," 0,00 "
05/09/2024 13:35:53,Open Position,NSDQ100/USD," 1.699,99 ",1.798440," 0,00 "," 8.627,66 "," 4.927,72 ",2803738391,CFD," 0,00 "
05/09/2024 13:36:04,Position closed,NSDQ100/USD," 506,38 ",0.529286," 6,39 "," 8.634,05 "," 5.434,10 ",2803737249,CFD," 0,00 "
05/09/2024 13:36:04,Position closed,NSDQ100/USD," 509,77 ",0.529465," 9,78 "," 8.643,83 "," 5.943,87 ",2803735360,CFD," 0,00 "
05/09/2024 13:36:04,Position closed,NSDQ100/USD," 512,14 ",0.529581," 12,16 "," 8.655,99 "," 6.456,01 ",2803736439,CFD," 0,00 "
05/09/2024 13:36:04,Position closed,NSDQ100/USD," 511,47 ",0.529555," 11,48 "," 8.667,47 "," 6.967,48 ",2803736016,CFD," 0,00 "
05/09/2024 13:36:04,Position closed,NSDQ100/USD," 1.703,87 ",1.798440," 3,88 "," 8.671,35 "," 8.671,35 ",2803738391,CFD," 0,00 "
05/09/2024 13:36:29,Open Position,NSDQ100/USD," 869,99 ",0.920198," 0,00 "," 8.671,35 "," 7.801,36 ",2803739679,CFD," 0,00 "
05/09/2024 13:36:57,Position closed,NSDQ100/USD," 876,49 ",0.920198," 6,50 "," 8.677,85 "," 8.677,85 ",2803739679,CFD," 0,00 "
05/09/2024 13:37:20,Open Position,NSDQ100/USD," 499,99 ",0.528156," 0,00 "," 8.677,85 "," 8.177,86 ",2803741432,CFD," 0,00 "
05/09/2024 13:37:32,Open Position,NSDQ100/USD," 499,99 ",0.527956," 0,00 "," 8.677,85 "," 7.677,87 ",2803741826,CFD," 0,00 "
05/09/2024 13:37:54,Position closed,NSDQ100/USD," 504,30 ",0.528156," 4,31 "," 8.682,16 "," 8.182,17 ",2803741432,CFD," 0,00 "
05/09/2024 13:37:54,Position closed,NSDQ100/USD," 500,50 ",0.527956," 0,51 "," 8.682,67 "," 8.682,67 ",2803741826,CFD," 0,00 "
05/09/2024 13:38:22,Open Position,NSDQ100/USD," 870,00 ",0.918475," 0,00 "," 8.682,67 "," 7.812,67 ",2803743332,CFD," 0,00 "
05/09/2024 13:38:59,Open Position,NSDQ100/USD," 999,99 ",1.054870," 0,00 "," 8.682,67 "," 6.812,68 ",2803744725,CFD," 0,00 "
05/09/2024 13:39:20,Position closed,NSDQ100/USD," 827,24 ",0.918475,"(42,76)"," 8.639,91 "," 7.639,92 ",2803743332,CFD," 0,00 "
05/09/2024 13:39:25,Position closed,NSDQ100/USD," 1.025,58 ",1.054870," 25,59 "," 8.665,50 "," 8.665,50 ",2803744725,CFD," 0,00 "
05/09/2024 13:40:09,Open Position,NSDQ100/USD," 499,99 ",0.527065," 0,00 "," 8.665,50 "," 8.165,51 ",2803747036,CFD," 0,00 "
05/09/2024 13:42:17,Open Position,NSDQ100/USD," 1.000,00 ",1.055546," 0,00 "," 8.665,50 "," 7.165,51 ",2803749925,CFD," 0,00 "
05/09/2024 13:52:58,Position closed,NSDQ100/USD," 500,12 ",0.527065," 0,13 "," 8.665,63 "," 7.665,63 ",2803747036,CFD," 0,00 "
05/09/2024 13:53:50,Open Position,NSDQ100/USD," 500,00 ",0.527086," 0,00 "," 8.665,63 "," 7.165,63 ",2803810573,CFD," 0,00 "
05/09/2024 13:54:20,Open Position,NSDQ100/USD," 500,00 ",0.526647," 0,00 "," 8.665,63 "," 6.665,63 ",2803816640,CFD," 0,00 "
05/09/2024 13:54:56,Open Position,NSDQ100/USD," 1.000,00 ",1.053067," 0,00 "," 8.665,63 "," 5.665,63 ",2803819971,CFD," 0,00 "
05/09/2024 13:55:48,Position closed,NSDQ100/USD," 1.004,26 ",1.053067," 4,26 "," 8.669,89 "," 6.669,89 ",2803819971,CFD," 0,00 "
05/09/2024 13:57:06,Open Position,NSDQ100/USD," 1.000,00 ",1.052508," 0,00 "," 8.669,89 "," 5.669,89 ",2803828452,CFD," 0,00 "
05/09/2024 14:05:14,Open Position,NSDQ100/USD," 1.499,99 ",1.575496," 0,00 "," 8.669,89 "," 4.169,90 ",2803849937,CFD," 0,00 "
05/09/2024 14:07:50,Open Position,NSDQ100/USD," 500,00 ",0.524768," 0,00 "," 8.669,89 "," 3.669,90 ",2803854537,CFD," 0,00 "
05/09/2024 14:09:58,Position closed,NSDQ100/USD," 507,37 ",0.524768," 7,37 "," 8.677,26 "," 4.177,27 ",2803854537,CFD," 0,00 "
05/09/2024 14:11:12,Position closed,NSDQ100/USD," 1.533,78 ",1.575496," 33,79 "," 8.711,05 "," 5.711,05 ",2803849937,CFD," 0,00 "
05/09/2024 14:11:49,Open Position,NSDQ100/USD," 1.000,00 ",1.052536," 0,00 "," 8.711,05 "," 4.711,05 ",2803870491,CFD," 0,00 "
05/09/2024 14:15:39,Position closed,NSDQ100/USD," 1.008,04 ",1.052536," 8,04 "," 8.719,09 "," 5.719,09 ",2803870491,CFD," 0,00 "
05/09/2024 14:15:48,Position closed,NSDQ100/USD," 1.011,41 ",1.052508," 11,41 "," 8.730,50 "," 6.730,50 ",2803828452,CFD," 0,00 "
05/09/2024 14:18:41,Open Position,NSDQ100/USD," 1.000,00 ",1.051927," 0,00 "," 8.730,50 "," 5.730,50 ",2803880810,CFD," 0,00 "
05/09/2024 14:23:02,Open Position,NSDQ100/USD," 1.000,00 ",1.048909," 0,00 "," 8.730,50 "," 4.730,50 ",2803888454,CFD," 0,00 "
05/09/2024 14:36:36,Position closed,NSDQ100/USD," 1.006,55 ",1.048909," 6,55 "," 8.737,05 "," 5.737,05 ",2803888454,CFD," 0,00 "
05/09/2024 14:37:23,Open Position,NSDQ100/USD," 1.000,00 ",1.048893," 0,00 "," 8.737,05 "," 4.737,05 ",2803912507,CFD," 0,00 "
05/09/2024 14:43:26,Position closed,NSDQ100/USD," 1.011,06 ",1.048893," 11,06 "," 8.748,11 "," 5.748,11 ",2803912507,CFD," 0,00 "
05/09/2024 14:51:12,Position closed,NSDQ100/USD," 511,30 ",0.526647," 11,30 "," 8.759,41 "," 6.259,41 ",2803816640,CFD," 0,00 "
05/09/2024 14:51:12,Position closed,NSDQ100/USD," 979,90 ",1.055546,"(20,10)"," 8.739,31 "," 7.239,31 ",2803749925,CFD," 0,00 "
05/09/2024 14:51:12,Position closed,NSDQ100/USD," 1.048,55 ",1.051927," 48,55 "," 8.787,86 "," 8.287,86 ",2803880810,CFD," 0,00 "
05/09/2024 14:51:12,Position closed,NSDQ100/USD," 502,98 ",0.527086," 2,98 "," 8.790,84 "," 8.790,84 ",2803810573,CFD," 0,00 "
05/09/2024 15:09:24,Open Position,NSDQ100/USD," 880,00 ",0.929783," 0,00 "," 8.790,84 "," 7.910,84 ",2803965233,CFD," 0,00 "
05/09/2024 15:11:02,Position closed,NSDQ100/USD," 883,59 ",0.929783," 3,59 "," 8.794,43 "," 8.794,43 ",2803965233,CFD," 0,00 "
05/09/2024 15:11:31,Open Position,NSDQ100/USD," 879,99 ",0.930081," 0,00 "," 8.794,43 "," 7.914,44 ",2803969653,CFD," 0,00 "
05/09/2024 15:12:47,Position closed,NSDQ100/USD," 881,25 ",0.930081," 1,26 "," 8.795,69 "," 8.795,69 ",2803969653,CFD," 0,00 "
05/09/2024 15:19:22,Open Position,NSDQ100/USD," 879,99 ",0.930996," 0,00 "," 8.795,69 "," 7.915,70 ",2803999840,CFD," 0,00 "
05/09/2024 15:20:11,Position closed,NSDQ100/USD," 884,33 ",0.930996," 4,34 "," 8.800,03 "," 8.800,03 ",2803999840,CFD," 0,00 "
05/09/2024 15:29:26,Open Position,NSDQ100/USD," 2.000,00 ",2.123619," 0,00 "," 8.800,03 "," 6.800,03 ",2804050866,CFD," 0,00 "
05/09/2024 15:33:35,Open Position,NSDQ100/USD," 999,99 ",1.062910," 0,00 "," 8.800,03 "," 5.800,04 ",2804055269,CFD," 0,00 "
05/09/2024 15:35:17,Position closed,NSDQ100/USD," 1.013,36 ",1.062910," 13,37 "," 8.813,40 "," 6.813,40 ",2804055269,CFD," 0,00 "
05/09/2024 15:35:24,Position closed,NSDQ100/USD," 1.995,05 ",2.123619,"(4,95)"," 8.808,45 "," 8.808,45 ",2804050866,CFD," 0,00 "
05/09/2024 15:44:47,Open Position,NSDQ100/USD," 499,99 ",0.530639," 0,00 "," 8.808,45 "," 8.308,46 ",2804066591,CFD," 0,00 "
05/09/2024 16:02:07,Position closed,NSDQ100/USD," 501,88 ",0.530639," 1,89 "," 8.810,34 "," 8.810,34 ",2804066591,CFD," 0,00 "
05/09/2024 16:09:05,Open Position,NSDQ100/USD," 499,99 ",0.529875," 0,00 "," 8.810,34 "," 8.310,35 ",2804089782,CFD," 0,00 "
05/09/2024 16:23:25,Position closed,NSDQ100/USD," 505,06 ",0.529875," 5,07 "," 8.815,41 "," 8.815,41 ",2804089782,CFD," 0,00 "
05/09/2024 16:24:26,Open Position,NSDQ100/USD," 599,99 ",0.635343," 0,00 "," 8.815,41 "," 8.215,42 ",2804100636,CFD," 0,00 "
05/09/2024 16:32:18,Open Position,NSDQ100/USD," 500,00 ",0.528867," 0,00 "," 8.815,41 "," 7.715,42 ",2804103937,CFD," 0,00 "
05/09/2024 17:04:40,Position closed,NSDQ100/USD," 596,54 ",0.635343,"(3,45)"," 8.811,96 "," 8.311,96 ",2804100636,CFD," 0,00 "
05/09/2024 17:04:40,Position closed,NSDQ100/USD," 508,18 ",0.528867," 8,18 "," 8.820,14 "," 8.820,14 ",2804103937,CFD," 0,00 "
05/09/2024 18:49:12,Open Position,NSDQ100/USD," 1.000,00 ",1.054422," 0,00 "," 8.820,14 "," 7.820,14 ",2804163978,CFD," 0,00 "
05/09/2024 19:12:23,Position closed,NSDQ100/USD," 1.030,43 ",1.054422," 30,43 "," 8.850,57 "," 8.850,57 ",2804163978,CFD," 0,00 "
05/09/2024 19:13:11,Open Position,NSDQ100/USD," 1.999,99 ",2.112665," 0,00 "," 8.850,57 "," 6.850,58 ",2804172757,CFD," 0,00 "
05/09/2024 19:17:38,Position closed,NSDQ100/USD," 2.080,00 ",2.112665," 80,01 "," 8.930,58 "," 8.930,58 ",2804172757,CFD," 0,00 "
05/09/2024 19:19:54,Open Position,NSDQ100/USD," 500,00 ",0.529287," 0,00 "," 8.930,58 "," 8.430,58 ",2804176992,CFD," 0,00 "
05/09/2024 19:22:00,Position closed,NSDQ100/USD," 501,89 ",0.529287," 1,89 "," 8.932,47 "," 8.932,47 ",2804176992,CFD," 0,00 "
05/09/2024 20:02:53,Open Position,NSDQ100/USD," 1.800,00 ",1.899918," 0,00 "," 8.932,47 "," 7.132,47 ",2804214863,CFD," 0,00 "
05/09/2024 20:20:21,Position closed,NSDQ100/USD," 1.885,80 ",1.899918," 85,80 "," 9.018,27 "," 9.018,27 ",2804214863,CFD," 0,00 "
05/09/2024 23:31:51,Open Position,NSDQ100/USD," 500,00 ",0.530155," 0,00 "," 9.018,27 "," 8.518,27 ",2804226513,CFD," 0,00 "
06/09/2024 00:13:46,Position closed,NSDQ100/USD," 511,39 ",0.530155," 11,39 "," 9.029,66 "," 9.029,66 ",2804226513,CFD," 0,00 "
06/09/2024 06:50:11,Open Position,NSDQ100/USD," 500,00 ",0.531180," 0,00 "," 9.029,66 "," 8.529,66 ",2804256178,CFD," 0,00 "
06/09/2024 07:03:01,Position closed,NSDQ100/USD," 514,54 ",0.531180," 14,54 "," 9.044,20 "," 9.044,20 ",2804256178,CFD," 0,00 "
06/09/2024 07:10:30,Open Position,NSDQ100/USD," 1.999,99 ",2.129221," 0,00 "," 9.044,20 "," 7.044,21 ",2804274518,CFD," 0,00 "
06/09/2024 07:12:53,Position closed,NSDQ100/USD," 2.007,40 ",2.129221," 7,41 "," 9.051,61 "," 9.051,61 ",2804274518,CFD," 0,00 "
06/09/2024 07:13:36,Open Position,NSDQ100/USD," 1.999,99 ",2.129867," 0,00 "," 9.051,61 "," 7.051,62 ",2804275205,CFD," 0,00 "
06/09/2024 07:14:02,Open Position,NSDQ100/USD," 1.799,99 ",1.917534," 0,00 "," 9.051,61 "," 5.251,63 ",2804275298,CFD," 0,00 "
06/09/2024 07:14:47,Open Position,NSDQ100/USD," 1.400,00 ",1.493970," 0,00 "," 9.051,61 "," 3.851,63 ",2804275679,CFD," 0,00 "
06/09/2024 07:16:18,Open Position,NSDQ100/USD," 499,99 ",0.533953," 0,00 "," 9.051,61 "," 3.351,64 ",2804276314,CFD," 0,00 "
06/09/2024 07:18:28,Open Position,NSDQ100/USD," 499,94 ",0.534341," 0,00 "," 9.051,61 "," 2.851,70 ",2804277564,CFD," 0,00 "
06/09/2024 07:20:25,Open Position,NSDQ100/USD," 719,99 ",0.770453," 0,00 "," 9.051,61 "," 2.131,71 ",2804278324,CFD," 0,00 "
06/09/2024 07:22:33,Position closed,NSDQ100/USD," 729,62 ",0.770453," 9,63 "," 9.061,24 "," 2.861,33 ",2804278324,CFD," 0,00 "
06/09/2024 07:24:37,Open Position,NSDQ100/USD," 719,99 ",0.769806," 0,00 "," 9.061,24 "," 2.141,34 ",2804292912,CFD," 0,00 "
06/09/2024 07:25:18,Position closed,NSDQ100/USD," 725,22 ",0.769806," 5,23 "," 9.066,47 "," 2.866,56 ",2804292912,CFD," 0,00 "
06/09/2024 07:26:58,Open Position,NSDQ100/USD," 719,99 ",0.769596," 0,00 "," 9.066,47 "," 2.146,57 ",2804293996,CFD," 0,00 "
06/09/2024 07:27:25,Open Position,NSDQ100/USD," 540,00 ",0.577323," 0,00 "," 9.066,47 "," 1.606,57 ",2804294085,CFD," 0,00 "
06/09/2024 07:28:55,Open Position,NSDQ100/USD," 409,99 ",0.438378," 0,00 "," 9.066,47 "," 1.196,58 ",2804294491,CFD," 0,00 "
06/09/2024 07:29:12,Position closed,NSDQ100/USD," 542,53 ",0.577323," 2,53 "," 9.069,00 "," 1.739,11 ",2804294085,CFD," 0,00 "
06/09/2024 07:29:27,Open Position,NSDQ100/USD," 699,99 ",0.748362," 0,00 "," 9.069,00 "," 1.039,12 ",2804294636,CFD," 0,00 "
06/09/2024 07:29:55,Position closed,NSDQ100/USD," 702,08 ",0.748362," 2,09 "," 9.071,09 "," 1.741,20 ",2804294636,CFD," 0,00 "
06/09/2024 07:30:20,Open Position,NSDQ100/USD," 999,99 ",1.068975," 0,00 "," 9.071,09 "," 741,21 ",2804296264,CFD," 0,00 "
06/09/2024 07:30:29,Position closed,NSDQ100/USD," 410,73 ",0.438378," 0,74 "," 9.071,83 "," 1.151,94 ",2804294491,CFD," 0,00 "
06/09/2024 07:31:21,Position closed,NSDQ100/USD," 1.004,15 ",1.068975," 4,16 "," 9.075,99 "," 2.156,09 ",2804296264,CFD," 0,00 "
06/09/2024 07:31:25,Position closed,NSDQ100/USD," 717,37 ",0.769596,"(2,62)"," 9.073,37 "," 2.873,46 ",2804293996,CFD," 0,00 "
06/09/2024 07:31:40,Open Position,NSDQ100/USD," 719,99 ",0.769838," 0,00 "," 9.073,37 "," 2.153,47 ",2804296523,CFD," 0,00 "
06/09/2024 07:31:56,Open Position,NSDQ100/USD," 999,99 ",1.069175," 0,00 "," 9.073,37 "," 1.153,48 ",2804296563,CFD," 0,00 "
06/09/2024 07:32:51,Open Position,NSDQ100/USD," 499,99 ",0.534598," 0,00 "," 9.073,37 "," 653,49 ",2804296826,CFD," 0,00 "
06/09/2024 07:33:04,Position closed,NSDQ100/USD," 1.005,86 ",1.069175," 5,87 "," 9.079,24 "," 1.659,35 ",2804296563,CFD," 0,00 "
06/09/2024 07:34:02,Position closed,NSDQ100/USD," 724,76 ",0.769838," 4,77 "," 9.084,01 "," 2.384,11 ",2804296523,CFD," 0,00 "
06/09/2024 07:34:07,Position closed,NSDQ100/USD," 503,57 ",0.534598," 3,58 "," 9.087,59 "," 2.887,68 ",2804296826,CFD," 0,00 "
06/09/2024 07:34:23,Open Position,NSDQ100/USD," 500,00 ",0.534345," 0,00 "," 9.087,59 "," 2.387,68 ",2804297157,CFD," 0,00 "
06/09/2024 07:36:06,Position closed,NSDQ100/USD," 497,32 ",0.534345,"(2,68)"," 9.084,91 "," 2.885,00 ",2804297157,CFD," 0,00 "
06/09/2024 07:36:13,Position closed,NSDQ100/USD," 501,97 ",0.534341," 2,03 "," 9.086,94 "," 3.386,97 ",2804277564,CFD," 0,00 "
06/09/2024 07:36:59,Open Position,NSDQ100/USD," 850,00 ",0.907876," 0,00 "," 9.086,94 "," 2.536,97 ",2804297765,CFD," 0,00 "
06/09/2024 07:40:04,Open Position,NSDQ100/USD," 640,00 ",0.683621," 0,00 "," 9.086,94 "," 1.896,97 ",2804298499,CFD," 0,00 "
06/09/2024 07:44:18,Position closed,NSDQ100/USD," 501,85 ",0.533953," 1,86 "," 9.088,80 "," 2.398,82 ",2804276314,CFD," 0,00 "
06/09/2024 07:45:25,Open Position,NSDQ100/USD," 999,99 ",1.068318," 0,00 "," 9.088,80 "," 1.398,83 ",2804299589,CFD," 0,00 "
06/09/2024 07:45:53,Open Position,NSDQ100/USD," 499,99 ",0.534196," 0,00 "," 9.088,80 "," 898,84 ",2804299665,CFD," 0,00 "
06/09/2024 07:46:59,Open Position,NSDQ100/USD," 499,99 ",0.534581," 0,00 "," 9.088,80 "," 398,85 ",2804300208,CFD," 0,00 "
06/09/2024 07:50:11,Position closed,NSDQ100/USD," 504,64 ",0.534581," 4,65 "," 9.093,45 "," 903,49 ",2804300208,CFD," 0,00 "
06/09/2024 07:51:26,Open Position,NSDQ100/USD," 499,99 ",0.534324," 0,00 "," 9.093,45 "," 403,50 ",2804311976,CFD," 0,00 "
06/09/2024 07:52:50,Position closed,NSDQ100/USD," 503,03 ",0.534324," 3,04 "," 9.096,49 "," 906,53 ",2804311976,CFD," 0,00 "
06/09/2024 07:52:58,Position closed,NSDQ100/USD," 1.004,79 ",1.068318," 4,80 "," 9.101,29 "," 1.911,32 ",2804299589,CFD," 0,00 "
06/09/2024 07:53:03,Position closed,NSDQ100/USD," 851,26 ",0.907876," 1,26 "," 9.102,55 "," 2.762,58 ",2804297765,CFD," 0,00 "
06/09/2024 07:53:16,Position closed,NSDQ100/USD," 504,42 ",0.534196," 4,43 "," 9.106,98 "," 3.267,00 ",2804299665,CFD," 0,00 "
06/09/2024 07:53:20,Position closed,NSDQ100/USD," 640,95 ",0.683621," 0,95 "," 9.107,93 "," 3.907,95 ",2804298499,CFD," 0,00 "
06/09/2024 07:56:51,Open Position,NSDQ100/USD," 499,99 ",0.533586," 0,00 "," 9.107,93 "," 3.407,96 ",2804313057,CFD," 0,00 "
06/09/2024 07:57:39,Position closed,NSDQ100/USD," 1.398,94 ",1.493970,"(1,06)"," 9.106,87 "," 4.806,90 ",2804275679,CFD," 0,00 "
06/09/2024 07:59:09,Position closed,NSDQ100/USD," 501,64 ",0.533586," 1,65 "," 9.108,52 "," 5.308,54 ",2804313057,CFD," 0,00 "
06/09/2024 08:02:33,Open Position,NSDQ100/USD," 499,99 ",0.533632," 0,00 "," 9.108,52 "," 4.808,55 ",2804314328,CFD," 0,00 "
06/09/2024 08:03:10,Position closed,NSDQ100/USD," 507,83 ",0.533632," 7,84 "," 9.116,36 "," 5.316,38 ",2804314328,CFD," 0,00 "
06/09/2024 08:03:56,Open Position,NSDQ100/USD," 699,99 ",0.746539," 0,00 "," 9.116,36 "," 4.616,39 ",2804314882,CFD," 0,00 "
06/09/2024 08:06:48,Open Position,NSDQ100/USD," 1.200,00 ",1.280150," 0,00 "," 9.116,36 "," 3.416,39 ",2804315470,CFD," 0,00 "
06/09/2024 08:07:53,Open Position,NSDQ100/USD," 499,99 ",0.533458," 0,00 "," 9.116,36 "," 2.916,40 ",2804315698,CFD," 0,00 "
06/09/2024 08:12:53,Open Position,NSDQ100/USD," 999,99 ",1.067565," 0,00 "," 9.116,36 "," 1.916,41 ",2804329626,CFD," 0,00 "
06/09/2024 08:23:30,Open Position,NSDQ100/USD," 999,99 ",1.068472," 0,00 "," 9.116,36 "," 916,42 ",2804416575,CFD," 0,00 "
06/09/2024 08:30:24,Position closed,NSDQ100/USD," 1.014,61 ",1.068472," 14,62 "," 9.130,98 "," 1.931,03 ",2804416575,CFD," 0,00 "
06/09/2024 08:39:22,Open Position,NSDQ100/USD," 999,99 ",1.068712," 0,00 "," 9.130,98 "," 931,04 ",2804418802,CFD," 0,00 "
06/09/2024 08:40:41,Open Position,NSDQ100/USD," 499,99 ",0.534473," 0,00 "," 9.130,98 "," 431,05 ",2804419226,CFD," 0,00 "
06/09/2024 08:47:30,Open Position,NSDQ100/USD," 300,00 ",0.320975," 0,00 "," 9.130,98 "," 131,05 ",2804421821,CFD," 0,00 "
06/09/2024 09:21:37,Position closed,NSDQ100/USD," 299,84 ",0.320975,"(0,16)"," 9.130,82 "," 430,89 ",2804421821,CFD," 0,00 "
06/09/2024 09:47:47,Position closed,NSDQ100/USD," 503,03 ",0.534473," 3,04 "," 9.133,86 "," 933,92 ",2804419226,CFD," 0,00 "
06/09/2024 09:47:59,Position closed,NSDQ100/USD," 1.003,93 ",1.068712," 3,94 "," 9.137,80 "," 1.937,85 ",2804418802,CFD," 0,00 "
06/09/2024 10:00:15,Position closed,NSDQ100/USD," 993,15 ",1.067565,"(6,84)"," 9.130,96 "," 2.931,00 ",2804329626,CFD," 0,00 "
06/09/2024 10:27:13,Position closed,NSDQ100/USD," 485,37 ",0.533458,"(14,62)"," 9.116,34 "," 3.416,37 ",2804315698,CFD," 0,00 "
06/09/2024 10:43:55,Open Position,NSDQ100/USD," 860,00 ",0.920105," 0,00 "," 9.116,34 "," 2.556,37 ",2804459271,CFD," 0,00 "
06/09/2024 10:44:08,Open Position,NSDQ100/USD," 299,99 ",0.321046," 0,00 "," 9.116,34 "," 2.256,38 ",2804459400,CFD," 0,00 "
06/09/2024 10:44:40,Position closed,NSDQ100/USD," 861,38 ",0.920105," 1,38 "," 9.117,72 "," 3.117,76 ",2804459271,CFD," 0,00 "
06/09/2024 11:36:20,Position closed,NSDQ100/USD," 1.900,70 ",2.129867,"(99,29)"," 9.018,43 "," 5.018,46 ",2804275205,CFD," 0,00 "
06/09/2024 11:36:20,Position closed,NSDQ100/USD," 1.182,19 ",1.280150,"(17,81)"," 9.000,62 "," 6.200,65 ",2804315470,CFD," 0,00 "
06/09/2024 11:36:20,Position closed,NSDQ100/USD," 685,57 ",0.746539,"(14,42)"," 8.986,20 "," 6.886,22 ",2804314882,CFD," 0,00 "
06/09/2024 11:36:20,Position closed,NSDQ100/USD," 284,64 ",0.321046,"(15,35)"," 8.970,85 "," 7.170,86 ",2804459400,CFD," 0,00 "
06/09/2024 11:36:20,Position closed,NSDQ100/USD," 1.722,87 ",1.917534,"(77,12)"," 8.893,73 "," 8.893,73 ",2804275298,CFD," 0,00 "
06/09/2024 12:11:05,Open Position,NSDQ100/USD," 500,00 ",0.533512," 0,00 "," 8.893,73 "," 8.393,73 ",2804484147,CFD," 0,00 "
06/09/2024 12:15:39,Position closed,NSDQ100/USD," 500,63 ",0.533512," 0,63 "," 8.894,36 "," 8.894,36 ",2804484147,CFD," 0,00 "
06/09/2024 12:33:43,Open Position,NSDQ100/USD," 399,99 ",0.425678," 0,00 "," 8.894,36 "," 8.494,37 ",2804496322,CFD," 0,00 "
06/09/2024 12:34:11,Position closed,NSDQ100/USD," 406,71 ",0.425678," 6,72 "," 8.901,08 "," 8.901,08 ",2804496322,CFD," 0,00 "
06/09/2024 12:34:34,Open Position,NSDQ100/USD," 900,00 ",0.956805," 0,00 "," 8.901,08 "," 8.001,08 ",2804496865,CFD," 0,00 "
06/09/2024 12:34:45,Position closed,NSDQ100/USD," 909,26 ",0.956805," 9,26 "," 8.910,34 "," 8.910,34 ",2804496865,CFD," 0,00 "
06/09/2024 12:35:02,Open Position,NSDQ100/USD," 900,00 ",0.956063," 0,00 "," 8.910,34 "," 8.010,34 ",2804497140,CFD," 0,00 "
06/09/2024 12:35:42,Open Position,NSDQ100/USD," 999,99 ",1.062066," 0,00 "," 8.910,34 "," 7.010,35 ",2804497650,CFD," 0,00 "
06/09/2024 12:36:05,Position closed,NSDQ100/USD," 920,63 ",0.956063," 20,63 "," 8.930,97 "," 7.930,98 ",2804497140,CFD," 0,00 "
06/09/2024 12:36:14,Position closed,NSDQ100/USD," 1.012,93 ",1.062066," 12,94 "," 8.943,91 "," 8.943,91 ",2804497650,CFD," 0,00 "
06/09/2024 12:36:31,Open Position,NSDQ100/USD," 899,99 ",0.955600," 0,00 "," 8.943,91 "," 8.043,92 ",2804498778,CFD," 0,00 "
06/09/2024 12:36:53,Position closed,NSDQ100/USD," 911,05 ",0.955600," 11,06 "," 8.954,97 "," 8.954,97 ",2804498778,CFD," 0,00 "
06/09/2024 12:37:16,Open Position,NSDQ100/USD," 900,00 ",0.954263," 0,00 "," 8.954,97 "," 8.054,97 ",2804499395,CFD," 0,00 "
06/09/2024 12:37:55,Position closed,NSDQ100/USD," 899,11 ",0.954263,"(0,89)"," 8.954,08 "," 8.954,08 ",2804499395,CFD," 0,00 "
06/09/2024 12:38:28,Open Position,NSDQ100/USD," 900,00 ",0.953591," 0,00 "," 8.954,08 "," 8.054,08 ",2804500181,CFD," 0,00 "
06/09/2024 12:39:07,Open Position,NSDQ100/USD," 999,99 ",1.060247," 0,00 "," 8.954,08 "," 7.054,09 ",2804500601,CFD," 0,00 "
06/09/2024 12:39:17,Position closed,NSDQ100/USD," 1.005,14 ",1.060247," 5,15 "," 8.959,23 "," 8.059,23 ",2804500601,CFD," 0,00 "
06/09/2024 12:39:24,Open Position,NSDQ100/USD," 2.100,00 ",2.226755," 0,00 "," 8.959,23 "," 5.959,23 ",2804500811,CFD," 0,00 "
06/09/2024 12:39:56,Position closed,NSDQ100/USD," 2.111,49 ",2.226755," 11,49 "," 8.970,72 "," 8.070,72 ",2804500811,CFD," 0,00 "
06/09/2024 12:40:12,Open Position,NSDQ100/USD," 999,99 ",1.060764," 0,00 "," 8.970,72 "," 7.070,73 ",2804501329,CFD," 0,00 "
06/09/2024 12:40:58,Open Position,NSDQ100/USD," 500,00 ",0.530836," 0,00 "," 8.970,72 "," 6.570,73 ",2804501847,CFD," 0,00 "
06/09/2024 12:42:46,Position closed,NSDQ100/USD," 507,37 ",0.530836," 7,37 "," 8.978,09 "," 7.078,10 ",2804501847,CFD," 0,00 "
06/09/2024 12:43:38,Open Position,NSDQ100/USD," 499,99 ",0.531024," 0,00 "," 8.978,09 "," 6.578,11 ",2804503641,CFD," 0,00 "
06/09/2024 12:44:24,Position closed,NSDQ100/USD," 500,46 ",0.531024," 0,47 "," 8.978,56 "," 7.078,57 ",2804503641,CFD," 0,00 "
06/09/2024 12:44:57,Open Position,NSDQ100/USD," 499,99 ",0.531005," 0,00 "," 8.978,56 "," 6.578,58 ",2804504165,CFD," 0,00 "
06/09/2024 12:45:31,Position closed,NSDQ100/USD," 513,89 ",0.531005," 13,90 "," 8.992,46 "," 7.092,47 ",2804504165,CFD," 0,00 "
06/09/2024 12:45:45,Open Position,NSDQ100/USD," 500,00 ",0.530667," 0,00 "," 8.992,46 "," 6.592,47 ",2804504479,CFD," 0,00 "
06/09/2024 12:46:13,Position closed,NSDQ100/USD," 1.003,25 ",1.060764," 3,26 "," 8.995,72 "," 7.595,72 ",2804501329,CFD," 0,00 "
06/09/2024 12:46:39,Open Position,NSDQ100/USD," 500,00 ",0.530046," 0,00 "," 8.995,72 "," 7.095,72 ",2804504808,CFD," 0,00 "
06/09/2024 12:47:30,Position closed,NSDQ100/USD," 902,55 ",0.953591," 2,55 "," 8.998,27 "," 7.998,27 ",2804500181,CFD," 0,00 "
06/09/2024 12:48:13,Open Position,NSDQ100/USD," 299,99 ",0.317864," 0,00 "," 8.998,27 "," 7.698,28 ",2804505733,CFD," 0,00 "
06/09/2024 12:49:05,Open Position,NSDQ100/USD," 999,99 ",1.059433," 0,00 "," 8.998,27 "," 6.698,29 ",2804506101,CFD," 0,00 "
06/09/2024 12:49:17,Position closed,NSDQ100/USD," 1.009,49 ",1.059433," 9,50 "," 9.007,77 "," 7.707,78 ",2804506101,CFD," 0,00 "
06/09/2024 12:49:52,Open Position,NSDQ100/USD," 999,99 ",1.057819," 0,00 "," 9.007,77 "," 6.707,79 ",2804506392,CFD," 0,00 "
06/09/2024 12:50:07,Position closed,NSDQ100/USD," 288,31 ",0.317864,"(11,68)"," 8.996,09 "," 6.996,10 ",2804505733,CFD," 0,00 "
06/09/2024 12:50:11,Position closed,NSDQ100/USD," 997,51 ",1.057819,"(2,48)"," 8.993,61 "," 7.993,61 ",2804506392,CFD," 0,00 "
06/09/2024 12:50:49,Open Position,NSDQ100/USD," 999,98 ",1.057764," 0,00 "," 8.993,61 "," 6.993,63 ",2804506994,CFD," 0,00 "
06/09/2024 12:51:35,Open Position,NSDQ100/USD," 499,99 ",0.528834," 0,00 "," 8.993,61 "," 6.493,64 ",2804507305,CFD," 0,00 "
06/09/2024 12:53:05,Open Position,NSDQ100/USD," 999,99 ",1.057556," 0,00 "," 8.993,61 "," 5.493,65 ",2804507846,CFD," 0,00 "
06/09/2024 12:53:33,Open Position,NSDQ100/USD," 499,99 ",0.528814," 0,00 "," 8.993,61 "," 4.993,66 ",2804508005,CFD," 0,00 "
06/09/2024 12:53:54,Open Position,NSDQ100/USD," 499,99 ",0.529262," 0,00 "," 8.993,61 "," 4.493,67 ",2804508129,CFD," 0,00 "
06/09/2024 12:54:13,Position closed,NSDQ100/USD," 483,98 ",0.530046,"(16,02)"," 8.977,59 "," 4.977,65 ",2804504808,CFD," 0,00 "
06/09/2024 12:58:35,Position closed,NSDQ100/USD," 502,78 ",0.529262," 2,79 "," 8.980,38 "," 5.480,43 ",2804508129,CFD," 0,00 "
06/09/2024 13:00:22,Position closed,NSDQ100/USD," 1.004,91 ",1.057764," 4,93 "," 8.985,31 "," 6.485,34 ",2804506994,CFD," 0,00 "
06/09/2024 13:00:32,Position closed,NSDQ100/USD," 999,21 ",1.057556,"(0,78)"," 8.984,53 "," 7.484,55 ",2804507846,CFD," 0,00 "
06/09/2024 13:00:32,Position closed,NSDQ100/USD," 463,16 ",0.530667,"(36,84)"," 8.947,69 "," 7.947,71 ",2804504479,CFD," 0,00 "
06/09/2024 13:00:32,Position closed,NSDQ100/USD," 500,66 ",0.528834," 0,67 "," 8.948,36 "," 8.448,37 ",2804507305,CFD," 0,00 "
06/09/2024 13:00:32,Position closed,NSDQ100/USD," 500,34 ",0.528814," 0,35 "," 8.948,71 "," 8.948,71 ",2804508005,CFD," 0,00 "
06/09/2024 13:01:47,Open Position,NSDQ100/USD," 100,00 ",0.105818," 0,00 "," 8.948,71 "," 8.848,71 ",2804512118,CFD," 0,00 "
06/09/2024 13:02:17,Open Position,NSDQ100/USD," 499,99 ",0.528979," 0,00 "," 8.948,71 "," 8.348,72 ",2804512374,CFD," 0,00 "
06/09/2024 13:02:34,Open Position,NSDQ100/USD," 100,00 ",0.105860," 0,00 "," 8.948,71 "," 8.248,72 ",2804512464,CFD," 0,00 "
06/09/2024 13:03:29,Open Position,NSDQ100/USD," 100,00 ",0.105929," 0,00 "," 8.948,71 "," 8.148,72 ",2804512778,CFD," 0,00 "
06/09/2024 13:04:43,Position closed,NSDQ100/USD," 101,47 ",0.105929," 1,47 "," 8.950,18 "," 8.250,19 ",2804512778,CFD," 0,00 "
06/09/2024 13:05:58,Position closed,NSDQ100/USD," 100,32 ",0.105860," 0,32 "," 8.950,50 "," 8.350,51 ",2804512464,CFD," 0,00 "
06/09/2024 13:06:39,Open Position,NSDQ100/USD," 999,99 ",1.058368," 0,00 "," 8.950,50 "," 7.350,52 ",2804515475,CFD," 0,00 "
06/09/2024 13:07:11,Position closed,NSDQ100/USD," 1.006,31 ",1.058368," 6,32 "," 8.956,82 "," 8.356,83 ",2804515475,CFD," 0,00 "
06/09/2024 13:07:15,Position closed,NSDQ100/USD," 497,43 ",0.528979,"(2,56)"," 8.954,26 "," 8.854,26 ",2804512374,CFD," 0,00 "
06/09/2024 13:07:27,Position closed,NSDQ100/USD," 100,79 ",0.105818," 0,79 "," 8.955,05 "," 8.955,05 ",2804512118,CFD," 0,00 "
06/09/2024 13:08:13,Open Position,NSDQ100/USD," 199,99 ",0.211526," 0,00 "," 8.955,05 "," 8.755,06 ",2804516573,CFD," 0,00 "
06/09/2024 13:08:53,Open Position,NSDQ100/USD," 499,99 ",0.528831," 0,00 "," 8.955,05 "," 8.255,07 ",2804516812,CFD," 0,00 "
06/09/2024 13:09:12,Open Position,NSDQ100/USD," 499,99 ",0.529147," 0,00 "," 8.955,05 "," 7.755,08 ",2804516951,CFD," 0,00 "
06/09/2024 13:09:44,Open Position,NSDQ100/USD," 499,99 ",0.529206," 0,00 "," 8.955,05 "," 7.255,09 ",2804517106,CFD," 0,00 "
06/09/2024 13:10:15,Position closed,NSDQ100/USD," 501,14 ",0.529206," 1,15 "," 8.956,20 "," 7.756,23 ",2804517106,CFD," 0,00 "
06/09/2024 13:10:26,Position closed,NSDQ100/USD," 502,20 ",0.529147," 2,21 "," 8.958,41 "," 8.258,43 ",2804516951,CFD," 0,00 "
06/09/2024 13:10:55,Open Position,NSDQ100/USD," 499,99 ",0.529192," 0,00 "," 8.958,41 "," 7.758,44 ",2804517561,CFD," 0,00 "
06/09/2024 13:11:13,Open Position,NSDQ100/USD," 499,99 ",0.529492," 0,00 "," 8.958,41 "," 7.258,45 ",2804517664,CFD," 0,00 "
06/09/2024 13:11:48,Position closed,NSDQ100/USD," 498,65 ",0.529192,"(1,34)"," 8.957,07 "," 7.757,10 ",2804517561,CFD," 0,00 "
06/09/2024 13:11:53,Position closed,NSDQ100/USD," 504,47 ",0.529492," 4,48 "," 8.961,55 "," 8.261,57 ",2804517664,CFD," 0,00 "
06/09/2024 13:12:09,Open Position,NSDQ100/USD," 199,99 ",0.211673," 0,00 "," 8.961,55 "," 8.061,58 ",2804517889,CFD," 0,00 "
06/09/2024 13:12:24,Open Position,NSDQ100/USD," 999,99 ",1.058592," 0,00 "," 8.961,55 "," 7.061,59 ",2804517949,CFD," 0,00 "
06/09/2024 13:12:50,Open Position,NSDQ100/USD," 499,99 ",0.529394," 0,00 "," 8.961,55 "," 6.561,60 ",2804518049,CFD," 0,00 "
06/09/2024 13:13:30,Open Position,NSDQ100/USD," 300,00 ",0.317591," 0,00 "," 8.961,55 "," 6.261,60 ",2804518197,CFD," 0,00 "
06/09/2024 13:13:44,Position closed,NSDQ100/USD," 1.000,28 ",1.058592," 0,29 "," 8.961,84 "," 7.261,88 ",2804517949,CFD," 0,00 "
06/09/2024 13:14:09,Position closed,NSDQ100/USD," 501,19 ",0.529394," 1,20 "," 8.963,04 "," 7.763,07 ",2804518049,CFD," 0,00 "
06/09/2024 13:14:30,Position closed,NSDQ100/USD," 301,74 ",0.317591," 1,74 "," 8.964,78 "," 8.064,81 ",2804518197,CFD," 0,00 "
06/09/2024 13:15:00,Position closed,NSDQ100/USD," 200,98 ",0.211673," 0,99 "," 8.965,77 "," 8.265,79 ",2804517889,CFD," 0,00 "
06/09/2024 13:15:40,Open Position,NSDQ100/USD," 600,00 ",0.634698," 0,00 "," 8.965,77 "," 7.665,79 ",2804518710,CFD," 0,00 "
06/09/2024 13:16:37,Position closed,NSDQ100/USD," 601,82 ",0.634698," 1,82 "," 8.967,59 "," 8.267,61 ",2804518710,CFD," 0,00 "
06/09/2024 13:16:37,Position closed,NSDQ100/USD," 499,92 ",0.528831,"(0,07)"," 8.967,52 "," 8.767,53 ",2804516812,CFD," 0,00 "
06/09/2024 13:16:37,Position closed,NSDQ100/USD," 199,85 ",0.211526,"(0,14)"," 8.967,38 "," 8.967,38 ",2804516573,CFD," 0,00 "
06/09/2024 13:17:29,Open Position,NSDQ100/USD," 499,99 ",0.528901," 0,00 "," 8.967,38 "," 8.467,39 ",2804519326,CFD," 0,00 "
06/09/2024 13:18:10,Position closed,NSDQ100/USD," 503,46 ",0.528901," 3,47 "," 8.970,85 "," 8.970,85 ",2804519326,CFD," 0,00 "
06/09/2024 13:18:24,Open Position,NSDQ100/USD," 199,99 ",0.211481," 0,00 "," 8.970,85 "," 8.770,86 ",2804519585,CFD," 0,00 "
06/09/2024 13:19:20,Open Position,NSDQ100/USD," 999,99 ",1.057992," 0,00 "," 8.970,85 "," 7.770,87 ",2804519838,CFD," 0,00 "
06/09/2024 13:19:46,Open Position,NSDQ100/USD," 499,99 ",0.529069," 0,00 "," 8.970,85 "," 7.270,88 ",2804519962,CFD," 0,00 "
06/09/2024 13:20:49,Open Position,NSDQ100/USD," 999,99 ",1.058015," 0,00 "," 8.970,85 "," 6.270,89 ",2804520258,CFD," 0,00 "
06/09/2024 13:21:06,Position closed,NSDQ100/USD," 1.003,12 ",1.058015," 3,13 "," 8.973,98 "," 7.274,01 ",2804520258,CFD," 0,00 "
06/09/2024 13:21:13,Position closed,NSDQ100/USD," 1.004,50 ",1.057992," 4,51 "," 8.978,49 "," 8.278,51 ",2804519838,CFD," 0,00 "
06/09/2024 13:21:17,Position closed,NSDQ100/USD," 502,94 ",0.529069," 2,95 "," 8.981,44 "," 8.781,45 ",2804519962,CFD," 0,00 "
06/09/2024 13:22:19,Open Position,NSDQ100/USD," 100,00 ",0.105732," 0,00 "," 8.981,44 "," 8.681,45 ",2804520778,CFD," 0,00 "
06/09/2024 13:22:40,Position closed,NSDQ100/USD," 100,56 ",0.105732," 0,56 "," 8.982,00 "," 8.782,01 ",2804520778,CFD," 0,00 "
06/09/2024 13:22:40,Position closed,NSDQ100/USD," 201,40 ",0.211481," 1,41 "," 8.983,41 "," 8.983,41 ",2804519585,CFD," 0,00 "
06/09/2024 13:23:18,Open Position,NSDQ100/USD," 299,99 ",0.316931," 0,00 "," 8.983,41 "," 8.683,42 ",2804521185,CFD," 0,00 "
06/09/2024 13:23:57,Open Position,NSDQ100/USD," 499,99 ",0.528116," 0,00 "," 8.983,41 "," 8.183,43 ",2804521413,CFD," 0,00 "
06/09/2024 13:24:20,Position closed,NSDQ100/USD," 300,58 ",0.316931," 0,59 "," 8.984,00 "," 8.484,01 ",2804521185,CFD," 0,00 "
06/09/2024 13:25:14,Open Position,NSDQ100/USD," 999,99 ",1.057948," 0,00 "," 8.984,00 "," 7.484,02 ",2804521813,CFD," 0,00 "
06/09/2024 13:26:35,Open Position,NSDQ100/USD," 999,99 ",1.057718," 0,00 "," 8.984,00 "," 6.484,03 ",2804522114,CFD," 0,00 "
06/09/2024 13:27:59,Open Position,NSDQ100/USD," 499,99 ",0.528881," 0,00 "," 8.984,00 "," 5.984,04 ",2804522646,CFD," 0,00 "
06/09/2024 13:28:20,Open Position,NSDQ100/USD," 499,99 ",0.529240," 0,00 "," 8.984,00 "," 5.484,05 ",2804522785,CFD," 0,00 "
06/09/2024 13:30:56,Position closed,NSDQ100/USD," 1.020,31 ",1.057948," 20,32 "," 9.004,32 "," 6.504,36 ",2804521813,CFD," 0,00 "
06/09/2024 13:30:56,Position closed,NSDQ100/USD," 508,40 ",0.528881," 8,41 "," 9.012,73 "," 7.012,76 ",2804522646,CFD," 0,00 "
06/09/2024 13:30:56,Position closed,NSDQ100/USD," 1.015,97 ",1.057718," 15,98 "," 9.028,71 "," 8.028,73 ",2804522114,CFD," 0,00 "
06/09/2024 13:30:56,Position closed,NSDQ100/USD," 493,92 ",0.528116,"(6,07)"," 9.022,64 "," 8.522,65 ",2804521413,CFD," 0,00 "
06/09/2024 13:30:56,Position closed,NSDQ100/USD," 515,19 ",0.529240," 15,20 "," 9.037,84 "," 9.037,84 ",2804522785,CFD," 0,00 "
06/09/2024 13:33:33,Open Position,NSDQ100/USD," 200,00 ",0.211771," 0,00 "," 9.037,84 "," 8.837,84 ",2804566191,CFD," 0,00 "
06/09/2024 13:33:45,Open Position,NSDQ100/USD," 499,99 ",0.529423," 0,00 "," 9.037,84 "," 8.337,85 ",2804566549,CFD," 0,00 "
06/09/2024 13:34:32,Position closed,NSDQ100/USD," 198,17 ",0.211771,"(1,83)"," 9.036,01 "," 8.536,02 ",2804566191,CFD," 0,00 "
06/09/2024 13:34:47,Position closed,NSDQ100/USD," 498,44 ",0.529423,"(1,55)"," 9.034,46 "," 9.034,46 ",2804566549,CFD," 0,00 "
06/09/2024 13:35:49,Open Position,NSDQ100/USD," 299,99 ",0.317674," 0,00 "," 9.034,46 "," 8.734,47 ",2804570668,CFD," 0,00 "
06/09/2024 13:36:35,Position closed,NSDQ100/USD," 302,84 ",0.317674," 2,85 "," 9.037,31 "," 9.037,31 ",2804570668,CFD," 0,00 "
06/09/2024 13:37:02,Open Position,NSDQ100/USD," 499,99 ",0.530521," 0,00 "," 9.037,31 "," 8.537,32 ",2804572329,CFD," 0,00 "
06/09/2024 13:39:30,Position closed,NSDQ100/USD," 465,17 ",0.530521,"(34,82)"," 9.002,49 "," 9.002,49 ",2804572329,CFD," 0,00 "
06/09/2024 13:40:05,Open Position,NSDQ100/USD," 500,00 ",0.532466," 0,00 "," 9.002,49 "," 8.502,49 ",2804578173,CFD," 0,00 "
06/09/2024 13:41:00,Position closed,NSDQ100/USD," 511,55 ",0.532466," 11,55 "," 9.014,04 "," 9.014,04 ",2804578173,CFD," 0,00 "
06/09/2024 13:41:27,Open Position,NSDQ100/USD," 299,97 ",0.319975," 0,00 "," 9.014,04 "," 8.714,07 ",2804581479,CFD," 0,00 "
06/09/2024 13:42:24,Open Position,NSDQ100/USD," 199,99 ",0.213080," 0,00 "," 9.014,04 "," 8.514,08 ",2804584991,CFD," 0,00 "
06/09/2024 13:42:35,Open Position,NSDQ100/USD," 199,99 ",0.212973," 0,00 "," 9.014,04 "," 8.314,09 ",2804585350,CFD," 0,00 "
06/09/2024 13:46:32,Open Position,NSDQ100/USD," 399,99 ",0.425155," 0,00 "," 9.014,04 "," 7.914,10 ",2804592281,CFD," 0,00 "
06/09/2024 13:48:17,Open Position,NSDQ100/USD," 500,00 ",0.531224," 0,00 "," 9.014,04 "," 7.414,10 ",2804594743,CFD," 0,00 "
06/09/2024 13:49:31,Position closed,NSDQ100/USD," 514,01 ",0.531224," 14,01 "," 9.028,05 "," 7.928,11 ",2804594743,CFD," 0,00 "
06/09/2024 13:49:40,Position closed,NSDQ100/USD," 407,29 ",0.425155," 7,30 "," 9.035,35 "," 8.335,40 ",2804592281,CFD," 0,00 "
06/09/2024 13:51:25,Position closed,NSDQ100/USD," 200,16 ",0.212973," 0,17 "," 9.035,52 "," 8.535,56 ",2804585350,CFD," 0,00 "
06/09/2024 13:51:55,Position closed,NSDQ100/USD," 199,69 ",0.213080,"(0,30)"," 9.035,22 "," 8.735,25 ",2804584991,CFD," 0,00 "
06/09/2024 13:53:08,Open Position,NSDQ100/USD," 4.999,99 ",5.321802," 0,00 "," 9.035,22 "," 3.735,26 ",2804689683,CFD," 0,00 "
06/09/2024 13:53:19,Position closed,NSDQ100/USD," 5.057,73 ",5.321802," 57,74 "," 9.092,96 "," 8.792,99 ",2804689683,CFD," 0,00 "
06/09/2024 13:54:59,Position closed,NSDQ100/USD," 301,09 ",0.319975," 1,12 "," 9.094,08 "," 9.094,08 ",2804581479,CFD," 0,00 "
06/09/2024 13:56:24,Open Position,NSDQ100/USD," 300,00 ",0.319850," 0,00 "," 9.094,08 "," 8.794,08 ",2804709134,CFD," 0,00 "
06/09/2024 13:57:13,Position closed,NSDQ100/USD," 302,65 ",0.319850," 2,65 "," 9.096,73 "," 9.096,73 ",2804709134,CFD," 0,00 "
06/09/2024 13:57:56,Open Position,NSDQ100/USD," 909,99 ",0.969568," 0,00 "," 9.096,73 "," 8.186,74 ",2804711271,CFD," 0,00 "
06/09/2024 13:58:18,Position closed,NSDQ100/USD," 921,91 ",0.969568," 11,92 "," 9.108,65 "," 9.108,65 ",2804711271,CFD," 0,00 "
06/09/2024 13:59:33,Open Position,NSDQ100/USD," 300,00 ",0.320638," 0,00 "," 9.108,65 "," 8.808,65 ",2804713356,CFD," 0,00 "
06/09/2024 13:59:48,Position closed,NSDQ100/USD," 299,74 ",0.320638,"(0,26)"," 9.108,39 "," 9.108,39 ",2804713356,CFD," 0,00 "
06/09/2024 14:00:33,Open Position,NSDQ100/USD," 500,00 ",0.535284," 0,00 "," 9.108,39 "," 8.608,39 ",2804715078,CFD," 0,00 "
06/09/2024 14:01:39,Open Position,NSDQ100/USD," 300,00 ",0.320743," 0,00 "," 9.108,39 "," 8.308,39 ",2804716190,CFD," 0,00 "
06/09/2024 14:04:07,Open Position,NSDQ100/USD," 299,99 ",0.320381," 0,00 "," 9.108,39 "," 8.008,40 ",2804719064,CFD," 0,00 "
06/09/2024 14:07:57,Open Position,NSDQ100/USD," 399,99 ",0.427251," 0,00 "," 9.108,39 "," 7.608,41 ",2804727533,CFD," 0,00 "
06/09/2024 14:08:17,Position closed,NSDQ100/USD," 304,82 ",0.320381," 4,83 "," 9.113,22 "," 7.913,23 ",2804719064,CFD," 0,00 "
06/09/2024 14:08:36,Open Position,NSDQ100/USD," 1.000,00 ",1.067250," 0,00 "," 9.113,22 "," 6.913,23 ",2804728307,CFD," 0,00 "
06/09/2024 14:10:00,Position closed,NSDQ100/USD," 1.010,33 ",1.067250," 10,33 "," 9.123,55 "," 7.923,56 ",2804728307,CFD," 0,00 "
06/09/2024 14:10:30,Open Position,NSDQ100/USD," 1.000,00 ",1.067176," 0,00 "," 9.123,55 "," 6.923,56 ",2804746526,CFD," 0,00 "
06/09/2024 14:10:41,Open Position,NSDQ100/USD," 500,00 ",0.533650," 0,00 "," 9.123,55 "," 6.423,56 ",2804748323,CFD," 0,00 "
06/09/2024 14:11:18,Position closed,NSDQ100/USD," 1.009,16 ",1.067176," 9,16 "," 9.132,71 "," 7.432,72 ",2804746526,CFD," 0,00 "
06/09/2024 14:11:27,Position closed,NSDQ100/USD," 515,14 ",0.533650," 15,14 "," 9.147,85 "," 7.947,86 ",2804748323,CFD," 0,00 "
06/09/2024 14:11:31,Position closed,NSDQ100/USD," 407,04 ",0.427251," 7,05 "," 9.154,90 "," 8.354,90 ",2804727533,CFD," 0,00 "
06/09/2024 14:11:35,Position closed,NSDQ100/USD," 300,51 ",0.320743," 0,51 "," 9.155,41 "," 8.655,41 ",2804716190,CFD," 0,00 "
06/09/2024 14:11:40,Position closed,NSDQ100/USD," 482,97 ",0.535284,"(17,03)"," 9.138,38 "," 9.138,38 ",2804715078,CFD," 0,00 "
06/09/2024 14:13:16,Open Position,NSDQ100/USD," 49,99 ",0.053511," 0,00 "," 9.138,38 "," 9.088,39 ",2804751661,CFD," 0,00 "
06/09/2024 14:14:15,Open Position,NSDQ100/USD," 500,00 ",0.534906," 0,00 "," 9.138,38 "," 8.588,39 ",2804753078,CFD," 0,00 "
06/09/2024 14:14:40,Position closed,NSDQ100/USD," 503,96 ",0.534906," 3,96 "," 9.142,34 "," 9.092,35 ",2804753078,CFD," 0,00 "
06/09/2024 14:15:02,Open Position,NSDQ100/USD," 1.000,00 ",1.069555," 0,00 "," 9.142,34 "," 8.092,35 ",2804753714,CFD," 0,00 "
06/09/2024 14:16:31,Open Position,NSDQ100/USD," 500,00 ",0.534497," 0,00 "," 9.142,34 "," 7.592,35 ",2804755208,CFD," 0,00 "
06/09/2024 14:16:46,Position closed,NSDQ100/USD," 506,20 ",0.534497," 6,20 "," 9.148,54 "," 8.098,55 ",2804755208,CFD," 0,00 "
06/09/2024 14:17:12,Position closed,NSDQ100/USD," 1.006,31 ",1.069555," 6,31 "," 9.154,85 "," 9.104,86 ",2804753714,CFD," 0,00 "
06/09/2024 14:18:31,Open Position,NSDQ100/USD," 500,00 ",0.534540," 0,00 "," 9.154,85 "," 8.604,86 ",2804758302,CFD," 0,00 "
06/09/2024 14:18:44,Open Position,NSDQ100/USD," 500,00 ",0.534697," 0,00 "," 9.154,85 "," 8.104,86 ",2804758560,CFD," 0,00 "
06/09/2024 14:19:15,Open Position,NSDQ100/USD," 1.000,00 ",1.068938," 0,00 "," 9.154,85 "," 7.104,86 ",2804759430,CFD," 0,00 "
06/09/2024 14:19:52,Open Position,NSDQ100/USD," 500,00 ",0.534292," 0,00 "," 9.154,85 "," 6.604,86 ",2804761144,CFD," 0,00 "
06/09/2024 14:21:01,Position closed,NSDQ100/USD," 505,66 ",0.534292," 5,66 "," 9.160,51 "," 7.110,52 ",2804761144,CFD," 0,00 "
06/09/2024 14:21:28,Position closed,NSDQ100/USD," 1.007,90 ",1.068938," 7,90 "," 9.168,41 "," 8.118,42 ",2804759430,CFD," 0,00 "
06/09/2024 14:21:35,Position closed,NSDQ100/USD," 503,42 ",0.534540," 3,42 "," 9.171,83 "," 8.621,84 ",2804758302,CFD," 0,00 "
06/09/2024 14:22:07,Position closed,NSDQ100/USD," 504,76 ",0.534697," 4,76 "," 9.176,59 "," 9.126,60 ",2804758560,CFD," 0,00 "
06/09/2024 14:22:46,Open Position,NSDQ100/USD," 1.000,00 ",1.069281," 0,00 "," 9.176,59 "," 8.126,60 ",2804766330,CFD," 0,00 "
06/09/2024 14:23:03,Open Position,NSDQ100/USD," 1.000,00 ",1.068710," 0,00 "," 9.176,59 "," 7.126,60 ",2804766892,CFD," 0,00 "
06/09/2024 14:23:21,Open Position,NSDQ100/USD," 500,00 ",0.534632," 0,00 "," 9.176,59 "," 6.626,60 ",2804767288,CFD," 0,00 "
06/09/2024 14:23:47,Position closed,NSDQ100/USD," 1.017,95 ",1.068710," 17,95 "," 9.194,54 "," 7.644,55 ",2804766892,CFD," 0,00 "
06/09/2024 14:23:54,Position closed,NSDQ100/USD," 1.007,91 ",1.069281," 7,91 "," 9.202,45 "," 8.652,46 ",2804766330,CFD," 0,00 "
06/09/2024 14:23:57,Position closed,NSDQ100/USD," 501,92 ",0.534632," 1,92 "," 9.204,37 "," 9.154,38 ",2804767288,CFD," 0,00 "
06/09/2024 14:24:35,Position closed,NSDQ100/USD," 51,36 ",0.053511," 1,37 "," 9.205,74 "," 9.205,74 ",2804751661,CFD," 0,00 "
06/09/2024 14:25:01,Open Position,NSDQ100/USD," 49,99 ",0.053616," 0,00 "," 9.205,74 "," 9.155,75 ",2804769365,CFD," 0,00 "
06/09/2024 14:25:46,Open Position,NSDQ100/USD," 500,00 ",0.537133," 0,00 "," 9.205,74 "," 8.655,75 ",2804771402,CFD," 0,00 "
06/09/2024 14:26:31,Position closed,NSDQ100/USD," 498,34 ",0.537133,"(1,66)"," 9.204,08 "," 9.154,09 ",2804771402,CFD," 0,00 "
06/09/2024 14:26:35,Position closed,NSDQ100/USD," 51,67 ",0.053616," 1,68 "," 9.205,76 "," 9.205,76 ",2804769365,CFD," 0,00 "
06/09/2024 14:29:27,Open Position,NSDQ100/USD," 500,00 ",0.537101," 0,00 "," 9.205,76 "," 8.705,76 ",2804788541,CFD," 0,00 "
06/09/2024 14:29:52,Position closed,NSDQ100/USD," 501,40 ",0.537101," 1,40 "," 9.207,16 "," 9.207,16 ",2804788541,CFD," 0,00 "
06/09/2024 14:30:38,Open Position,NSDQ100/USD," 929,99 ",0.999927," 0,00 "," 9.207,16 "," 8.277,17 ",2804790179,CFD," 0,00 "
06/09/2024 14:30:50,Open Position,NSDQ100/USD," 1.000,00 ",1.075034," 0,00 "," 9.207,16 "," 7.277,17 ",2804790782,CFD," 0,00 "
06/09/2024 14:33:14,Position closed,NSDQ100/USD," 997,97 ",1.075034,"(2,03)"," 9.205,13 "," 8.275,14 ",2804790782,CFD," 0,00 "
06/09/2024 14:33:34,Position closed,NSDQ100/USD," 931,69 ",0.999927," 1,70 "," 9.206,83 "," 9.206,83 ",2804790179,CFD," 0,00 "
06/09/2024 14:38:20,Open Position,NSDQ100/USD," 929,99 ",1.000029," 0,00 "," 9.206,83 "," 8.276,84 ",2804803897,CFD," 0,00 "
06/09/2024 14:39:11,Open Position,NSDQ100/USD," 1.000,00 ",1.075404," 0,00 "," 9.206,83 "," 7.276,84 ",2804806910,CFD," 0,00 "
06/09/2024 14:39:35,Position closed,NSDQ100/USD," 947,19 ",1.000029," 17,20 "," 9.224,03 "," 8.224,03 ",2804803897,CFD," 0,00 "
06/09/2024 14:39:40,Position closed,NSDQ100/USD," 1.013,67 ",1.075404," 13,67 "," 9.237,70 "," 9.237,70 ",2804806910,CFD," 0,00 "
06/09/2024 14:40:48,Open Position,NSDQ100/USD," 500,00 ",0.538721," 0,00 "," 9.237,70 "," 8.737,70 ",2804815935,CFD," 0,00 "
06/09/2024 14:41:23,Position closed,NSDQ100/USD," 502,97 ",0.538721," 2,97 "," 9.240,67 "," 9.240,67 ",2804815935,CFD," 0,00 "
06/09/2024 14:43:02,Open Position,NSDQ100/USD," 99,99 ",0.107914," 0,00 "," 9.240,67 "," 9.140,68 ",2804822546,CFD," 0,00 "
06/09/2024 14:43:39,Position closed,NSDQ100/USD," 100,39 ",0.107914," 0,40 "," 9.241,07 "," 9.241,07 ",2804822546,CFD," 0,00 "
06/09/2024 14:46:45,Open Position,NSDQ100/USD," 929,99 ",1.003877," 0,00 "," 9.241,07 "," 8.311,08 ",2804833337,CFD," 0,00 "
06/09/2024 14:47:18,Position closed,NSDQ100/USD," 934,23 ",1.003877," 4,24 "," 9.245,31 "," 9.245,31 ",2804833337,CFD," 0,00 "
06/09/2024 14:47:51,Open Position,NSDQ100/USD," 299,99 ",0.323760," 0,00 "," 9.245,31 "," 8.945,32 ",2804835810,CFD," 0,00 "
06/09/2024 14:48:39,Open Position,NSDQ100/USD," 999,97 ",1.079507," 0,00 "," 9.245,31 "," 7.945,35 ",2804837806,CFD," 0,00 "
06/09/2024 14:48:54,Position closed,NSDQ100/USD," 297,02 ",0.323760,"(2,97)"," 9.242,34 "," 8.242,37 ",2804835810,CFD," 0,00 "
06/09/2024 14:48:54,Position closed,NSDQ100/USD," 1.000,64 ",1.079507," 0,67 "," 9.243,01 "," 9.243,01 ",2804837806,CFD," 0,00 "
06/09/2024 14:49:34,Open Position,NSDQ100/USD," 929,99 ",1.004891," 0,00 "," 9.243,01 "," 8.313,02 ",2804839557,CFD," 0,00 "
06/09/2024 14:50:20,Open Position,NSDQ100/USD," 1.000,00 ",1.080546," 0,00 "," 9.243,01 "," 7.313,02 ",2804840667,CFD," 0,00 "
06/09/2024 14:50:48,Open Position,NSDQ100/USD," 1.000,00 ",1.080347," 0,00 "," 9.243,01 "," 6.313,02 ",2804841662,CFD," 0,00 "
06/09/2024 14:51:50,Position closed,NSDQ100/USD," 1.004,67 ",1.080347," 4,67 "," 9.247,68 "," 7.317,69 ",2804841662,CFD," 0,00 "
06/09/2024 14:51:50,Position closed,NSDQ100/USD," 1.000,99 ",1.080546," 0,99 "," 9.248,67 "," 8.318,68 ",2804840667,CFD," 0,00 "
06/09/2024 14:51:50,Position closed,NSDQ100/USD," 931,22 ",1.004891," 1,23 "," 9.249,90 "," 9.249,90 ",2804839557,CFD," 0,00 "
06/09/2024 14:54:54,Open Position,NSDQ100/USD," 300,00 ",0.324598," 0,00 "," 9.249,90 "," 8.949,90 ",2804849990,CFD," 0,00 "
06/09/2024 14:57:40,Position closed,NSDQ100/USD," 301,34 ",0.324598," 1,34 "," 9.251,24 "," 9.251,24 ",2804849990,CFD," 0,00 "
06/09/2024 14:59:02,Open Position,NSDQ100/USD," 929,99 ",1.005793," 0,00 "," 9.251,24 "," 8.321,25 ",2804860300,CFD," 0,00 "
06/09/2024 14:59:25,Open Position,NSDQ100/USD," 999,97 ",1.081024," 0,00 "," 9.251,24 "," 7.321,28 ",2804860758,CFD," 0,00 "
06/09/2024 15:00:23,Open Position,NSDQ100/USD," 500,00 ",0.539751," 0,00 "," 9.251,24 "," 6.821,28 ",2804862305,CFD," 0,00 "
06/09/2024 15:02:22,Open Position,NSDQ100/USD," 500,00 ",0.538469," 0,00 "," 9.251,24 "," 6.321,28 ",2804867636,CFD," 0,00 "
06/09/2024 15:04:59,Position closed,NSDQ100/USD," 522,20 ",0.538469," 22,20 "," 9.273,44 "," 6.843,48 ",2804867636,CFD," 0,00 "
06/09/2024 15:06:46,Open Position,NSDQ100/USD," 999,98 ",1.078401," 0,00 "," 9.273,44 "," 5.843,50 ",2804875201,CFD," 0,00 "
06/09/2024 15:07:41,Position closed,NSDQ100/USD," 1.011,86 ",1.078401," 11,88 "," 9.285,32 "," 6.855,36 ",2804875201,CFD," 0,00 "
06/09/2024 15:08:07,Position closed,NSDQ100/USD," 506,00 ",0.539751," 6,00 "," 9.291,32 "," 7.361,36 ",2804862305,CFD," 0,00 "
06/09/2024 15:09:26,Position closed,NSDQ100/USD," 1.000,43 ",1.081024," 0,46 "," 9.291,78 "," 8.361,79 ",2804860758,CFD," 0,00 "
06/09/2024 15:11:16,Position closed,NSDQ100/USD," 926,10 ",1.005793,"(3,89)"," 9.287,89 "," 9.287,89 ",2804860300,CFD," 0,00 "
06/09/2024 15:12:38,Open Position,NSDQ100/USD," 500,00 ",0.540194," 0,00 "," 9.287,89 "," 8.787,89 ",2804883914,CFD," 0,00 "
06/09/2024 15:12:48,Position closed,NSDQ100/USD," 504,06 ",0.540194," 4,06 "," 9.291,95 "," 9.291,95 ",2804883914,CFD," 0,00 "
06/09/2024 15:13:55,Open Position,NSDQ100/USD," 929,99 ",1.004690," 0,00 "," 9.291,95 "," 8.361,96 ",2804886407,CFD," 0,00 "
06/09/2024 15:14:37,Position closed,NSDQ100/USD," 932,42 ",1.004690," 2,43 "," 9.294,38 "," 9.294,38 ",2804886407,CFD," 0,00 "
06/09/2024 15:15:10,Open Position,NSDQ100/USD," 929,99 ",1.004310," 0,00 "," 9.294,38 "," 8.364,39 ",2804888417,CFD," 0,00 "
06/09/2024 15:15:21,Position closed,NSDQ100/USD," 929,21 ",1.004310,"(0,78)"," 9.293,60 "," 9.293,60 ",2804888417,CFD," 0,00 "
06/09/2024 15:15:46,Open Position,NSDQ100/USD," 929,99 ",1.004755," 0,00 "," 9.293,60 "," 8.363,61 ",2804889316,CFD," 0,00 "
06/09/2024 15:16:07,Position closed,NSDQ100/USD," 936,54 ",1.004755," 6,55 "," 9.300,15 "," 9.300,15 ",2804889316,CFD," 0,00 "
06/09/2024 15:17:37,Open Position,NSDQ100/USD," 300,00 ",0.324927," 0,00 "," 9.300,15 "," 9.000,15 ",2804896637,CFD," 0,00 "
06/09/2024 15:18:56,Position closed,NSDQ100/USD," 300,46 ",0.324927," 0,46 "," 9.300,61 "," 9.300,61 ",2804896637,CFD," 0,00 "
06/09/2024 15:20:44,Open Position,NSDQ100/USD," 939,97 ",1.018370," 0,00 "," 9.300,61 "," 8.360,64 ",2804903277,CFD," 0,00 "
06/09/2024 15:21:32,Open Position,NSDQ100/USD," 500,00 ",0.541314," 0,00 "," 9.300,61 "," 7.860,64 ",2804904496,CFD," 0,00 "
06/09/2024 15:23:34,Position closed,NSDQ100/USD," 501,21 ",0.541314," 1,21 "," 9.301,82 "," 8.361,85 ",2804904496,CFD," 0,00 "
06/09/2024 15:24:01,Open Position,NSDQ100/USD," 500,00 ",0.540804," 0,00 "," 9.301,82 "," 7.861,85 ",2804908560,CFD," 0,00 "
06/09/2024 15:24:17,Open Position,NSDQ100/USD," 500,00 ",0.540816," 0,00 "," 9.301,82 "," 7.361,85 ",2804908946,CFD," 0,00 "
06/09/2024 15:26:17,Position closed,NSDQ100/USD," 504,78 ",0.540804," 4,78 "," 9.306,60 "," 7.866,63 ",2804908560,CFD," 0,00 "
06/09/2024 15:26:22,Position closed,NSDQ100/USD," 505,64 ",0.540816," 5,64 "," 9.312,24 "," 8.372,27 ",2804908946,CFD," 0,00 "
06/09/2024 15:28:45,Open Position,NSDQ100/USD," 2.100,00 ",2.271908," 0,00 "," 9.312,24 "," 6.272,27 ",2804915154,CFD," 0,00 "
06/09/2024 15:28:55,Position closed,NSDQ100/USD," 2.124,83 ",2.271908," 24,83 "," 9.337,07 "," 8.397,10 ",2804915154,CFD," 0,00 "
06/09/2024 15:28:58,Position closed,NSDQ100/USD," 922,90 ",1.018370,"(17,07)"," 9.320,00 "," 9.320,00 ",2804903277,CFD," 0,00 "
06/09/2024 15:30:09,Open Position,NSDQ100/USD," 1.999,98 ",2.164952," 0,00 "," 9.320,00 "," 7.320,02 ",2804916747,CFD," 0,00 "
06/09/2024 15:30:51,Open Position,NSDQ100/USD," 1.900,00 ",2.056225," 0,00 "," 9.320,00 "," 5.420,02 ",2804917964,CFD," 0,00 "
06/09/2024 15:31:58,Open Position,NSDQ100/USD," 1.000,00 ",1.081574," 0,00 "," 9.320,00 "," 4.420,02 ",2804920544,CFD," 0,00 "
06/09/2024 15:33:10,Open Position,NSDQ100/USD," 500,00 ",0.540483," 0,00 "," 9.320,00 "," 3.920,02 ",2804922786,CFD," 0,00 "
06/09/2024 15:34:37,Position closed,NSDQ100/USD," 501,10 ",0.540483," 1,10 "," 9.321,10 "," 4.421,12 ",2804922786,CFD," 0,00 "
06/09/2024 15:35:12,Position closed,NSDQ100/USD," 1.008,79 ",1.081574," 8,79 "," 9.329,89 "," 5.429,91 ",2804920544,CFD," 0,00 "
06/09/2024 15:36:21,Position closed,NSDQ100/USD," 1.904,17 ",2.056225," 4,17 "," 9.334,06 "," 7.334,08 ",2804917964,CFD," 0,00 "
06/09/2024 15:36:25,Position closed,NSDQ100/USD," 1.998,10 ",2.164952,"(1,88)"," 9.332,18 "," 9.332,18 ",2804916747,CFD," 0,00 "
06/09/2024 15:37:43,Open Position,NSDQ100/USD," 939,99 ",1.017142," 0,00 "," 9.332,18 "," 8.392,19 ",2804927826,CFD," 0,00 "
06/09/2024 15:38:26,Position closed,NSDQ100/USD," 944,09 ",1.017142," 4,10 "," 9.336,28 "," 9.336,28 ",2804927826,CFD," 0,00 "
06/09/2024 15:40:02,Open Position,NSDQ100/USD," 939,99 ",1.017891," 0,00 "," 9.336,28 "," 8.396,29 ",2804929418,CFD," 0,00 "
06/09/2024 15:41:05,Position closed,NSDQ100/USD," 939,82 ",1.017891,"(0,17)"," 9.336,11 "," 9.336,11 ",2804929418,CFD," 0,00 "
06/09/2024 15:43:05,Open Position,NSDQ100/USD," 500,00 ",0.541721," 0,00 "," 9.336,11 "," 8.836,11 ",2804932483,CFD," 0,00 "
06/09/2024 15:43:36,Open Position,NSDQ100/USD," 500,00 ",0.541413," 0,00 "," 9.336,11 "," 8.336,11 ",2804933075,CFD," 0,00 "
06/09/2024 15:44:51,Position closed,NSDQ100/USD," 505,91 ",0.541413," 5,91 "," 9.342,02 "," 8.842,02 ",2804933075,CFD," 0,00 "
06/09/2024 15:44:54,Position closed,NSDQ100/USD," 500,67 ",0.541721," 0,67 "," 9.342,69 "," 9.342,69 ",2804932483,CFD," 0,00 "
06/09/2024 15:46:37,Open Position,NSDQ100/USD," 499,99 ",0.542300," 0,00 "," 9.342,69 "," 8.842,70 ",2805026334,CFD," 0,00 "
06/09/2024 15:46:50,Position closed,NSDQ100/USD," 502,34 ",0.542300," 2,35 "," 9.345,04 "," 9.345,04 ",2805026334,CFD," 0,00 "
06/09/2024 15:47:19,Open Position,NSDQ100/USD," 939,99 ",1.019646," 0,00 "," 9.345,04 "," 8.405,05 ",2805045346,CFD," 0,00 "
06/09/2024 15:47:38,Position closed,NSDQ100/USD," 944,01 ",1.019646," 4,02 "," 9.349,06 "," 9.349,06 ",2805045346,CFD," 0,00 "
06/09/2024 15:48:14,Open Position,NSDQ100/USD," 939,99 ",1.019717," 0,00 "," 9.349,06 "," 8.409,07 ",2805046157,CFD," 0,00 "
06/09/2024 15:48:28,Position closed,NSDQ100/USD," 945,64 ",1.019717," 5,65 "," 9.354,71 "," 9.354,71 ",2805046157,CFD," 0,00 "
06/09/2024 15:49:35,Open Position,NSDQ100/USD," 1.999,99 ",2.169059," 0,00 "," 9.354,71 "," 7.354,72 ",2805047132,CFD," 0,00 "
06/09/2024 15:50:19,Position closed,NSDQ100/USD," 2.015,48 ",2.169059," 15,49 "," 9.370,20 "," 9.370,20 ",2805047132,CFD," 0,00 "
06/09/2024 15:52:02,Open Position,NSDQ100/USD," 199,99 ",0.217173," 0,00 "," 9.370,20 "," 9.170,21 ",2805049551,CFD," 0,00 "
06/09/2024 15:52:26,Position closed,NSDQ100/USD," 199,56 ",0.217173,"(0,43)"," 9.369,77 "," 9.369,77 ",2805049551,CFD," 0,00 "
06/09/2024 15:52:47,Open Position,NSDQ100/USD," 939,99 ",1.020459," 0,00 "," 9.369,77 "," 8.429,78 ",2805050399,CFD," 0,00 "
06/09/2024 15:53:33,Open Position,NSDQ100/USD," 500,00 ",0.542880," 0,00 "," 9.369,77 "," 7.929,78 ",2805051554,CFD," 0,00 "
06/09/2024 15:54:52,Open Position,NSDQ100/USD," 1.000,00 ",1.084600," 0,00 "," 9.369,77 "," 6.929,78 ",2805053092,CFD," 0,00 "
06/09/2024 15:55:34,Open Position,NSDQ100/USD," 500,00 ",0.541838," 0,00 "," 9.369,77 "," 6.429,78 ",2805053861,CFD," 0,00 "
06/09/2024 15:57:26,Open Position,NSDQ100/USD," 1.699,99 ",1.843021," 0,00 "," 9.369,77 "," 4.729,79 ",2805056278,CFD," 0,00 "
06/09/2024 15:57:41,Position closed,NSDQ100/USD," 1.702,26 ",1.843021," 2,27 "," 9.372,04 "," 6.432,05 ",2805056278,CFD," 0,00 "
06/09/2024 15:58:43,Position closed,NSDQ100/USD," 1.003,29 ",1.084600," 3,29 "," 9.375,33 "," 7.435,34 ",2805053092,CFD," 0,00 "
06/09/2024 15:58:52,Position closed,NSDQ100/USD," 510,80 ",0.541838," 10,80 "," 9.386,13 "," 7.946,14 ",2805053861,CFD," 0,00 "
06/09/2024 15:59:40,Open Position,NSDQ100/USD," 1.000,00 ",1.084612," 0,00 "," 9.386,13 "," 6.946,14 ",2805058834,CFD," 0,00 "
06/09/2024 15:59:49,Position closed,NSDQ100/USD," 1.005,68 ",1.084612," 5,68 "," 9.391,81 "," 7.951,82 ",2805058834,CFD," 0,00 "
06/09/2024 16:01:10,Position closed,NSDQ100/USD," 499,04 ",0.542880,"(0,96)"," 9.390,85 "," 8.450,86 ",2805051554,CFD," 0,00 "
06/09/2024 16:01:10,Position closed,NSDQ100/USD," 941,05 ",1.020459," 1,06 "," 9.391,91 "," 9.391,91 ",2805050399,CFD," 0,00 "
06/09/2024 16:07:33,Open Position,NSDQ100/USD," 939,99 ",1.018900," 0,00 "," 9.391,91 "," 8.451,92 ",2805069446,CFD," 0,00 "
06/09/2024 16:08:24,Withdraw Fee,-,"(5,00)",-,"(5,00)"," 9.386,91 "," 8.446,92 ",-,-," 0,00 "
06/09/2024 16:08:24,Withdraw Request,-,"(65,00)",-,"(65,00)"," 9.321,91 "," 8.381,92 ",-,-," 0,00 "
06/09/2024 16:08:24,Withdrawal Conversion Fee,-," 0,00 ",-," 0,00 "," 9.321,91 "," 8.381,92 ",-,-," 0,00 "
06/09/2024 16:08:33,Position closed,NSDQ100/USD," 951,02 ",1.018900," 11,03 "," 9.332,94 "," 9.332,94 ",2805069446,CFD," 0,00 "
06/09/2024 16:10:06,Open Position,NSDQ100/USD," 939,99 ",1.019248," 0,00 "," 9.332,94 "," 8.392,95 ",2805074111,CFD," 0,00 "
06/09/2024 16:10:23,Position closed,NSDQ100/USD," 946,54 ",1.019248," 6,55 "," 9.339,49 "," 9.339,49 ",2805074111,CFD," 0,00 "
06/09/2024 16:11:33,Open Position,NSDQ100/USD," 939,98 ",1.019541," 0,00 "," 9.339,49 "," 8.399,51 ",2805075501,CFD," 0,00 "
06/09/2024 16:11:53,Position closed,NSDQ100/USD," 943,58 ",1.019541," 3,60 "," 9.343,09 "," 9.343,09 ",2805075501,CFD," 0,00 "
06/09/2024 16:13:02,Open Position,NSDQ100/USD," 939,99 ",1.019126," 0,00 "," 9.343,09 "," 8.403,10 ",2805080482,CFD," 0,00 "
06/09/2024 16:13:26,Open Position,NSDQ100/USD," 2.199,99 ",2.385823," 0,00 "," 9.343,09 "," 6.203,11 ",2805080823,CFD," 0,00 "
06/09/2024 16:13:40,Open Position,NSDQ100/USD," 500,00 ",0.542088," 0,00 "," 9.343,09 "," 5.703,11 ",2805081070,CFD," 0,00 "
06/09/2024 16:14:32,Open Position,NSDQ100/USD," 499,96 ",0.541841," 0,00 "," 9.343,09 "," 5.203,15 ",2805082027,CFD," 0,00 "
06/09/2024 16:14:53,Position closed,NSDQ100/USD," 505,34 ",0.541841," 5,38 "," 9.348,47 "," 5.708,49 ",2805082027,CFD," 0,00 "
06/09/2024 16:14:58,Position closed,NSDQ100/USD," 502,67 ",0.542088," 2,67 "," 9.351,14 "," 6.211,16 ",2805081070,CFD," 0,00 "
06/09/2024 16:15:03,Position closed,NSDQ100/USD," 947,36 ",1.019126," 7,37 "," 9.358,51 "," 7.158,52 ",2805080482,CFD," 0,00 "
06/09/2024 16:15:03,Position closed,NSDQ100/USD," 2.205,55 ",2.385823," 5,56 "," 9.364,07 "," 9.364,07 ",2805080823,CFD," 0,00 "
06/09/2024 16:19:03,Open Position,NSDQ100/USD," 500,00 ",0.542409," 0,00 "," 9.364,07 "," 8.864,07 ",2805087886,CFD," 0,00 "
06/09/2024 16:20:09,Position closed,NSDQ100/USD," 501,65 ",0.542409," 1,65 "," 9.365,72 "," 9.365,72 ",2805087886,CFD," 0,00 "
06/09/2024 16:22:51,Open Position,NSDQ100/USD," 939,99 ",1.019596," 0,00 "," 9.365,72 "," 8.425,73 ",2805093033,CFD," 0,00 "
06/09/2024 16:24:24,Open Position,NSDQ100/USD," 2.199,99 ",2.385797," 0,00 "," 9.365,72 "," 6.225,74 ",2805094231,CFD," 0,00 "
06/09/2024 16:24:48,Open Position,NSDQ100/USD," 1.000,00 ",1.084300," 0,00 "," 9.365,72 "," 5.225,74 ",2805095389,CFD," 0,00 "
06/09/2024 16:26:10,Open Position,NSDQ100/USD," 1.000,00 ",1.083942," 0,00 "," 9.365,72 "," 4.225,74 ",2805097574,CFD," 0,00 "
06/09/2024 16:27:11,Position closed,NSDQ100/USD," 1.010,22 ",1.083942," 10,22 "," 9.375,94 "," 5.235,96 ",2805097574,CFD," 0,00 "
06/09/2024 16:27:35,Position closed,NSDQ100/USD," 2.209,60 ",2.385797," 9,61 "," 9.385,55 "," 7.445,56 ",2805094231,CFD," 0,00 "
06/09/2024 16:27:41,Position closed,NSDQ100/USD," 942,37 ",1.019596," 2,38 "," 9.387,93 "," 8.387,93 ",2805093033,CFD," 0,00 "
06/09/2024 16:27:46,Position closed,NSDQ100/USD," 1.013,38 ",1.084300," 13,38 "," 9.401,31 "," 9.401,31 ",2805095389,CFD," 0,00 "
06/09/2024 16:31:59,Open Position,NSDQ100/USD," 500,00 ",0.542889," 0,00 "," 9.401,31 "," 8.901,31 ",2805104973,CFD," 0,00 "
06/09/2024 16:32:12,Position closed,NSDQ100/USD," 501,70 ",0.542889," 1,70 "," 9.403,01 "," 9.403,01 ",2805104973,CFD," 0,00 "
06/09/2024 16:33:23,Open Position,NSDQ100/USD," 949,99 ",1.031192," 0,00 "," 9.403,01 "," 8.453,02 ",2805105864,CFD," 0,00 "
06/09/2024 16:33:46,Open Position,NSDQ100/USD," 2.199,99 ",2.386496," 0,00 "," 9.403,01 "," 6.253,03 ",2805106073,CFD," 0,00 "
06/09/2024 16:34:20,Open Position,NSDQ100/USD," 999,98 ",1.084273," 0,00 "," 9.403,01 "," 5.253,05 ",2805106459,CFD," 0,00 "
06/09/2024 16:34:45,Open Position,NSDQ100/USD," 500,00 ",0.542144," 0,00 "," 9.403,01 "," 4.753,05 ",2805107129,CFD," 0,00 "
06/09/2024 16:35:31,Open Position,NSDQ100/USD," 1.200,00 ",1.300202," 0,00 "," 9.403,01 "," 3.553,05 ",2805108380,CFD," 0,00 "
06/09/2024 16:35:51,Open Position,NSDQ100/USD," 889,91 ",0.964603," 0,00 "," 9.403,01 "," 2.663,14 ",2805108637,CFD," 0,00 "
06/09/2024 16:37:14,Position closed,NSDQ100/USD," 997,41 ",1.084273,"(2,57)"," 9.400,44 "," 3.660,55 ",2805106459,CFD," 0,00 "
06/09/2024 16:38:24,Position closed,NSDQ100/USD," 499,09 ",0.542144,"(0,91)"," 9.399,53 "," 4.159,64 ",2805107129,CFD," 0,00 "
06/09/2024 16:38:29,Position closed,NSDQ100/USD," 895,24 ",0.964603," 5,33 "," 9.404,86 "," 5.054,88 ",2805108637,CFD," 0,00 "
06/09/2024 16:39:42,Position closed,NSDQ100/USD," 947,35 ",1.031192,"(2,64)"," 9.402,22 "," 6.002,23 ",2805105864,CFD," 0,00 "
06/09/2024 16:39:42,Position closed,NSDQ100/USD," 1.240,10 ",1.300202," 40,10 "," 9.442,32 "," 7.242,33 ",2805108380,CFD," 0,00 "
06/09/2024 16:39:42,Position closed,NSDQ100/USD," 2.222,04 ",2.386496," 22,05 "," 9.464,37 "," 9.464,37 ",2805106073,CFD," 0,00 "
06/09/2024 16:41:52,Open Position,NSDQ100/USD," 299,99 ",0.325773," 0,00 "," 9.464,37 "," 9.164,38 ",2805113338,CFD," 0,00 "
06/09/2024 16:42:39,Position closed,NSDQ100/USD," 302,15 ",0.325773," 2,16 "," 9.466,53 "," 9.466,53 ",2805113338,CFD," 0,00 "
06/09/2024 16:43:02,Open Position,NSDQ100/USD," 949,98 ",1.031119," 0,00 "," 9.466,53 "," 8.516,55 ",2805114039,CFD," 0,00 "
06/09/2024 16:43:25,Open Position,NSDQ100/USD," 500,00 ",0.542506," 0,00 "," 9.466,53 "," 8.016,55 ",2805114214,CFD," 0,00 "
06/09/2024 16:43:50,Open Position,NSDQ100/USD," 499,99 ",0.542365," 0,00 "," 9.466,53 "," 7.516,56 ",2805114415,CFD," 0,00 "
06/09/2024 16:44:31,Position closed,NSDQ100/USD," 502,34 ",0.542365," 2,35 "," 9.468,88 "," 8.018,90 ",2805114415,CFD," 0,00 "
06/09/2024 16:44:47,Open Position,NSDQ100/USD," 1.000,00 ",1.084582," 0,00 "," 9.468,88 "," 7.018,90 ",2805115116,CFD," 0,00 "
06/09/2024 16:45:44,Open Position,NSDQ100/USD," 1.000,00 ",1.084977," 0,00 "," 9.468,88 "," 6.018,90 ",2805115894,CFD," 0,00 "
06/09/2024 16:47:03,Position closed,NSDQ100/USD," 1.010,89 ",1.084582," 10,89 "," 9.479,77 "," 7.029,79 ",2805115116,CFD," 0,00 "
06/09/2024 16:47:17,Position closed,NSDQ100/USD," 1.003,41 ",1.084977," 3,41 "," 9.483,18 "," 8.033,20 ",2805115894,CFD," 0,00 "
06/09/2024 16:47:30,Position closed,NSDQ100/USD," 948,78 ",1.031119,"(1,20)"," 9.481,98 "," 8.981,98 ",2805114039,CFD," 0,00 "
06/09/2024 16:47:30,Position closed,NSDQ100/USD," 503,01 ",0.542506," 3,01 "," 9.484,99 "," 9.484,99 ",2805114214,CFD," 0,00 "
06/09/2024 16:50:04,Open Position,NSDQ100/USD," 299,99 ",0.325780," 0,00 "," 9.484,99 "," 9.185,00 ",2805122104,CFD," 0,00 "
06/09/2024 16:52:53,Open Position,NSDQ100/USD," 300,00 ",0.325990," 0,00 "," 9.484,99 "," 8.885,00 ",2805124472,CFD," 0,00 "
06/09/2024 16:53:36,Open Position,NSDQ100/USD," 300,00 ",0.325952," 0,00 "," 9.484,99 "," 8.585,00 ",2805124835,CFD," 0,00 "
06/09/2024 16:54:46,Open Position,NSDQ100/USD," 500,00 ",0.543254," 0,00 "," 9.484,99 "," 8.085,00 ",2805125912,CFD," 0,00 "
06/09/2024 16:55:12,Position closed,NSDQ100/USD," 297,14 ",0.325780,"(2,85)"," 9.482,14 "," 8.382,14 ",2805122104,CFD," 0,00 "
06/09/2024 16:55:25,Open Position,NSDQ100/USD," 500,00 ",0.543396," 0,00 "," 9.482,14 "," 7.882,14 ",2805126288,CFD," 0,00 "
06/09/2024 16:58:55,Open Position,NSDQ100/USD," 500,00 ",0.543015," 0,00 "," 9.482,14 "," 7.382,14 ",2805137078,CFD," 0,00 "
06/09/2024 17:05:03,Open Position,NSDQ100/USD," 1.900,00 ",2.061187," 0,00 "," 9.482,14 "," 5.482,14 ",2805142453,CFD," 0,00 "
06/09/2024 17:07:02,Open Position,NSDQ100/USD," 1.399,99 ",1.518130," 0,00 "," 9.482,14 "," 4.082,15 ",2805143962,CFD," 0,00 "
06/09/2024 17:07:12,Position closed,NSDQ100/USD," 1.392,75 ",1.518130,"(7,24)"," 9.474,90 "," 5.474,90 ",2805143962,CFD," 0,00 "
06/09/2024 17:07:35,Open Position,NSDQ100/USD," 1.400,00 ",1.518119," 0,00 "," 9.474,90 "," 4.074,90 ",2805145455,CFD," 0,00 "
06/09/2024 17:09:07,Open Position,NSDQ100/USD," 1.099,99 ",1.192510," 0,00 "," 9.474,90 "," 2.974,91 ",2805146460,CFD," 0,00 "
06/09/2024 17:09:33,Open Position,NSDQ100/USD," 749,97 ",0.812314," 0,00 "," 9.474,90 "," 2.224,94 ",2805146723,CFD," 0,00 "
06/09/2024 17:12:34,Open Position,NSDQ100/USD," 559,99 ",0.606357," 0,00 "," 9.474,90 "," 1.664,95 ",2805149415,CFD," 0,00 "
06/09/2024 17:14:46,Open Position,NSDQ100/USD," 419,99 ",0.454484," 0,00 "," 9.474,90 "," 1.244,96 ",2805151603,CFD," 0,00 "
06/09/2024 17:38:48,Position closed,NSDQ100/USD," 1.401,72 ",1.518119," 1,72 "," 9.476,62 "," 2.646,68 ",2805145455,CFD," 0,00 "
06/09/2024 17:39:53,Position closed,NSDQ100/USD," 437,68 ",0.454484," 17,69 "," 9.494,31 "," 3.084,36 ",2805151603,CFD," 0,00 "
06/09/2024 17:40:35,Position closed,NSDQ100/USD," 772,01 ",0.812314," 22,04 "," 9.516,35 "," 3.856,37 ",2805146723,CFD," 0,00 "
06/09/2024 17:41:16,Position closed,NSDQ100/USD," 1.900,47 ",2.061187," 0,47 "," 9.516,82 "," 5.756,84 ",2805142453,CFD," 0,00 "
06/09/2024 17:42:34,Position closed,NSDQ100/USD," 489,37 ",0.543015,"(10,63)"," 9.506,19 "," 6.246,21 ",2805137078,CFD," 0,00 "
06/09/2024 17:42:43,Position closed,NSDQ100/USD," 487,80 ",0.543254,"(12,20)"," 9.493,99 "," 6.734,01 ",2805125912,CFD," 0,00 "
06/09/2024 17:42:43,Position closed,NSDQ100/USD," 292,68 ",0.325952,"(7,32)"," 9.486,67 "," 7.026,69 ",2805124835,CFD," 0,00 "
06/09/2024 17:42:43,Position closed,NSDQ100/USD," 485,19 ",0.543396,"(14,81)"," 9.471,86 "," 7.511,88 ",2805126288,CFD," 0,00 "
06/09/2024 17:42:43,Position closed,NSDQ100/USD," 291,99 ",0.325990,"(8,01)"," 9.463,85 "," 7.803,87 ",2805124472,CFD," 0,00 "
06/09/2024 17:42:43,Position closed,NSDQ100/USD," 584,81 ",0.606357," 24,82 "," 9.488,67 "," 8.388,68 ",2805149415,CFD," 0,00 "
06/09/2024 17:42:43,Position closed,NSDQ100/USD," 1.121,98 ",1.192510," 21,99 "," 9.510,66 "," 9.510,66 ",2805146460,CFD," 0,00 "
06/09/2024 18:54:02,Open Position,NSDQ100/USD," 959,97 ",1.041193," 0,00 "," 9.510,66 "," 8.550,69 ",2805221550,CFD," 0,00 "
06/09/2024 18:55:07,Open Position,NSDQ100/USD," 1.000,00 ",1.084371," 0,00 "," 9.510,66 "," 7.550,69 ",2805221845,CFD," 0,00 "
06/09/2024 18:56:56,Open Position,NSDQ100/USD," 1.900,00 ",2.058954," 0,00 "," 9.510,66 "," 5.650,69 ",2805223004,CFD," 0,00 "
06/09/2024 18:58:02,Position closed,NSDQ100/USD," 1.910,77 ",2.058954," 10,77 "," 9.521,43 "," 7.561,46 ",2805223004,CFD," 0,00 "
06/09/2024 18:59:46,Position closed,NSDQ100/USD," 996,45 ",1.084371,"(3,55)"," 9.517,88 "," 8.557,91 ",2805221845,CFD," 0,00 "
06/09/2024 19:00:36,Open Position,NSDQ100/USD," 2.199,99 ",2.383432," 0,00 "," 9.517,88 "," 6.357,92 ",2805225441,CFD," 0,00 "
06/09/2024 19:01:49,Position closed,NSDQ100/USD," 2.212,22 ",2.383432," 12,23 "," 9.530,11 "," 8.570,14 ",2805225441,CFD," 0,00 "
06/09/2024 19:03:14,Open Position,NSDQ100/USD," 2.199,99 ",2.383781," 0,00 "," 9.530,11 "," 6.370,15 ",2805227354,CFD," 0,00 "
06/09/2024 19:04:14,Open Position,NSDQ100/USD," 1.499,99 ",1.624750," 0,00 "," 9.530,11 "," 4.870,16 ",2805227724,CFD," 0,00 "
06/09/2024 19:06:12,Open Position,NSDQ100/USD," 1.000,00 ",1.082458," 0,00 "," 9.530,11 "," 3.870,16 ",2805229343,CFD," 0,00 "
06/09/2024 19:07:09,Position closed,NSDQ100/USD," 1.011,50 ",1.082458," 11,50 "," 9.541,61 "," 4.881,66 ",2805229343,CFD," 0,00 "
06/09/2024 19:11:27,Open Position,NSDQ100/USD," 1.299,99 ",1.406503," 0,00 "," 9.541,61 "," 3.581,67 ",2805233004,CFD," 0,00 "
06/09/2024 19:11:51,Open Position,NSDQ100/USD," 899,99 ",0.973869," 0,00 "," 9.541,61 "," 2.681,68 ",2805233132,CFD," 0,00 "
06/09/2024 19:16:00,Position closed,NSDQ100/USD," 1.310,30 ",1.406503," 10,31 "," 9.551,92 "," 3.991,98 ",2805233004,CFD," 0,00 "
06/09/2024 19:16:19,Position closed,NSDQ100/USD," 906,45 ",0.973869," 6,46 "," 9.558,38 "," 4.898,43 ",2805233132,CFD," 0,00 "
06/09/2024 19:27:31,Open Position,NSDQ100/USD," 500,00 ",0.540758," 0,00 "," 9.558,38 "," 4.398,43 ",2805241793,CFD," 0,00 "
06/09/2024 19:33:14,Position closed,NSDQ100/USD," 508,07 ",0.540758," 8,07 "," 9.566,45 "," 4.906,50 ",2805241793,CFD," 0,00 "
06/09/2024 19:39:05,Position closed,NSDQ100/USD," 2.204,59 ",2.383781," 4,60 "," 9.571,05 "," 7.111,09 ",2805227354,CFD," 0,00 "
06/09/2024 19:39:18,Position closed,NSDQ100/USD," 1.516,45 ",1.624750," 16,46 "," 9.587,51 "," 8.627,54 ",2805227724,CFD," 0,00 "
06/09/2024 19:39:18,Position closed,NSDQ100/USD," 945,01 ",1.041193,"(14,96)"," 9.572,55 "," 9.572,55 ",2805221550,CFD," 0,00 "
09/09/2024 03:07:07,Open Position,NSDQ100/USD," 499,99 ",0.540582," 0,00 "," 9.572,55 "," 9.072,56 ",2805364060,CFD," 0,00 "
09/09/2024 03:31:43,Position closed,NSDQ100/USD," 499,95 ",0.540582,"(0,04)"," 9.572,51 "," 9.572,51 ",2805364060,CFD," 0,00 "
09/09/2024 03:32:37,Open Position,NSDQ100/USD," 959,99 ",1.037457," 0,00 "," 9.572,51 "," 8.612,52 ",2805364877,CFD," 0,00 "
09/09/2024 03:33:02,Open Position,NSDQ100/USD," 999,99 ",1.080783," 0,00 "," 9.572,51 "," 7.612,53 ",2805364888,CFD," 0,00 "
09/09/2024 03:33:21,Open Position,NSDQ100/USD," 499,99 ",0.540406," 0,00 "," 9.572,51 "," 7.112,54 ",2805364900,CFD," 0,00 "
09/09/2024 04:09:24,Position closed,NSDQ100/USD," 1.019,68 ",1.080783," 19,69 "," 9.592,20 "," 8.132,22 ",2805364888,CFD," 0,00 "
09/09/2024 04:09:24,Position closed,NSDQ100/USD," 977,13 ",1.037457," 17,14 "," 9.609,34 "," 9.109,35 ",2805364877,CFD," 0,00 "
09/09/2024 04:09:24,Position closed,NSDQ100/USD," 510,11 ",0.540406," 10,12 "," 9.619,46 "," 9.619,46 ",2805364900,CFD," 0,00 "
09/09/2024 04:10:33,Open Position,NSDQ100/USD," 499,99 ",0.539342," 0,00 "," 9.619,46 "," 9.119,47 ",2805366178,CFD," 0,00 "
09/09/2024 04:12:53,Position closed,NSDQ100/USD," 498,92 ",0.539342,"(1,07)"," 9.618,39 "," 9.618,39 ",2805366178,CFD," 0,00 "
09/09/2024 04:21:37,Open Position,NSDQ100/USD," 969,99 ",1.046482," 0,00 "," 9.618,39 "," 8.648,40 ",2805367011,CFD," 0,00 "
09/09/2024 04:23:36,Open Position,NSDQ100/USD," 500,00 ",0.539775," 0,00 "," 9.618,39 "," 8.148,40 ",2805367098,CFD," 0,00 "
09/09/2024 04:24:46,Position closed,NSDQ100/USD," 499,26 ",0.539775,"(0,74)"," 9.617,65 "," 8.647,66 ",2805367098,CFD," 0,00 "
09/09/2024 04:25:10,Open Position,NSDQ100/USD," 999,99 ",1.079546," 0,00 "," 9.617,65 "," 7.647,67 ",2805367504,CFD," 0,00 "
09/09/2024 04:25:51,Open Position,NSDQ100/USD," 499,99 ",0.539694," 0,00 "," 9.617,65 "," 7.147,68 ",2805367529,CFD," 0,00 "
09/09/2024 04:26:57,Open Position,NSDQ100/USD," 600,00 ",0.647466," 0,00 "," 9.617,65 "," 6.547,68 ",2805367578,CFD," 0,00 "
09/09/2024 04:29:19,Position closed,NSDQ100/USD," 1.011,24 ",1.079546," 11,25 "," 9.628,90 "," 7.558,92 ",2805367504,CFD," 0,00 "
09/09/2024 04:29:26,Position closed,NSDQ100/USD," 503,67 ",0.539694," 3,68 "," 9.632,58 "," 8.062,59 ",2805367529,CFD," 0,00 "
09/09/2024 04:29:33,Position closed,NSDQ100/USD," 600,98 ",0.647466," 0,98 "," 9.633,56 "," 8.663,57 ",2805367578,CFD," 0,00 "
09/09/2024 04:29:46,Position closed,NSDQ100/USD," 966,24 ",1.046482,"(3,75)"," 9.629,81 "," 9.629,81 ",2805367011,CFD," 0,00 "
09/09/2024 04:30:45,Open Position,NSDQ100/USD," 149,99 ",0.161842," 0,00 "," 9.629,81 "," 9.479,82 ",2805368002,CFD," 0,00 "
09/09/2024 04:34:40,Open Position,NSDQ100/USD," 2.399,99 ",2.588746," 0,00 "," 9.629,81 "," 7.079,83 ",2805368144,CFD," 0,00 "
09/09/2024 04:35:10,Open Position,NSDQ100/USD," 999,99 ",1.078778," 0,00 "," 9.629,81 "," 6.079,84 ",2805368163,CFD," 0,00 "
09/09/2024 04:35:47,Open Position,NSDQ100/USD," 1.599,99 ",1.726184," 0,00 "," 9.629,81 "," 4.479,85 ",2805368181,CFD," 0,00 "
09/09/2024 04:38:02,Open Position,NSDQ100/USD," 499,99 ",0.539290," 0,00 "," 9.629,81 "," 3.979,86 ",2805368292,CFD," 0,00 "
09/09/2024 04:42:21,Open Position,NSDQ100/USD," 600,00 ",0.647123," 0,00 "," 9.629,81 "," 3.379,86 ",2805368633,CFD," 0,00 "
09/09/2024 04:44:13,Open Position,NSDQ100/USD," 499,99 ",0.539330," 0,00 "," 9.629,81 "," 2.879,87 ",2805368721,CFD," 0,00 "
09/09/2024 04:48:32,Position closed,NSDQ100/USD," 1.007,24 ",1.078778," 7,25 "," 9.637,06 "," 3.887,11 ",2805368163,CFD," 0,00 "
09/09/2024 04:48:32,Position closed,NSDQ100/USD," 151,56 ",0.161842," 1,57 "," 9.638,63 "," 4.038,67 ",2805368002,CFD," 0,00 "
09/09/2024 04:48:32,Position closed,NSDQ100/USD," 1.614,35 ",1.726184," 14,36 "," 9.652,99 "," 5.653,02 ",2805368181,CFD," 0,00 "
09/09/2024 04:48:32,Position closed,NSDQ100/USD," 2.411,69 ",2.588746," 11,70 "," 9.664,69 "," 8.064,71 ",2805368144,CFD," 0,00 "
09/09/2024 04:48:32,Position closed,NSDQ100/USD," 502,59 ",0.539330," 2,60 "," 9.667,29 "," 8.567,30 ",2805368721,CFD," 0,00 "
09/09/2024 04:48:32,Position closed,NSDQ100/USD," 501,83 ",0.539290," 1,84 "," 9.669,13 "," 9.069,13 ",2805368292,CFD," 0,00 "
09/09/2024 04:48:32,Position closed,NSDQ100/USD," 601,76 ",0.647123," 1,76 "," 9.670,89 "," 9.670,89 ",2805368633,CFD," 0,00 "
09/09/2024 04:49:30,Open Position,NSDQ100/USD," 499,99 ",0.539031," 0,00 "," 9.670,89 "," 9.170,90 ",2805368994,CFD," 0,00 "
09/09/2024 04:51:46,Open Position,NSDQ100/USD," 499,99 ",0.539046," 0,00 "," 9.670,89 "," 8.670,91 ",2805369137,CFD," 0,00 "
09/09/2024 04:52:34,Open Position,NSDQ100/USD," 2.200,00 ",2.371457," 0,00 "," 9.670,89 "," 6.470,91 ",2805369176,CFD," 0,00 "
09/09/2024 04:53:55,Open Position,NSDQ100/USD," 999,99 ",1.078289," 0,00 "," 9.670,89 "," 5.470,92 ",2805369308,CFD," 0,00 "
09/09/2024 04:54:33,Open Position,NSDQ100/USD," 499,99 ",0.539112," 0,00 "," 9.670,89 "," 4.970,93 ",2805369440,CFD," 0,00 "
09/09/2024 04:55:46,Open Position,NSDQ100/USD," 600,00 ",0.647005," 0,00 "," 9.670,89 "," 4.370,93 ",2805369503,CFD," 0,00 "
09/09/2024 04:56:57,Open Position,NSDQ100/USD," 499,96 ",0.539336," 0,00 "," 9.670,89 "," 3.870,97 ",2805369946,CFD," 0,00 "
09/09/2024 05:02:25,Open Position,NSDQ100/USD," 499,99 ",0.539444," 0,00 "," 9.670,89 "," 3.370,98 ",2805370323,CFD," 0,00 "
09/09/2024 05:07:03,Open Position,NSDQ100/USD," 600,00 ",0.647490," 0,00 "," 9.670,89 "," 2.770,98 ",2805370871,CFD," 0,00 "
09/09/2024 07:00:54,Position closed,NSDQ100/USD," 1.007,99 ",1.078289," 8,00 "," 9.678,89 "," 3.778,97 ",2805369308,CFD," 0,00 "
09/09/2024 07:00:54,Position closed,NSDQ100/USD," 2.203,13 ",2.371457," 3,13 "," 9.682,02 "," 5.982,10 ",2805369176,CFD," 0,00 "
09/09/2024 07:00:54,Position closed,NSDQ100/USD," 501,89 ",0.539031," 1,90 "," 9.683,92 "," 6.483,99 ",2805368994,CFD," 0,00 "
09/09/2024 07:00:54,Position closed,NSDQ100/USD," 509,55 ",0.539444," 9,56 "," 9.693,48 "," 6.993,54 ",2805370323,CFD," 0,00 "
09/09/2024 07:00:54,Position closed,NSDQ100/USD," 508,17 ",0.539336," 8,21 "," 9.701,69 "," 7.501,71 ",2805369946,CFD," 0,00 "
09/09/2024 07:00:54,Position closed,NSDQ100/USD," 502,16 ",0.539046," 2,17 "," 9.703,86 "," 8.003,87 ",2805369137,CFD," 0,00 "
09/09/2024 07:00:54,Position closed,NSDQ100/USD," 503,40 ",0.539112," 3,41 "," 9.707,27 "," 8.507,27 ",2805369440,CFD," 0,00 "
09/09/2024 07:00:54,Position closed,NSDQ100/USD," 614,39 ",0.647490," 14,39 "," 9.721,66 "," 9.121,66 ",2805370871,CFD," 0,00 "
09/09/2024 07:00:54,Position closed,NSDQ100/USD," 605,38 ",0.647005," 5,38 "," 9.727,04 "," 9.727,04 ",2805369503,CFD," 0,00 "
09/09/2024 07:15:51,Open Position,NSDQ100/USD," 499,99 ",0.538607," 0,00 "," 9.727,04 "," 9.227,05 ",2805423715,CFD," 0,00 "
09/09/2024 07:21:03,Position closed,NSDQ100/USD," 502,32 ",0.538607," 2,33 "," 9.729,37 "," 9.729,37 ",2805423715,CFD," 0,00 "
09/09/2024 07:22:27,Open Position,NSDQ100/USD," 979,99 ",1.055557," 0,00 "," 9.729,37 "," 8.749,38 ",2805448888,CFD," 0,00 "
09/09/2024 07:25:07,Open Position,NSDQ100/USD," 999,99 ",1.077540," 0,00 "," 9.729,37 "," 7.749,39 ",2805450461,CFD," 0,00 "
09/09/2024 07:27:09,Open Position,NSDQ100/USD," 499,99 ",0.538929," 0,00 "," 9.729,37 "," 7.249,40 ",2805450942,CFD," 0,00 "
09/09/2024 07:30:10,Position closed,NSDQ100/USD," 502,37 ",0.538929," 2,38 "," 9.731,75 "," 7.751,77 ",2805450942,CFD," 0,00 "
09/09/2024 07:30:33,Open Position,NSDQ100/USD," 500,00 ",0.538760," 0,00 "," 9.731,75 "," 7.251,77 ",2805452302,CFD," 0,00 "
09/09/2024 07:30:43,Position closed,NSDQ100/USD," 1.003,46 ",1.077540," 3,47 "," 9.735,22 "," 8.255,23 ",2805450461,CFD," 0,00 "
09/09/2024 07:31:26,Open Position,NSDQ100/USD," 500,00 ",0.538633," 0,00 "," 9.735,22 "," 7.755,23 ",2805452732,CFD," 0,00 "
09/09/2024 07:33:13,Position closed,NSDQ100/USD," 501,84 ",0.538633," 1,84 "," 9.737,06 "," 8.257,07 ",2805452732,CFD," 0,00 "
09/09/2024 07:33:28,Open Position,NSDQ100/USD," 1.000,00 ",1.077428," 0,00 "," 9.737,06 "," 7.257,07 ",2805453846,CFD," 0,00 "
09/09/2024 07:36:02,Position closed,NSDQ100/USD," 999,81 ",1.077428,"(0,19)"," 9.736,87 "," 8.256,88 ",2805453846,CFD," 0,00 "
09/09/2024 07:36:19,Open Position,NSDQ100/USD," 499,99 ",0.538659," 0,00 "," 9.736,87 "," 7.756,89 ",2805454587,CFD," 0,00 "
09/09/2024 07:36:53,Position closed,NSDQ100/USD," 500,65 ",0.538659," 0,66 "," 9.737,53 "," 8.257,54 ",2805454587,CFD," 0,00 "
09/09/2024 07:37:41,Open Position,NSDQ100/USD," 500,00 ",0.538589," 0,00 "," 9.737,53 "," 7.757,54 ",2805454790,CFD," 0,00 "
09/09/2024 07:37:57,Position closed,NSDQ100/USD," 980,22 ",1.055557," 0,23 "," 9.737,76 "," 8.737,76 ",2805448888,CFD," 0,00 "
09/09/2024 07:39:17,Position closed,NSDQ100/USD," 496,34 ",0.538589,"(3,66)"," 9.734,10 "," 9.234,10 ",2805454790,CFD," 0,00 "
09/09/2024 07:39:17,Position closed,NSDQ100/USD," 493,16 ",0.538760,"(6,84)"," 9.727,26 "," 9.727,26 ",2805452302,CFD," 0,00 "
09/09/2024 07:42:42,Open Position,NSDQ100/USD," 499,99 ",0.538450," 0,00 "," 9.727,26 "," 9.227,27 ",2805456232,CFD," 0,00 "
09/09/2024 07:43:52,Open Position,NSDQ100/USD," 2.400,00 ",2.584897," 0,00 "," 9.727,26 "," 6.827,27 ",2805456407,CFD," 0,00 "
09/09/2024 07:44:41,Open Position,NSDQ100/USD," 499,99 ",0.538465," 0,00 "," 9.727,26 "," 6.327,28 ",2805456756,CFD," 0,00 "
09/09/2024 07:46:24,Open Position,NSDQ100/USD," 499,99 ",0.538485," 0,00 "," 9.727,26 "," 5.827,29 ",2805457247,CFD," 0,00 "
09/09/2024 07:46:44,Position closed,NSDQ100/USD," 2.404,94 ",2.584897," 4,94 "," 9.732,20 "," 8.232,23 ",2805456407,CFD," 0,00 "
09/09/2024 07:47:38,Position closed,NSDQ100/USD," 500,53 ",0.538450," 0,54 "," 9.732,74 "," 8.732,76 ",2805456232,CFD," 0,00 "
09/09/2024 07:47:38,Position closed,NSDQ100/USD," 500,80 ",0.538465," 0,81 "," 9.733,55 "," 9.233,56 ",2805456756,CFD," 0,00 "
09/09/2024 07:47:38,Position closed,NSDQ100/USD," 501,18 ",0.538485," 1,19 "," 9.734,74 "," 9.734,74 ",2805457247,CFD," 0,00 "
09/09/2024 07:49:03,Open Position,NSDQ100/USD," 980,00 ",1.055027," 0,00 "," 9.734,74 "," 8.754,74 ",2805458059,CFD," 0,00 "
09/09/2024 07:50:52,Open Position,NSDQ100/USD," 999,99 ",1.076165," 0,00 "," 9.734,74 "," 7.754,75 ",2805458865,CFD," 0,00 "
09/09/2024 07:51:11,Position closed,NSDQ100/USD," 974,31 ",1.055027,"(5,69)"," 9.729,05 "," 8.729,06 ",2805458059,CFD," 0,00 "
09/09/2024 07:51:46,Open Position,NSDQ100/USD," 499,99 ",0.538143," 0,00 "," 9.729,05 "," 8.229,07 ",2805459079,CFD," 0,00 "
09/09/2024 07:53:26,Position closed,NSDQ100/USD," 502,20 ",0.538143," 2,21 "," 9.731,26 "," 8.731,27 ",2805459079,CFD," 0,00 "
09/09/2024 07:53:30,Position closed,NSDQ100/USD," 1.004,09 ",1.076165," 4,10 "," 9.735,36 "," 9.735,36 ",2805458865,CFD," 0,00 "
09/09/2024 07:54:47,Open Position,NSDQ100/USD," 500,00 ",0.538068," 0,00 "," 9.735,36 "," 9.235,36 ",2805459625,CFD," 0,00 "
09/09/2024 07:55:49,Position closed,NSDQ100/USD," 500,11 ",0.538068," 0,11 "," 9.735,47 "," 9.735,47 ",2805459625,CFD," 0,00 "
09/09/2024 07:56:03,Open Position,NSDQ100/USD," 979,99 ",1.054579," 0,00 "," 9.735,47 "," 8.755,48 ",2805459798,CFD," 0,00 "
09/09/2024 07:56:08,Open Position,NSDQ100/USD," 2.200,00 ",2.367577," 0,00 "," 9.735,47 "," 6.555,48 ",2805459816,CFD," 0,00 "
09/09/2024 07:56:53,Open Position,NSDQ100/USD," 999,99 ",1.076321," 0,00 "," 9.735,47 "," 5.555,49 ",2805459996,CFD," 0,00 "
09/09/2024 07:58:15,Open Position,NSDQ100/USD," 499,99 ",0.538065," 0,00 "," 9.735,47 "," 5.055,50 ",2805460391,CFD," 0,00 "
09/09/2024 07:59:36,Position closed,NSDQ100/USD," 2.214,70 ",2.367577," 14,70 "," 9.750,17 "," 7.270,20 ",2805459816,CFD," 0,00 "
09/09/2024 07:59:36,Position closed,NSDQ100/USD," 1.009,47 ",1.076321," 9,48 "," 9.759,65 "," 8.279,67 ",2805459996,CFD," 0,00 "
09/09/2024 07:59:36,Position closed,NSDQ100/USD," 502,95 ",0.538065," 2,96 "," 9.762,61 "," 8.782,62 ",2805460391,CFD," 0,00 "
09/09/2024 07:59:36,Position closed,NSDQ100/USD," 985,27 ",1.054579," 5,28 "," 9.767,89 "," 9.767,89 ",2805459798,CFD," 0,00 "
09/09/2024 08:00:06,Open Position,NSDQ100/USD," 500,00 ",0.538204," 0,00 "," 9.767,89 "," 9.267,89 ",2805460657,CFD," 0,00 "
09/09/2024 08:00:12,Open Position,NSDQ100/USD," 2.400,00 ",2.582992," 0,00 "," 9.767,89 "," 6.867,89 ",2805460673,CFD," 0,00 "
09/09/2024 08:00:28,Position closed,NSDQ100/USD," 498,93 ",0.538204,"(1,07)"," 9.766,82 "," 7.366,82 ",2805460657,CFD," 0,00 "
09/09/2024 08:00:45,Open Position,NSDQ100/USD," 1.499,99 ",1.614213," 0,00 "," 9.766,82 "," 5.866,83 ",2805460758,CFD," 0,00 "
09/09/2024 08:01:57,Open Position,NSDQ100/USD," 1.499,99 ",1.614031," 0,00 "," 9.766,82 "," 4.366,84 ",2805460977,CFD," 0,00 "
09/09/2024 08:02:38,Position closed,NSDQ100/USD," 1.503,23 ",1.614031," 3,24 "," 9.770,06 "," 5.870,07 ",2805460977,CFD," 0,00 "
09/09/2024 08:02:38,Position closed,NSDQ100/USD," 1.506,62 ",1.614213," 6,63 "," 9.776,69 "," 7.376,69 ",2805460758,CFD," 0,00 "
09/09/2024 08:02:38,Position closed,NSDQ100/USD," 2.415,27 ",2.582992," 15,27 "," 9.791,96 "," 9.791,96 ",2805460673,CFD," 0,00 "
09/09/2024 08:03:29,Open Position,NSDQ100/USD," 979,99 ",1.054443," 0,00 "," 9.791,96 "," 8.811,97 ",2805461563,CFD," 0,00 "
09/09/2024 08:04:14,Open Position,NSDQ100/USD," 499,99 ",0.538079," 0,00 "," 9.791,96 "," 8.311,98 ",2805461661,CFD," 0,00 "
09/09/2024 08:05:21,Open Position,NSDQ100/USD," 499,99 ",0.538111," 0,00 "," 9.791,96 "," 7.811,99 ",2805461848,CFD," 0,00 "
09/09/2024 08:05:29,Open Position,NSDQ100/USD," 1.999,99 ",2.152875," 0,00 "," 9.791,96 "," 5.812,00 ",2805461873,CFD," 0,00 "
09/09/2024 08:06:00,Open Position,NSDQ100/USD," 999,99 ",1.076293," 0,00 "," 9.791,96 "," 4.812,01 ",2805462041,CFD," 0,00 "
09/09/2024 08:07:50,Position closed,NSDQ100/USD," 999,89 ",1.076293,"(0,10)"," 9.791,86 "," 5.811,90 ",2805462041,CFD," 0,00 "
09/09/2024 08:07:54,Position closed,NSDQ100/USD," 499,62 ",0.538111,"(0,37)"," 9.791,49 "," 6.311,52 ",2805461848,CFD," 0,00 "
09/09/2024 08:08:13,Open Position,NSDQ100/USD," 1.600,00 ",1.722198," 0,00 "," 9.791,49 "," 4.711,52 ",2805462383,CFD," 0,00 "
09/09/2024 08:09:16,Open Position,NSDQ100/USD," 499,99 ",0.538331," 0,00 "," 9.791,49 "," 4.211,53 ",2805462551,CFD," 0,00 "
09/09/2024 08:10:51,Position closed,NSDQ100/USD," 2.006,47 ",2.152875," 6,48 "," 9.797,97 "," 6.218,00 ",2805461873,CFD," 0,00 "
09/09/2024 08:10:57,Position closed,NSDQ100/USD," 1.604,67 ",1.722198," 4,67 "," 9.802,64 "," 7.822,67 ",2805462383,CFD," 0,00 "
09/09/2024 08:11:02,Position closed,NSDQ100/USD," 499,67 ",0.538079,"(0,32)"," 9.802,32 "," 8.322,34 ",2805461661,CFD," 0,00 "
09/09/2024 08:11:02,Position closed,NSDQ100/USD," 975,78 ",1.054443,"(4,21)"," 9.798,11 "," 9.298,12 ",2805461563,CFD," 0,00 "
09/09/2024 08:11:02,Position closed,NSDQ100/USD," 504,36 ",0.538331," 4,37 "," 9.802,48 "," 9.802,48 ",2805462551,CFD," 0,00 "
09/09/2024 08:11:33,Open Position,NSDQ100/USD," 989,99 ",1.065467," 0,00 "," 9.802,48 "," 8.812,49 ",2805465626,CFD," 0,00 "
09/09/2024 08:12:17,Open Position,NSDQ100/USD," 499,99 ",0.538227," 0,00 "," 9.802,48 "," 8.312,50 ",2805465768,CFD," 0,00 "
09/09/2024 08:12:31,Open Position,NSDQ100/USD," 499,99 ",0.538187," 0,00 "," 9.802,48 "," 7.812,51 ",2805465796,CFD," 0,00 "
09/09/2024 08:13:17,Position closed,NSDQ100/USD," 501,50 ",0.538227," 1,51 "," 9.803,99 "," 8.314,01 ",2805465768,CFD," 0,00 "
09/09/2024 08:13:35,Open Position,NSDQ100/USD," 2.099,99 ",2.260032," 0,00 "," 9.803,99 "," 6.214,02 ",2805465925,CFD," 0,00 "
09/09/2024 08:14:17,Open Position,NSDQ100/USD," 600,00 ",0.645820," 0,00 "," 9.803,99 "," 5.614,02 ",2805466004,CFD," 0,00 "
09/09/2024 08:14:33,Open Position,NSDQ100/USD," 499,99 ",0.538343," 0,00 "," 9.803,99 "," 5.114,03 ",2805466112,CFD," 0,00 "
09/09/2024 08:14:48,Open Position,NSDQ100/USD," 1.299,99 ",1.399723," 0,00 "," 9.803,99 "," 3.814,04 ",2805466157,CFD," 0,00 "
09/09/2024 08:19:38,Open Position,NSDQ100/USD," 959,99 ",1.033652," 0,00 "," 9.803,99 "," 2.854,05 ",2805467017,CFD," 0,00 "
09/09/2024 08:21:47,Open Position,NSDQ100/USD," 719,99 ",0.775941," 0,00 "," 9.803,99 "," 2.134,06 ",2805467326,CFD," 0,00 "
09/09/2024 08:22:29,Open Position,NSDQ100/USD," 540,00 ",0.581878," 0,00 "," 9.803,99 "," 1.594,06 ",2805467432,CFD," 0,00 "
09/09/2024 08:23:01,Open Position,NSDQ100/USD," 600,00 ",0.646576," 0,00 "," 9.803,99 "," 994,06 ",2805467618,CFD," 0,00 "
09/09/2024 08:59:29,Position closed,NSDQ100/USD," 497,52 ",0.538187,"(2,47)"," 9.801,52 "," 1.491,58 ",2805465796,CFD," 0,00 "
09/09/2024 08:59:29,Position closed,NSDQ100/USD," 596,97 ",0.645820,"(3,03)"," 9.798,49 "," 2.088,55 ",2805466004,CFD," 0,00 "
09/09/2024 08:59:29,Position closed,NSDQ100/USD," 2.083,06 ",2.260032,"(16,93)"," 9.781,56 "," 4.171,61 ",2805465925,CFD," 0,00 "
09/09/2024 08:59:29,Position closed,NSDQ100/USD," 982,44 ",1.065467,"(7,55)"," 9.774,01 "," 5.154,05 ",2805465626,CFD," 0,00 "
09/09/2024 08:59:29,Position closed,NSDQ100/USD," 1.301,68 ",1.399723," 1,69 "," 9.775,70 "," 6.455,73 ",2805466157,CFD," 0,00 "
09/09/2024 08:59:29,Position closed,NSDQ100/USD," 500,43 ",0.538343," 0,44 "," 9.776,14 "," 6.956,16 ",2805466112,CFD," 0,00 "
09/09/2024 08:59:29,Position closed,NSDQ100/USD," 734,13 ",0.775941," 14,14 "," 9.790,28 "," 7.690,29 ",2805467326,CFD," 0,00 "
09/09/2024 08:59:29,Position closed,NSDQ100/USD," 961,45 ",1.033652," 1,46 "," 9.791,74 "," 8.651,74 ",2805467017,CFD," 0,00 "
09/09/2024 08:59:29,Position closed,NSDQ100/USD," 611,00 ",0.646576," 11,00 "," 9.802,74 "," 9.262,74 ",2805467618,CFD," 0,00 "
09/09/2024 08:59:29,Position closed,NSDQ100/USD," 549,15 ",0.581878," 9,15 "," 9.811,89 "," 9.811,89 ",2805467432,CFD," 0,00 "
09/09/2024 09:01:58,Open Position,NSDQ100/USD," 499,99 ",0.538224," 0,00 "," 9.811,89 "," 9.311,90 ",2805482450,CFD," 0,00 "
09/09/2024 09:02:11,Open Position,NSDQ100/USD," 499,99 ",0.538244," 0,00 "," 9.811,89 "," 8.811,91 ",2805482469,CFD," 0,00 "
09/09/2024 09:09:34,Position closed,NSDQ100/USD," 505,70 ",0.538224," 5,71 "," 9.817,60 "," 9.317,61 ",2805482450,CFD," 0,00 "
09/09/2024 09:09:34,Position closed,NSDQ100/USD," 506,08 ",0.538244," 6,09 "," 9.823,69 "," 9.823,69 ",2805482469,CFD," 0,00 "
09/09/2024 09:10:30,Open Position,NSDQ100/USD," 500,00 ",0.537862," 0,00 "," 9.823,69 "," 9.323,69 ",2805483888,CFD," 0,00 "
09/09/2024 09:14:07,Position closed,NSDQ100/USD," 497,48 ",0.537862,"(2,52)"," 9.821,17 "," 9.821,17 ",2805483888,CFD," 0,00 "
09/09/2024 09:14:27,Open Position,NSDQ100/USD," 300,00 ",0.322651," 0,00 "," 9.821,17 "," 9.521,17 ",2805484501,CFD," 0,00 "
09/09/2024 09:19:07,Open Position,NSDQ100/USD," 499,99 ",0.537894," 0,00 "," 9.821,17 "," 9.021,18 ",2805485505,CFD," 0,00 "
09/09/2024 09:26:26,Position closed,NSDQ100/USD," 505,53 ",0.537894," 5,54 "," 9.826,71 "," 9.526,71 ",2805485505,CFD," 0,00 "
09/09/2024 09:26:26,Position closed,NSDQ100/USD," 301,74 ",0.322651," 1,74 "," 9.828,45 "," 9.828,45 ",2805484501,CFD," 0,00 "
09/09/2024 09:28:37,Open Position,NSDQ100/USD," 300,00 ",0.322502," 0,00 "," 9.828,45 "," 9.528,45 ",2805487036,CFD," 0,00 "
09/09/2024 09:30:25,Open Position,NSDQ100/USD," 300,00 ",0.322578," 0,00 "," 9.828,45 "," 9.228,45 ",2805487254,CFD," 0,00 "
09/09/2024 09:38:03,Open Position,NSDQ100/USD," 399,99 ",0.430167," 0,00 "," 9.828,45 "," 8.828,46 ",2805488536,CFD," 0,00 "
09/09/2024 09:38:34,Open Position,NSDQ100/USD," 399,99 ",0.430260," 0,00 "," 9.828,45 "," 8.428,47 ",2805488579,CFD," 0,00 "
09/09/2024 09:43:08,Open Position,NSDQ100/USD," 600,00 ",0.645556," 0,00 "," 9.828,45 "," 7.828,47 ",2805489586,CFD," 0,00 "
09/09/2024 09:44:59,Open Position,NSDQ100/USD," 599,99 ",0.645716," 0,00 "," 9.828,45 "," 7.228,48 ",2805489849,CFD," 0,00 "
09/09/2024 09:51:51,Open Position,NSDQ100/USD," 399,99 ",0.430459," 0,00 "," 9.828,45 "," 6.828,49 ",2805491061,CFD," 0,00 "
09/09/2024 09:52:32,Open Position,NSDQ100/USD," 299,99 ",0.322866," 0,00 "," 9.828,45 "," 6.528,50 ",2805491134,CFD," 0,00 "
09/09/2024 10:02:49,Position closed,NSDQ100/USD," 407,22 ",0.430459," 7,23 "," 9.835,68 "," 6.935,72 ",2805491061,CFD," 0,00 "
09/09/2024 10:03:12,Position closed,NSDQ100/USD," 609,10 ",0.645556," 9,10 "," 9.844,78 "," 7.544,82 ",2805489586,CFD," 0,00 "
09/09/2024 10:03:17,Position closed,NSDQ100/USD," 403,95 ",0.430260," 3,96 "," 9.848,74 "," 7.948,77 ",2805488579,CFD," 0,00 "
09/09/2024 10:03:23,Position closed,NSDQ100/USD," 402,66 ",0.430167," 2,67 "," 9.851,41 "," 8.351,43 ",2805488536,CFD," 0,00 "
09/09/2024 10:03:59,Position closed,NSDQ100/USD," 301,84 ",0.322578," 1,84 "," 9.853,25 "," 8.653,27 ",2805487254,CFD," 0,00 "
09/09/2024 10:04:07,Position closed,NSDQ100/USD," 300,52 ",0.322502," 0,52 "," 9.853,77 "," 8.953,79 ",2805487036,CFD," 0,00 "
09/09/2024 10:04:42,Position closed,NSDQ100/USD," 291,80 ",0.322866,"(8,19)"," 9.845,58 "," 9.245,59 ",2805491134,CFD," 0,00 "
09/09/2024 10:04:42,Position closed,NSDQ100/USD," 583,92 ",0.645716,"(16,07)"," 9.829,51 "," 9.829,51 ",2805489849,CFD," 0,00 "
09/09/2024 10:06:32,Open Position,NSDQ100/USD," 300,00 ",0.322485," 0,00 "," 9.829,51 "," 9.529,51 ",2805493223,CFD," 0,00 "
09/09/2024 10:07:45,Position closed,NSDQ100/USD," 301,45 ",0.322485," 1,45 "," 9.830,96 "," 9.830,96 ",2805493223,CFD," 0,00 "
09/09/2024 10:08:29,Open Position,NSDQ100/USD," 399,99 ",0.429830," 0,00 "," 9.830,96 "," 9.430,97 ",2805493669,CFD," 0,00 "
09/09/2024 10:18:13,Open Position,NSDQ100/USD," 300,00 ",0.322407," 0,00 "," 9.830,96 "," 9.130,97 ",2805495371,CFD," 0,00 "
09/09/2024 10:26:31,Open Position,NSDQ100/USD," 499,99 ",0.537622," 0,00 "," 9.830,96 "," 8.630,98 ",2805497275,CFD," 0,00 "
09/09/2024 10:43:24,Open Position,NSDQ100/USD," 999,99 ",1.076518," 0,00 "," 9.830,96 "," 7.630,99 ",2805500904,CFD," 0,00 "
09/09/2024 10:55:16,Position closed,NSDQ100/USD," 1.002,91 ",1.076518," 2,92 "," 9.833,88 "," 8.633,90 ",2805500904,CFD," 0,00 "
09/09/2024 10:55:38,Open Position,NSDQ100/USD," 499,99 ",0.538079," 0,00 "," 9.833,88 "," 8.133,91 ",2805503192,CFD," 0,00 "
09/09/2024 10:55:55,Open Position,NSDQ100/USD," 300,00 ",0.322938," 0,00 "," 9.833,88 "," 7.833,91 ",2805503235,CFD," 0,00 "
09/09/2024 10:58:51,Open Position,NSDQ100/USD," 999,99 ",1.076513," 0,00 "," 9.833,88 "," 6.833,92 ",2805504289,CFD," 0,00 "
09/09/2024 11:03:31,Open Position,NSDQ100/USD," 999,99 ",1.076553," 0,00 "," 9.833,88 "," 5.833,93 ",2805505047,CFD," 0,00 "
09/09/2024 11:06:10,Position closed,NSDQ100/USD," 1.002,91 ",1.076553," 2,92 "," 9.836,80 "," 6.836,84 ",2805505047,CFD," 0,00 "
09/09/2024 11:06:13,Position closed,NSDQ100/USD," 1.002,91 ",1.076513," 2,92 "," 9.839,72 "," 7.839,75 ",2805504289,CFD," 0,00 "
09/09/2024 11:06:16,Position closed,NSDQ100/USD," 300,71 ",0.322938," 0,71 "," 9.840,43 "," 8.140,46 ",2805503235,CFD," 0,00 "
09/09/2024 11:07:47,Open Position,NSDQ100/USD," 1.499,99 ",1.614830," 0,00 "," 9.840,43 "," 6.640,47 ",2805505595,CFD," 0,00 "
09/09/2024 11:08:02,Open Position,NSDQ100/USD," 499,99 ",0.538288," 0,00 "," 9.840,43 "," 6.140,48 ",2805505619,CFD," 0,00 "
09/09/2024 11:08:24,Open Position,NSDQ100/USD," 499,99 ",0.538302," 0,00 "," 9.840,43 "," 5.640,49 ",2805505722,CFD," 0,00 "
09/09/2024 11:09:15,Position closed,NSDQ100/USD," 1.503,24 ",1.614830," 3,25 "," 9.843,68 "," 7.143,73 ",2805505595,CFD," 0,00 "
09/09/2024 11:09:18,Position closed,NSDQ100/USD," 500,75 ",0.538288," 0,76 "," 9.844,44 "," 7.644,48 ",2805505619,CFD," 0,00 "
09/09/2024 11:09:20,Position closed,NSDQ100/USD," 500,86 ",0.538302," 0,87 "," 9.845,31 "," 8.145,34 ",2805505722,CFD," 0,00 "
09/09/2024 11:10:21,Position closed,NSDQ100/USD," 500,75 ",0.538079," 0,76 "," 9.846,07 "," 8.646,09 ",2805503192,CFD," 0,00 "
09/09/2024 11:14:02,Open Position,NSDQ100/USD," 499,99 ",0.537755," 0,00 "," 9.846,07 "," 8.146,10 ",2805506733,CFD," 0,00 "
09/09/2024 11:19:29,Open Position,NSDQ100/USD," 399,98 ",0.430200," 0,00 "," 9.846,07 "," 7.746,12 ",2805507363,CFD," 0,00 "
09/09/2024 11:31:01,Position closed,NSDQ100/USD," 402,60 ",0.430200," 2,62 "," 9.848,69 "," 8.148,72 ",2805507363,CFD," 0,00 "
09/09/2024 11:31:04,Position closed,NSDQ100/USD," 503,38 ",0.537755," 3,39 "," 9.852,08 "," 8.652,10 ",2805506733,CFD," 0,00 "
09/09/2024 11:31:07,Position closed,NSDQ100/USD," 501,12 ",0.537622," 1,13 "," 9.853,21 "," 9.153,22 ",2805497275,CFD," 0,00 "
09/09/2024 11:31:54,Open Position,NSDQ100/USD," 499,99 ",0.537732," 0,00 "," 9.853,21 "," 8.653,23 ",2805509221,CFD," 0,00 "
09/09/2024 11:32:11,Open Position,NSDQ100/USD," 999,99 ",1.075419," 0,00 "," 9.853,21 "," 7.653,24 ",2805509254,CFD," 0,00 "
09/09/2024 11:34:27,Open Position,NSDQ100/USD," 1.999,99 ",2.152377," 0,00 "," 9.853,21 "," 5.653,25 ",2805509694,CFD," 0,00 "
09/09/2024 11:34:49,Open Position,NSDQ100/USD," 1.499,99 ",1.614422," 0,00 "," 9.853,21 "," 4.153,26 ",2805509741,CFD," 0,00 "
09/09/2024 11:35:31,Open Position,NSDQ100/USD," 1.100,00 ",1.184068," 0,00 "," 9.853,21 "," 3.053,26 ",2805509856,CFD," 0,00 "
09/09/2024 11:36:12,Open Position,NSDQ100/USD," 769,99 ",0.828888," 0,00 "," 9.853,21 "," 2.283,27 ",2805510102,CFD," 0,00 "
09/09/2024 11:38:04,Open Position,NSDQ100/USD," 580,00 ",0.624414," 0,00 "," 9.853,21 "," 1.703,27 ",2805510996,CFD," 0,00 "
09/09/2024 11:54:28,Open Position,NSDQ100/USD," 699,99 ",0.754127," 0,00 "," 9.853,21 "," 1.003,28 ",2805514105,CFD," 0,00 "
09/09/2024 11:57:30,Position closed,NSDQ100/USD," 703,85 ",0.754127," 3,86 "," 9.857,07 "," 1.707,13 ",2805514105,CFD," 0,00 "
09/09/2024 11:58:48,Open Position,NSDQ100/USD," 429,99 ",0.463040," 0,00 "," 9.857,07 "," 1.277,14 ",2805514781,CFD," 0,00 "
09/09/2024 12:05:25,Open Position,NSDQ100/USD," 600,00 ",0.646726," 0,00 "," 9.857,07 "," 677,14 ",2805517471,CFD," 0,00 "
09/09/2024 13:03:02,Position closed,NSDQ100/USD," 430,18 ",0.463040," 0,19 "," 9.857,26 "," 1.107,32 ",2805514781,CFD," 0,00 "
09/09/2024 13:14:12,Position closed,NSDQ100/USD," 612,82 ",0.646726," 12,82 "," 9.870,08 "," 1.720,14 ",2805517471,CFD," 0,00 "
09/09/2024 13:24:51,Open Position,NSDQ100/USD," 439,99 ",0.473780," 0,00 "," 9.870,08 "," 1.280,15 ",2805539442,CFD," 0,00 "
09/09/2024 13:31:26,Position closed,NSDQ100/USD," 1.004,13 ",1.075419," 4,14 "," 9.874,22 "," 2.284,28 ",2805509254,CFD," 0,00 "
09/09/2024 13:31:26,Position closed,NSDQ100/USD," 395,37 ",0.429830,"(4,62)"," 9.869,60 "," 2.679,65 ",2805493669,CFD," 0,00 "
09/09/2024 13:31:27,Position closed,NSDQ100/USD," 502,49 ",0.537732," 2,50 "," 9.872,10 "," 3.182,14 ",2805509221,CFD," 0,00 "
09/09/2024 13:31:27,Position closed,NSDQ100/USD," 297,18 ",0.322407,"(2,82)"," 9.869,28 "," 3.479,32 ",2805495371,CFD," 0,00 "
09/09/2024 13:31:27,Position closed,NSDQ100/USD," 2.036,90 ",2.152377," 36,91 "," 9.906,19 "," 5.516,22 ",2805509694,CFD," 0,00 "
09/09/2024 13:31:27,Position closed,NSDQ100/USD," 788,35 ",0.828888," 18,36 "," 9.924,55 "," 6.304,57 ",2805510102,CFD," 0,00 "
09/09/2024 13:31:27,Position closed,NSDQ100/USD," 1.124,92 ",1.184068," 24,92 "," 9.949,47 "," 7.429,49 ",2805509856,CFD," 0,00 "
09/09/2024 13:31:27,Position closed,NSDQ100/USD," 594,77 ",0.624414," 14,77 "," 9.964,24 "," 8.024,26 ",2805510996,CFD," 0,00 "
09/09/2024 13:31:27,Position closed,NSDQ100/USD," 1.529,94 ",1.614422," 29,95 "," 9.994,19 "," 9.554,20 ",2805509741,CFD," 0,00 "
09/09/2024 13:31:27,Position closed,NSDQ100/USD," 451,39 ",0.473780," 11,40 "," 10.005,59 "," 10.005,59 ",2805539442,CFD," 0,00 "
09/09/2024 13:36:17,Open Position,NSDQ100/USD," 200,00 ",0.214726," 0,00 "," 10.005,59 "," 9.805,59 ",2805630212,CFD," 0,00 "
09/09/2024 13:37:04,Position closed,NSDQ100/USD," 196,87 ",0.214726,"(3,13)"," 10.002,46 "," 10.002,46 ",2805630212,CFD," 0,00 "
09/09/2024 13:38:07,Open Position,NSDQ100/USD," 49,99 ",0.053713," 0,00 "," 10.002,46 "," 9.952,47 ",2805641433,CFD," 0,00 "
09/09/2024 13:58:28,Open Position,NSDQ100/USD," 149,99 ",0.160875," 0,00 "," 10.002,46 "," 9.802,48 ",2805767102,CFD," 0,00 "
09/09/2024 14:16:30,Position closed,NSDQ100/USD," 152,32 ",0.160875," 2,33 "," 10.004,79 "," 9.954,80 ",2805767102,CFD," 0,00 "
09/09/2024 14:16:30,Position closed,NSDQ100/USD," 47,42 ",0.053713,"(2,57)"," 10.002,22 "," 10.002,22 ",2805641433,CFD," 0,00 "
09/09/2024 14:19:51,Open Position,NSDQ100/USD," 400,00 ",0.429646," 0,00 "," 10.002,22 "," 9.602,22 ",2805799303,CFD," 0,00 "
09/09/2024 14:32:32,Open Position,NSDQ100/USD," 299,99 ",0.323299," 0,00 "," 10.002,22 "," 9.302,23 ",2805815305,CFD," 0,00 "
09/09/2024 14:35:40,Position closed,NSDQ100/USD," 296,50 ",0.323299,"(3,49)"," 9.998,73 "," 9.598,73 ",2805815305,CFD," 0,00 "
09/09/2024 14:36:14,Open Position,NSDQ100/USD," 500,00 ",0.539448," 0,00 "," 9.998,73 "," 9.098,73 ",2805819784,CFD," 0,00 "
09/09/2024 14:40:27,Position closed,NSDQ100/USD," 503,19 ",0.539448," 3,19 "," 10.001,92 "," 9.601,92 ",2805819784,CFD," 0,00 "
09/09/2024 14:40:46,Open Position,NSDQ100/USD," 500,00 ",0.539733," 0,00 "," 10.001,92 "," 9.101,92 ",2805824035,CFD," 0,00 "
09/09/2024 14:43:17,Position closed,NSDQ100/USD," 500,44 ",0.539733," 0,44 "," 10.002,36 "," 9.602,36 ",2805824035,CFD," 0,00 "
09/09/2024 14:43:32,Open Position,NSDQ100/USD," 1.000,00 ",1.079472," 0,00 "," 10.002,36 "," 8.602,36 ",2805826034,CFD," 0,00 "
09/09/2024 14:44:06,Position closed,NSDQ100/USD," 361,38 ",0.429646,"(38,62)"," 9.963,74 "," 8.963,74 ",2805799303,CFD," 0,00 "
09/09/2024 14:44:32,Open Position,NSDQ100/USD," 499,99 ",0.539597," 0,00 "," 9.963,74 "," 8.463,75 ",2805826855,CFD," 0,00 "
09/09/2024 14:44:58,Position closed,NSDQ100/USD," 1.012,11 ",1.079472," 12,11 "," 9.975,85 "," 9.475,86 ",2805826034,CFD," 0,00 "
09/09/2024 14:45:39,Position closed,NSDQ100/USD," 492,55 ",0.539597,"(7,44)"," 9.968,41 "," 9.968,41 ",2805826855,CFD," 0,00 "
09/09/2024 14:45:59,Open Position,NSDQ100/USD," 1.000,00 ",1.080026," 0,00 "," 9.968,41 "," 8.968,41 ",2805827998,CFD," 0,00 "
09/09/2024 14:46:40,Open Position,NSDQ100/USD," 500,00 ",0.539908," 0,00 "," 9.968,41 "," 8.468,41 ",2805828412,CFD," 0,00 "
09/09/2024 14:47:13,Position closed,NSDQ100/USD," 1.001,32 ",1.080026," 1,32 "," 9.969,73 "," 9.469,73 ",2805827998,CFD," 0,00 "
09/09/2024 14:47:49,Position closed,NSDQ100/USD," 503,68 ",0.539908," 3,68 "," 9.973,41 "," 9.973,41 ",2805828412,CFD," 0,00 "
09/09/2024 14:48:06,Open Position,NSDQ100/USD," 1.000,00 ",1.080913," 0,00 "," 9.973,41 "," 8.973,41 ",2805829376,CFD," 0,00 "
09/09/2024 14:49:13,Open Position,NSDQ100/USD," 500,00 ",0.539911," 0,00 "," 9.973,41 "," 8.473,41 ",2805830541,CFD," 0,00 "
09/09/2024 14:49:31,Position closed,NSDQ100/USD," 502,12 ",0.539911," 2,12 "," 9.975,53 "," 8.975,53 ",2805830541,CFD," 0,00 "
09/09/2024 14:50:12,Open Position,NSDQ100/USD," 1.000,00 ",1.079647," 0,00 "," 9.975,53 "," 7.975,53 ",2805831464,CFD," 0,00 "
09/09/2024 14:52:39,Position closed,NSDQ100/USD," 998,83 ",1.079647,"(1,17)"," 9.974,36 "," 8.974,36 ",2805831464,CFD," 0,00 "
09/09/2024 14:58:31,Position closed,NSDQ100/USD," 1.006,19 ",1.080913," 6,19 "," 9.980,55 "," 9.980,55 ",2805829376,CFD," 0,00 "
09/09/2024 15:19:33,Open Position,NSDQ100/USD," 399,98 ",0.432869," 0,00 "," 9.980,55 "," 9.580,57 ",2805858231,CFD," 0,00 "
09/09/2024 15:21:02,Position closed,NSDQ100/USD," 401,16 ",0.432869," 1,18 "," 9.981,73 "," 9.981,73 ",2805858231,CFD," 0,00 "
09/09/2024 15:21:43,Open Position,NSDQ100/USD," 499,99 ",0.541129," 0,00 "," 9.981,73 "," 9.481,74 ",2805861800,CFD," 0,00 "
09/09/2024 15:26:59,Open Position,NSDQ100/USD," 500,00 ",0.540334," 0,00 "," 9.981,73 "," 8.981,74 ",2805867135,CFD," 0,00 "
09/09/2024 15:32:40,Open Position,NSDQ100/USD," 999,99 ",1.077868," 0,00 "," 9.981,73 "," 7.981,75 ",2805870221,CFD," 0,00 "
09/09/2024 15:38:38,Open Position,NSDQ100/USD," 1.999,99 ",2.157618," 0,00 "," 9.981,73 "," 5.981,76 ",2805873931,CFD," 0,00 "
09/09/2024 15:39:49,Position closed,NSDQ100/USD," 1.003,14 ",1.077868," 3,15 "," 9.984,88 "," 6.984,90 ",2805870221,CFD," 0,00 "
09/09/2024 15:41:38,Open Position,NSDQ100/USD," 499,99 ",0.538516," 0,00 "," 9.984,88 "," 6.484,91 ",2805875469,CFD," 0,00 "
09/09/2024 15:43:13,Open Position,NSDQ100/USD," 1.000,00 ",1.077704," 0,00 "," 9.984,88 "," 5.484,91 ",2805876097,CFD," 0,00 "
09/09/2024 15:46:01,Open Position,NSDQ100/USD," 999,97 ",1.077787," 0,00 "," 9.984,88 "," 4.484,94 ",2805877007,CFD," 0,00 "
09/09/2024 15:46:07,Position closed,NSDQ100/USD," 1.000,85 ",1.077787," 0,88 "," 9.985,76 "," 5.485,79 ",2805877007,CFD," 0,00 "
09/09/2024 15:46:22,Open Position,NSDQ100/USD," 1.000,00 ",1.077791," 0,00 "," 9.985,76 "," 4.485,79 ",2805877156,CFD," 0,00 "
09/09/2024 15:47:27,Open Position,NSDQ100/USD," 1.200,00 ",1.292597," 0,00 "," 9.985,76 "," 3.285,79 ",2805877549,CFD," 0,00 "
09/09/2024 15:48:07,Position closed,NSDQ100/USD," 499,30 ",0.538516,"(0,69)"," 9.985,07 "," 3.785,09 ",2805875469,CFD," 0,00 "
09/09/2024 15:48:15,Open Position,NSDQ100/USD," 500,00 ",0.538489," 0,00 "," 9.985,07 "," 3.285,09 ",2805877872,CFD," 0,00 "
09/09/2024 15:52:51,Open Position,NSDQ100/USD," 830,00 ",0.893729," 0,00 "," 9.985,07 "," 2.455,09 ",2805881106,CFD," 0,00 "
09/09/2024 17:15:39,Open Position,NSDQ100/USD," 1.000,00 ",1.070798," 0,00 "," 9.985,07 "," 1.455,09 ",2805944509,CFD," 0,00 "
09/09/2024 17:25:58,Open Position,NSDQ100/USD," 299,99 ",0.321208," 0,00 "," 9.985,07 "," 1.155,10 ",2805949782,CFD," 0,00 "
09/09/2024 17:31:28,Position closed,NSDQ100/USD," 291,38 ",0.321208,"(8,61)"," 9.976,46 "," 1.446,48 ",2805949782,CFD," 0,00 "
09/09/2024 17:35:17,Open Position,NSDQ100/USD," 500,00 ",0.536418," 0,00 "," 9.976,46 "," 946,48 ",2805953868,CFD," 0,00 "
09/09/2024 18:08:04,Open Position,NSDQ100/USD," 500,00 ",0.538159," 0,00 "," 9.976,46 "," 446,48 ",2805968430,CFD," 0,00 "
09/09/2024 18:19:31,Position closed,NSDQ100/USD," 971,24 ",1.077704,"(28,76)"," 9.947,70 "," 1.417,72 ",2805876097,CFD," 0,00 "
09/09/2024 18:19:31,Position closed,NSDQ100/USD," 443,07 ",0.541129,"(56,92)"," 9.890,78 "," 1.860,79 ",2805861800,CFD," 0,00 "
09/09/2024 18:19:31,Position closed,NSDQ100/USD," 458,08 ",0.540334,"(41,92)"," 9.848,86 "," 2.318,87 ",2805867135,CFD," 0,00 "
09/09/2024 18:19:31,Position closed,NSDQ100/USD," 1.901,41 ",2.157618,"(98,58)"," 9.750,28 "," 4.220,28 ",2805873931,CFD," 0,00 "
09/09/2024 18:19:31,Position closed,NSDQ100/USD," 820,36 ",0.893729,"(9,64)"," 9.740,64 "," 5.040,64 ",2805881106,CFD," 0,00 "
09/09/2024 18:19:31,Position closed,NSDQ100/USD," 969,62 ",1.077791,"(30,38)"," 9.710,26 "," 6.010,26 ",2805877156,CFD," 0,00 "
09/09/2024 18:19:31,Position closed,NSDQ100/USD," 492,36 ",0.538489,"(7,64)"," 9.702,62 "," 6.502,62 ",2805877872,CFD," 0,00 "
09/09/2024 18:19:31,Position closed,NSDQ100/USD," 1.177,52 ",1.292597,"(22,48)"," 9.680,14 "," 7.680,14 ",2805877549,CFD," 0,00 "
09/09/2024 18:19:31,Position closed,NSDQ100/USD," 498,50 ",0.538159,"(1,50)"," 9.678,64 "," 8.178,64 ",2805968430,CFD," 0,00 "
09/09/2024 18:19:31,Position closed,NSDQ100/USD," 1.099,58 ",1.070798," 99,58 "," 9.778,22 "," 9.278,22 ",2805944509,CFD," 0,00 "
09/09/2024 18:19:32,Position closed,NSDQ100/USD," 530,84 ",0.536418," 30,84 "," 9.809,06 "," 9.809,06 ",2805953868,CFD," 0,00 "
09/09/2024 18:20:11,Open Position,NSDQ100/USD," 1.499,99 ",1.614625," 0,00 "," 9.809,06 "," 8.309,07 ",2805975190,CFD," 0,00 "
09/09/2024 18:20:34,Open Position,NSDQ100/USD," 2.100,00 ",2.261181," 0,00 "," 9.809,06 "," 6.209,07 ",2805975287,CFD," 0,00 "
09/09/2024 18:21:44,Position closed,NSDQ100/USD," 1.510,99 ",1.614625," 11,00 "," 9.820,06 "," 7.720,06 ",2805975190,CFD," 0,00 "
09/09/2024 18:21:44,Position closed,NSDQ100/USD," 2.102,28 ",2.261181," 2,28 "," 9.822,34 "," 9.822,34 ",2805975287,CFD," 0,00 "
09/09/2024 18:22:06,Open Position,NSDQ100/USD," 1.499,99 ",1.615895," 0,00 "," 9.822,34 "," 8.322,35 ",2805975796,CFD," 0,00 "
09/09/2024 18:22:44,Open Position,NSDQ100/USD," 2.100,00 ",2.261571," 0,00 "," 9.822,34 "," 6.222,35 ",2805975961,CFD," 0,00 "
09/09/2024 18:24:53,Open Position,NSDQ100/USD," 1.599,98 ",1.722536," 0,00 "," 9.822,34 "," 4.622,37 ",2805976654,CFD," 0,00 "
09/09/2024 18:25:31,Open Position,NSDQ100/USD," 1.200,00 ",1.292222," 0,00 "," 9.822,34 "," 3.422,37 ",2805976776,CFD," 0,00 "
09/09/2024 18:30:21,Position closed,NSDQ100/USD," 1.628,78 ",1.722536," 28,80 "," 9.851,14 "," 5.051,15 ",2805976654,CFD," 0,00 "
09/09/2024 18:30:21,Position closed,NSDQ100/USD," 2.124,47 ",2.261571," 24,47 "," 9.875,61 "," 7.175,62 ",2805975961,CFD," 0,00 "
09/09/2024 18:30:21,Position closed,NSDQ100/USD," 1.508,42 ",1.615895," 8,43 "," 9.884,04 "," 8.684,04 ",2805975796,CFD," 0,00 "
09/09/2024 18:30:21,Position closed,NSDQ100/USD," 1.215,92 ",1.292222," 15,92 "," 9.899,96 "," 9.899,96 ",2805976776,CFD," 0,00 "
09/09/2024 18:30:46,Open Position,NSDQ100/USD," 989,99 ",1.066789," 0,00 "," 9.899,96 "," 8.909,97 ",2805979659,CFD," 0,00 "
09/09/2024 18:31:26,Open Position,NSDQ100/USD," 2.300,00 ",2.478026," 0,00 "," 9.899,96 "," 6.609,97 ",2805980285,CFD," 0,00 "
09/09/2024 18:31:51,Open Position,NSDQ100/USD," 1.000,00 ",1.077002," 0,00 "," 9.899,96 "," 5.609,97 ",2805980761,CFD," 0,00 "
09/09/2024 18:32:36,Open Position,NSDQ100/USD," 1.499,99 ",1.615677," 0,00 "," 9.899,96 "," 4.109,98 ",2805981322,CFD," 0,00 "
09/09/2024 18:33:00,Open Position,NSDQ100/USD," 499,99 ",0.538408," 0,00 "," 9.899,96 "," 3.609,99 ",2805981581,CFD," 0,00 "
09/09/2024 18:33:09,Position closed,NSDQ100/USD," 499,40 ",0.538408,"(0,59)"," 9.899,37 "," 4.109,39 ",2805981581,CFD," 0,00 "
09/09/2024 18:33:14,Open Position,NSDQ100/USD," 1.099,99 ",1.184798," 0,00 "," 9.899,37 "," 3.009,40 ",2805981640,CFD," 0,00 "
09/09/2024 18:35:25,Open Position,NSDQ100/USD," 759,99 ",0.818063," 0,00 "," 9.899,37 "," 2.249,41 ",2805982251,CFD," 0,00 "
09/09/2024 18:36:53,Position closed,NSDQ100/USD," 769,41 ",0.818063," 9,42 "," 9.908,79 "," 3.018,82 ",2805982251,CFD," 0,00 "
09/09/2024 18:37:18,Position closed,NSDQ100/USD," 1.504,22 ",1.615677," 4,23 "," 9.913,02 "," 4.523,04 ",2805981322,CFD," 0,00 "
09/09/2024 18:37:21,Position closed,NSDQ100/USD," 1.105,58 ",1.184798," 5,59 "," 9.918,61 "," 5.628,62 ",2805981640,CFD," 0,00 "
09/09/2024 18:37:23,Position closed,NSDQ100/USD," 1.005,73 ",1.077002," 5,73 "," 9.924,34 "," 6.634,35 ",2805980761,CFD," 0,00 "
09/09/2024 18:37:29,Position closed,NSDQ100/USD," 2.306,74 ",2.478026," 6,74 "," 9.931,08 "," 8.941,09 ",2805980285,CFD," 0,00 "
09/09/2024 18:37:31,Position closed,NSDQ100/USD," 988,09 ",1.066789,"(1,90)"," 9.929,18 "," 9.929,18 ",2805979659,CFD," 0,00 "
09/09/2024 18:37:54,Open Position,NSDQ100/USD," 1.000,00 ",1.077907," 0,00 "," 9.929,18 "," 8.929,18 ",2805983336,CFD," 0,00 "
09/09/2024 18:38:31,Open Position,NSDQ100/USD," 1.000,00 ",1.077681," 0,00 "," 9.929,18 "," 7.929,18 ",2805983660,CFD," 0,00 "
09/09/2024 18:39:42,Position closed,NSDQ100/USD," 1.016,19 ",1.077681," 16,19 "," 9.945,37 "," 8.945,37 ",2805983660,CFD," 0,00 "
09/09/2024 18:39:42,Position closed,NSDQ100/USD," 1.011,99 ",1.077907," 11,99 "," 9.957,36 "," 9.957,36 ",2805983336,CFD," 0,00 "
09/09/2024 18:39:56,Open Position,NSDQ100/USD," 1.000,00 ",1.078512," 0,00 "," 9.957,36 "," 8.957,36 ",2805984596,CFD," 0,00 "
09/09/2024 18:40:13,Open Position,NSDQ100/USD," 2.300,00 ",2.480391," 0,00 "," 9.957,36 "," 6.657,36 ",2805985385,CFD," 0,00 "
09/09/2024 18:41:47,Open Position,NSDQ100/USD," 1.000,00 ",1.077907," 0,00 "," 9.957,36 "," 5.657,36 ",2805986079,CFD," 0,00 "
09/09/2024 18:44:18,Open Position,NSDQ100/USD," 1.499,99 ",1.615503," 0,00 "," 9.957,36 "," 4.157,37 ",2805987130,CFD," 0,00 "
09/09/2024 18:46:43,Open Position,NSDQ100/USD," 1.099,99 ",1.184205," 0,00 "," 9.957,36 "," 3.057,38 ",2805991691,CFD," 0,00 "
09/09/2024 18:48:28,Open Position,NSDQ100/USD," 769,99 ",0.828952," 0,00 "," 9.957,36 "," 2.287,39 ",2805992204,CFD," 0,00 "
09/09/2024 19:51:02,Open Position,NSDQ100/USD," 899,99 ",0.966352," 0,00 "," 9.957,36 "," 1.387,40 ",2806018335,CFD," 0,00 "
09/09/2024 20:07:44,Open Position,NSDQ100/USD," 1.000,00 ",1.071880," 0,00 "," 9.957,36 "," 387,40 ",2806025463,CFD," 0,00 "
10/09/2024 00:48:41,Overnight refund,Daily," 0,12 ",-," 0,12 "," 9.957,48 "," 387,52 ",2805986079,CFD," 0,00 "
10/09/2024 00:48:41,Overnight refund,Daily," 0,10 ",-," 0,10 "," 9.957,58 "," 387,62 ",2806018335,CFD," 0,00 "
10/09/2024 00:48:41,Overnight refund,Daily," 0,11 ",-," 0,11 "," 9.957,69 "," 387,73 ",2806025463,CFD," 0,00 "
10/09/2024 00:48:41,Overnight refund,Daily," 0,17 ",-," 0,17 "," 9.957,86 "," 387,90 ",2805987130,CFD," 0,00 "
10/09/2024 00:48:41,Overnight refund,Daily," 0,09 ",-," 0,09 "," 9.957,95 "," 387,99 ",2805992204,CFD," 0,00 "
10/09/2024 00:48:41,Overnight refund,Daily," 0,12 ",-," 0,12 "," 9.958,07 "," 388,11 ",2805984596,CFD," 0,00 "
10/09/2024 00:48:41,Overnight refund,Daily," 0,26 ",-," 0,26 "," 9.958,33 "," 388,37 ",2805985385,CFD," 0,00 "
10/09/2024 00:48:41,Overnight refund,Daily," 0,13 ",-," 0,13 "," 9.958,46 "," 388,50 ",2805991691,CFD," 0,00 "
10/09/2024 01:27:20,Dividend,NSDQ100/USD,"(0,18)",-,"(0,18)"," 9.958,28 "," 388,32 ",2805984596,CFD," 0,00 "
10/09/2024 01:27:20,Dividend,NSDQ100/USD,"(0,40)",-,"(0,40)"," 9.957,88 "," 387,92 ",2805985385,CFD," 0,00 "
10/09/2024 01:27:20,Dividend,NSDQ100/USD,"(0,18)",-,"(0,18)"," 9.957,70 "," 387,74 ",2805986079,CFD," 0,00 "
10/09/2024 01:27:20,Dividend,NSDQ100/USD,"(0,26)",-,"(0,26)"," 9.957,44 "," 387,48 ",2805987130,CFD," 0,00 "
10/09/2024 01:27:20,Dividend,NSDQ100/USD,"(0,19)",-,"(0,19)"," 9.957,25 "," 387,29 ",2805991691,CFD," 0,00 "
10/09/2024 01:27:20,Dividend,NSDQ100/USD,"(0,14)",-,"(0,14)"," 9.957,11 "," 387,15 ",2805992204,CFD," 0,00 "
10/09/2024 01:27:20,Dividend,NSDQ100/USD,"(0,16)",-,"(0,16)"," 9.956,95 "," 386,99 ",2806018335,CFD," 0,00 "
10/09/2024 04:37:52,Position closed,NSDQ100/USD," 1.070,42 ",1.071880," 70,42 "," 10.027,37 "," 1.457,41 ",2806025463,CFD," 0,00 "
10/09/2024 04:38:42,Position closed,NSDQ100/USD," 937,44 ",0.966352," 37,45 "," 10.064,82 "," 2.394,85 ",2806018335,CFD," 0,00 "
10/09/2024 04:41:58,Position closed,NSDQ100/USD," 2.174,39 ",2.480391,"(125,61)"," 9.939,21 "," 4.569,24 ",2805985385,CFD," 0,00 "
10/09/2024 04:45:03,Open Position,NSDQ100/USD," 1.199,99 ",1.290627," 0,00 "," 9.939,21 "," 3.369,25 ",2806050645,CFD," 0,00 "
10/09/2024 04:46:04,Position closed,NSDQ100/USD," 953,18 ",1.077907,"(46,82)"," 9.892,39 "," 4.322,43 ",2805986079,CFD," 0,00 "
10/09/2024 04:46:11,Position closed,NSDQ100/USD," 941,93 ",1.078512,"(58,07)"," 9.834,32 "," 5.264,36 ",2805984596,CFD," 0,00 "
10/09/2024 04:46:37,Position closed,NSDQ100/USD," 1.455,18 ",1.615503,"(44,81)"," 9.789,51 "," 6.719,54 ",2805987130,CFD," 0,00 "
10/09/2024 04:46:44,Position closed,NSDQ100/USD," 1.076,38 ",1.184205,"(23,61)"," 9.765,90 "," 7.795,92 ",2805991691,CFD," 0,00 "
10/09/2024 04:46:52,Position closed,NSDQ100/USD," 753,71 ",0.828952,"(16,28)"," 9.749,62 "," 8.549,63 ",2805992204,CFD," 0,00 "
10/09/2024 04:47:37,Open Position,NSDQ100/USD," 999,99 ",1.075361," 0,00 "," 9.749,62 "," 7.549,64 ",2806050726,CFD," 0,00 "
10/09/2024 04:54:09,Position closed,NSDQ100/USD," 999,57 ",1.075361,"(0,42)"," 9.749,20 "," 8.549,21 ",2806050726,CFD," 0,00 "
10/09/2024 04:54:09,Position closed,NSDQ100/USD," 1.202,84 ",1.290627," 2,85 "," 9.752,05 "," 9.752,05 ",2806050645,CFD," 0,00 "
10/09/2024 04:58:00,Open Position,NSDQ100/USD," 500,00 ",0.537903," 0,00 "," 9.752,05 "," 9.252,05 ",2806051539,CFD," 0,00 "
10/09/2024 07:02:20,Open Position,NSDQ100/USD," 499,99 ",0.537709," 0,00 "," 9.752,05 "," 8.752,06 ",2806073878,CFD," 0,00 "
10/09/2024 07:03:49,Open Position,NSDQ100/USD," 499,98 ",0.537865," 0,00 "," 9.752,05 "," 8.252,08 ",2806074202,CFD," 0,00 "
10/09/2024 07:04:18,Position closed,NSDQ100/USD," 500,44 ",0.537903," 0,44 "," 9.752,49 "," 8.752,52 ",2806051539,CFD," 0,00 "
10/09/2024 07:05:57,Position closed,NSDQ100/USD," 501,87 ",0.537865," 1,89 "," 9.754,38 "," 9.254,39 ",2806074202,CFD," 0,00 "
10/09/2024 07:07:09,Open Position,NSDQ100/USD," 999,99 ",1.075424," 0,00 "," 9.754,38 "," 8.254,40 ",2806075763,CFD," 0,00 "
10/09/2024 07:08:38,Position closed,NSDQ100/USD," 1.001,50 ",1.075424," 1,51 "," 9.755,89 "," 9.255,90 ",2806075763,CFD," 0,00 "
10/09/2024 07:08:45,Position closed,NSDQ100/USD," 501,39 ",0.537709," 1,40 "," 9.757,29 "," 9.757,29 ",2806073878,CFD," 0,00 "
10/09/2024 07:09:20,Open Position,NSDQ100/USD," 499,99 ",0.537276," 0,00 "," 9.757,29 "," 9.257,30 ",2806076050,CFD," 0,00 "
10/09/2024 07:09:45,Position closed,NSDQ100/USD," 503,17 ",0.537276," 3,18 "," 9.760,47 "," 9.760,47 ",2806076050,CFD," 0,00 "
10/09/2024 07:10:12,Open Position,NSDQ100/USD," 979,98 ",1.052683," 0,00 "," 9.760,47 "," 8.780,49 ",2806076217,CFD," 0,00 "
10/09/2024 07:10:47,Open Position,NSDQ100/USD," 499,99 ",0.537218," 0,00 "," 9.760,47 "," 8.280,50 ",2806076309,CFD," 0,00 "
10/09/2024 07:13:17,Position closed,NSDQ100/USD," 503,00 ",0.537218," 3,01 "," 9.763,48 "," 8.783,50 ",2806076309,CFD," 0,00 "
10/09/2024 07:13:21,Position closed,NSDQ100/USD," 980,62 ",1.052683," 0,64 "," 9.764,12 "," 9.764,12 ",2806076217,CFD," 0,00 "
10/09/2024 07:15:22,Open Position,NSDQ100/USD," 979,99 ",1.052801," 0,00 "," 9.764,12 "," 8.784,13 ",2806077003,CFD," 0,00 "
10/09/2024 07:16:24,Position closed,NSDQ100/USD," 984,21 ",1.052801," 4,22 "," 9.768,34 "," 9.768,34 ",2806077003,CFD," 0,00 "
10/09/2024 07:17:14,Open Position,NSDQ100/USD," 979,99 ",1.052129," 0,00 "," 9.768,34 "," 8.788,35 ",2806077241,CFD," 0,00 "
10/09/2024 07:18:59,Open Position,NSDQ100/USD," 999,99 ",1.073941," 0,00 "," 9.768,34 "," 7.788,36 ",2806077599,CFD," 0,00 "
10/09/2024 07:20:18,Position closed,NSDQ100/USD," 1.003,97 ",1.073941," 3,98 "," 9.772,32 "," 8.792,33 ",2806077599,CFD," 0,00 "
10/09/2024 07:21:24,Open Position,NSDQ100/USD," 499,99 ",0.536766," 0,00 "," 9.772,32 "," 8.292,34 ",2806088002,CFD," 0,00 "
10/09/2024 07:22:05,Position closed,NSDQ100/USD," 985,68 ",1.052129," 5,69 "," 9.778,01 "," 9.278,02 ",2806077241,CFD," 0,00 "
10/09/2024 07:22:11,Position closed,NSDQ100/USD," 502,20 ",0.536766," 2,21 "," 9.780,22 "," 9.780,22 ",2806088002,CFD," 0,00 "
10/09/2024 07:23:21,Open Position,NSDQ100/USD," 499,99 ",0.536463," 0,00 "," 9.780,22 "," 9.280,23 ",2806088547,CFD," 0,00 "
10/09/2024 07:24:14,Open Position,NSDQ100/USD," 2.399,99 ",2.576268," 0,00 "," 9.780,22 "," 6.880,24 ",2806088722,CFD," 0,00 "
10/09/2024 07:25:01,Position closed,NSDQ100/USD," 2.397,44 ",2.576268,"(2,55)"," 9.777,67 "," 9.277,68 ",2806088722,CFD," 0,00 "
10/09/2024 07:25:22,Open Position,NSDQ100/USD," 999,99 ",1.073203," 0,00 "," 9.777,67 "," 8.277,69 ",2806089479,CFD," 0,00 "
10/09/2024 07:27:23,Open Position,NSDQ100/USD," 999,99 ",1.073462," 0,00 "," 9.777,67 "," 7.277,70 ",2806089761,CFD," 0,00 "
10/09/2024 07:29:12,Open Position,NSDQ100/USD," 1.900,00 ",2.040368," 0,00 "," 9.777,67 "," 5.377,70 ",2806089992,CFD," 0,00 "
10/09/2024 07:30:10,Position closed,NSDQ100/USD," 1.912,47 ",2.040368," 12,47 "," 9.790,14 "," 7.290,17 ",2806089992,CFD," 0,00 "
10/09/2024 07:30:40,Position closed,NSDQ100/USD," 1.003,22 ",1.073462," 3,23 "," 9.793,37 "," 8.293,39 ",2806089761,CFD," 0,00 "
10/09/2024 07:30:52,Position closed,NSDQ100/USD," 999,24 ",1.073203,"(0,75)"," 9.792,62 "," 9.292,63 ",2806089479,CFD," 0,00 "
10/09/2024 07:33:03,Open Position,NSDQ100/USD," 999,99 ",1.073480," 0,00 "," 9.792,62 "," 8.292,64 ",2806090707,CFD," 0,00 "
10/09/2024 07:37:06,Open Position,NSDQ100/USD," 1.499,99 ",1.610540," 0,00 "," 9.792,62 "," 6.792,65 ",2806091529,CFD," 0,00 "
10/09/2024 07:41:02,Position closed,NSDQ100/USD," 1.008,80 ",1.073480," 8,81 "," 9.801,43 "," 7.801,45 ",2806090707,CFD," 0,00 "
10/09/2024 07:41:06,Position closed,NSDQ100/USD," 1.519,65 ",1.610540," 19,66 "," 9.821,09 "," 9.321,10 ",2806091529,CFD," 0,00 "
10/09/2024 07:41:11,Position closed,NSDQ100/USD," 499,45 ",0.536463,"(0,54)"," 9.820,55 "," 9.820,55 ",2806088547,CFD," 0,00 "
10/09/2024 07:44:11,Open Position,NSDQ100/USD," 499,99 ",0.536250," 0,00 "," 9.820,55 "," 9.320,56 ",2806093412,CFD," 0,00 "
10/09/2024 07:47:19,Open Position,NSDQ100/USD," 499,99 ",0.536333," 0,00 "," 9.820,55 "," 8.820,57 ",2806094104,CFD," 0,00 "
10/09/2024 07:47:41,Position closed,NSDQ100/USD," 500,90 ",0.536333," 0,91 "," 9.821,46 "," 9.321,47 ",2806094104,CFD," 0,00 "
10/09/2024 07:47:51,Position closed,NSDQ100/USD," 499,35 ",0.536250,"(0,64)"," 9.820,82 "," 9.820,82 ",2806093412,CFD," 0,00 "
10/09/2024 07:49:23,Open Position,NSDQ100/USD," 499,99 ",0.536411," 0,00 "," 9.820,82 "," 9.320,83 ",2806094644,CFD," 0,00 "
10/09/2024 07:49:55,Open Position,NSDQ100/USD," 999,99 ",1.072961," 0,00 "," 9.820,82 "," 8.320,84 ",2806094731,CFD," 0,00 "
10/09/2024 07:53:11,Open Position,NSDQ100/USD," 999,99 ",1.073088," 0,00 "," 9.820,82 "," 7.320,85 ",2806098715,CFD," 0,00 "
10/09/2024 07:54:03,Position closed,NSDQ100/USD," 1.002,67 ",1.073088," 2,68 "," 9.823,50 "," 8.323,52 ",2806098715,CFD," 0,00 "
10/09/2024 07:54:10,Position closed,NSDQ100/USD," 1.001,71 ",1.072961," 1,72 "," 9.825,22 "," 9.325,23 ",2806094731,CFD," 0,00 "
10/09/2024 07:54:14,Position closed,NSDQ100/USD," 499,94 ",0.536411,"(0,05)"," 9.825,17 "," 9.825,17 ",2806094644,CFD," 0,00 "
10/09/2024 07:56:02,Open Position,NSDQ100/USD," 499,99 ",0.536239," 0,00 "," 9.825,17 "," 9.325,18 ",2806102511,CFD," 0,00 "
10/09/2024 08:00:04,Position closed,NSDQ100/USD," 502,03 ",0.536239," 2,04 "," 9.827,21 "," 9.827,21 ",2806102511,CFD," 0,00 "
10/09/2024 08:00:48,Open Position,NSDQ100/USD," 989,98 ",1.060997," 0,00 "," 9.827,21 "," 8.837,23 ",2806103467,CFD," 0,00 "
10/09/2024 08:01:35,Open Position,NSDQ100/USD," 500,00 ",0.536017," 0,00 "," 9.827,21 "," 8.337,23 ",2806103640,CFD," 0,00 "
10/09/2024 08:02:17,Position closed,NSDQ100/USD," 501,77 ",0.536017," 1,77 "," 9.828,98 "," 8.839,00 ",2806103640,CFD," 0,00 "
10/09/2024 08:02:34,Open Position,NSDQ100/USD," 1.000,00 ",1.072409," 0,00 "," 9.828,98 "," 7.839,00 ",2806104763,CFD," 0,00 "
10/09/2024 08:08:27,Open Position,NSDQ100/USD," 1.000,00 ",1.072374," 0,00 "," 9.828,98 "," 6.839,00 ",2806106552,CFD," 0,00 "
10/09/2024 08:11:53,Position closed,NSDQ100/USD," 1.002,90 ",1.072374," 2,90 "," 9.831,88 "," 7.841,90 ",2806106552,CFD," 0,00 "
10/09/2024 08:11:57,Position closed,NSDQ100/USD," 1.001,82 ",1.072409," 1,82 "," 9.833,70 "," 8.843,72 ",2806104763,CFD," 0,00 "
10/09/2024 08:12:11,Open Position,NSDQ100/USD," 2.300,00 ",2.467453," 0,00 "," 9.833,70 "," 6.543,72 ",2806107259,CFD," 0,00 "
10/09/2024 08:38:58,Position closed,NSDQ100/USD," 2.357,27 ",2.467453," 57,27 "," 9.890,97 "," 8.900,99 ",2806107259,CFD," 0,00 "
10/09/2024 08:39:20,Open Position,NSDQ100/USD," 999,99 ",1.074085," 0,00 "," 9.890,97 "," 7.901,00 ",2806112351,CFD," 0,00 "
10/09/2024 08:44:31,Open Position,NSDQ100/USD," 2.000,00 ",2.148009," 0,00 "," 9.890,97 "," 5.901,00 ",2806113135,CFD," 0,00 "
10/09/2024 08:46:54,Open Position,NSDQ100/USD," 1.499,99 ",1.610920," 0,00 "," 9.890,97 "," 4.401,01 ",2806113484,CFD," 0,00 "
10/09/2024 08:48:32,Open Position,NSDQ100/USD," 1.200,00 ",1.288944," 0,00 "," 9.890,97 "," 3.201,01 ",2806113871,CFD," 0,00 "
10/09/2024 08:50:51,Open Position,NSDQ100/USD," 499,99 ",0.536988," 0,00 "," 9.890,97 "," 2.701,02 ",2806114342,CFD," 0,00 "
10/09/2024 09:32:41,Open Position,NSDQ100/USD," 999,99 ",1.076177," 0,00 "," 9.890,97 "," 1.701,03 ",2806121593,CFD," 0,00 "
10/09/2024 09:38:49,Open Position,NSDQ100/USD," 499,99 ",0.537582," 0,00 "," 9.890,97 "," 1.201,04 ",2806122713,CFD," 0,00 "
10/09/2024 10:30:59,Position closed,NSDQ100/USD," 1.505,32 ",1.610920," 5,33 "," 9.896,30 "," 2.706,36 ",2806113484,CFD," 0,00 "
10/09/2024 10:30:59,Position closed,NSDQ100/USD," 2.009,26 ",2.148009," 9,26 "," 9.905,56 "," 4.715,62 ",2806113135,CFD," 0,00 "
10/09/2024 10:30:59,Position closed,NSDQ100/USD," 952,53 ",1.060997,"(37,45)"," 9.868,11 "," 5.668,15 ",2806103467,CFD," 0,00 "
10/09/2024 10:30:59,Position closed,NSDQ100/USD," 1.006,12 ",1.074085," 6,13 "," 9.874,24 "," 6.674,27 ",2806112351,CFD," 0,00 "
10/09/2024 10:30:59,Position closed,NSDQ100/USD," 513,11 ",0.537582," 13,12 "," 9.887,36 "," 7.187,38 ",2806122713,CFD," 0,00 "
10/09/2024 10:30:59,Position closed,NSDQ100/USD," 1.208,13 ",1.288944," 8,13 "," 9.895,49 "," 8.395,51 ",2806113871,CFD," 0,00 "
10/09/2024 10:30:59,Position closed,NSDQ100/USD," 1.045,08 ",1.076177," 45,09 "," 9.940,58 "," 9.440,59 ",2806121593,CFD," 0,00 "
10/09/2024 10:30:59,Position closed,NSDQ100/USD," 502,04 ",0.536988," 2,05 "," 9.942,63 "," 9.942,63 ",2806114342,CFD," 0,00 "
10/09/2024 10:31:46,Open Position,NSDQ100/USD," 999,99 ",1.073826," 0,00 "," 9.942,63 "," 8.942,64 ",2806133643,CFD," 0,00 "
10/09/2024 10:32:20,Open Position,NSDQ100/USD," 1.499,99 ",1.610514," 0,00 "," 9.942,63 "," 7.442,65 ",2806133693,CFD," 0,00 "
10/09/2024 10:33:09,Open Position,NSDQ100/USD," 499,99 ",0.536598," 0,00 "," 9.942,63 "," 6.942,66 ",2806133823,CFD," 0,00 "
10/09/2024 10:33:30,Open Position,NSDQ100/USD," 999,99 ",1.073070," 0,00 "," 9.942,63 "," 5.942,67 ",2806133881,CFD," 0,00 "
10/09/2024 10:34:21,Position closed,NSDQ100/USD," 1.517,88 ",1.610514," 17,89 "," 9.960,52 "," 7.460,55 ",2806133693,CFD," 0,00 "
10/09/2024 10:34:21,Position closed,NSDQ100/USD," 1.014,71 ",1.073826," 14,72 "," 9.975,24 "," 8.475,26 ",2806133643,CFD," 0,00 "
10/09/2024 10:34:21,Position closed,NSDQ100/USD," 501,49 ",0.536598," 1,50 "," 9.976,74 "," 8.976,75 ",2806133823,CFD," 0,00 "
10/09/2024 10:34:21,Position closed,NSDQ100/USD," 1.000,63 ",1.073070," 0,64 "," 9.977,38 "," 9.977,38 ",2806133881,CFD," 0,00 "
10/09/2024 10:35:07,Open Position,NSDQ100/USD," 499,99 ",0.536207," 0,00 "," 9.977,38 "," 9.477,39 ",2806134190,CFD," 0,00 "
10/09/2024 10:35:18,Position closed,NSDQ100/USD," 497,58 ",0.536207,"(2,41)"," 9.974,97 "," 9.974,97 ",2806134190,CFD," 0,00 "
10/09/2024 10:36:33,Open Position,NSDQ100/USD," 999,99 ",1.072811," 0,00 "," 9.974,97 "," 8.974,98 ",2806134650,CFD," 0,00 "
10/09/2024 10:37:59,Open Position,NSDQ100/USD," 999,99 ",1.072932," 0,00 "," 9.974,97 "," 7.974,99 ",2806134918,CFD," 0,00 "
10/09/2024 10:53:46,Open Position,NSDQ100/USD," 499,98 ",0.536778," 0,00 "," 9.974,97 "," 7.475,01 ",2806137741,CFD," 0,00 "
10/09/2024 10:53:58,Open Position,NSDQ100/USD," 199,99 ",0.214730," 0,00 "," 9.974,97 "," 7.275,02 ",2806137823,CFD," 0,00 "
10/09/2024 10:56:08,Open Position,GER30/EUR," 499,99 ",0.492653," 0,00 "," 9.974,97 "," 6.775,03 ",2806138117,CFD," 0,00 "
10/09/2024 10:57:31,Open Position,GER30/EUR," 200,00 ",0.197156," 0,00 "," 9.974,97 "," 6.575,03 ",2806138567,CFD," 0,00 "
10/09/2024 10:59:09,Open Position,GER30/EUR," 299,99 ",0.295428," 0,00 "," 9.974,97 "," 6.275,04 ",2806138959,CFD," 0,00 "
10/09/2024 11:00:24,Open Position,GER30/EUR," 200,00 ",0.196895," 0,00 "," 9.974,97 "," 6.075,04 ",2806139380,CFD," 0,00 "
10/09/2024 11:02:28,Position closed,GER30/EUR," 205,93 ",0.197156," 5,93 "," 9.980,90 "," 6.280,97 ",2806138567,CFD," 0,00 "
10/09/2024 11:02:28,Position closed,GER30/EUR," 201,36 ",0.196895," 1,36 "," 9.982,26 "," 6.482,33 ",2806139380,CFD," 0,00 "
10/09/2024 11:02:28,Position closed,GER30/EUR," 509,92 ",0.492653," 9,93 "," 9.992,19 "," 6.992,25 ",2806138117,CFD," 0,00 "
10/09/2024 11:02:28,Position closed,GER30/EUR," 303,17 ",0.295428," 3,18 "," 9.995,37 "," 7.295,42 ",2806138959,CFD," 0,00 "
10/09/2024 11:03:16,Open Position,GER30/EUR," 999,97 ",0.984414," 0,00 "," 9.995,37 "," 6.295,45 ",2806139953,CFD," 0,00 "
10/09/2024 11:04:02,Position closed,NSDQ100/USD," 202,89 ",0.214730," 2,90 "," 9.998,27 "," 6.498,34 ",2806137823,CFD," 0,00 "
10/09/2024 11:04:02,Position closed,NSDQ100/USD," 1.001,06 ",1.072932," 1,07 "," 9.999,34 "," 7.499,40 ",2806134918,CFD," 0,00 "
10/09/2024 11:04:02,Position closed,NSDQ100/USD," 506,53 ",0.536778," 6,55 "," 10.005,89 "," 8.005,93 ",2806137741,CFD," 0,00 "
10/09/2024 11:04:02,Position closed,NSDQ100/USD," 998,81 ",1.072811,"(1,18)"," 10.004,71 "," 9.004,74 ",2806134650,CFD," 0,00 "
10/09/2024 11:04:38,Open Position,GER30/EUR," 999,99 ",0.984352," 0,00 "," 10.004,71 "," 8.004,75 ",2806140088,CFD," 0,00 "
10/09/2024 11:05:07,Open Position,GER30/EUR," 299,99 ",0.295265," 0,00 "," 10.004,71 "," 7.704,76 ",2806140183,CFD," 0,00 "
10/09/2024 11:07:09,Open Position,SPX500/USD," 1.100,00 ",4.020945," 0,00 "," 10.004,71 "," 6.604,76 ",2806140543,CFD," 0,00 "
10/09/2024 11:13:13,Open Position,GER30/EUR," 1.500,00 ",1.478939," 0,00 "," 10.004,71 "," 5.104,76 ",2806141462,CFD," 0,00 "
10/09/2024 11:14:11,Open Position,NSDQ100/USD," 499,99 ",0.536526," 0,00 "," 10.004,71 "," 4.604,77 ",2806141624,CFD," 0,00 "
10/09/2024 11:18:32,Open Position,GER30/EUR," 600,00 ",0.592043," 0,00 "," 10.004,71 "," 4.004,77 ",2806143228,CFD," 0,00 "
10/09/2024 11:23:23,Open Position,GER30/EUR," 499,99 ",0.493606," 0,00 "," 10.004,71 "," 3.504,78 ",2806144236,CFD," 0,00 "
10/09/2024 11:25:30,Open Position,GER30/EUR," 499,99 ",0.493373," 0,00 "," 10.004,71 "," 3.004,79 ",2806144765,CFD," 0,00 "
10/09/2024 11:26:41,Position closed,SPX500/USD," 1.102,73 ",4.020945," 2,73 "," 10.007,44 "," 4.107,52 ",2806140543,CFD," 0,00 "
10/09/2024 11:28:21,Open Position,GER30/EUR," 499,98 ",0.493010," 0,00 "," 10.007,44 "," 3.607,54 ",2806145226,CFD," 0,00 "
10/09/2024 11:28:59,Position closed,NSDQ100/USD," 504,60 ",0.536526," 4,61 "," 10.012,05 "," 4.112,14 ",2806141624,CFD," 0,00 "
10/09/2024 11:32:00,Open Position,NSDQ100/USD," 499,99 ",0.536308," 0,00 "," 10.012,05 "," 3.612,15 ",2806145907,CFD," 0,00 "
10/09/2024 11:33:06,Open Position,NSDQ100/USD," 1.499,99 ",1.608630," 0,00 "," 10.012,05 "," 2.112,16 ",2806146091,CFD," 0,00 "
10/09/2024 11:36:43,Open Position,GER30/EUR," 499,99 ",0.493619," 0,00 "," 10.012,05 "," 1.612,17 ",2806146766,CFD," 0,00 "
10/09/2024 11:40:23,Open Position,GER30/EUR," 999,99 ",0.988315," 0,00 "," 10.012,05 "," 612,18 ",2806147478,CFD," 0,00 "
10/09/2024 11:58:10,Position closed,NSDQ100/USD," 1.537,95 ",1.608630," 37,96 "," 10.050,01 "," 2.150,13 ",2806146091,CFD," 0,00 "
10/09/2024 11:58:10,Position closed,NSDQ100/USD," 514,47 ",0.536308," 14,48 "," 10.064,49 "," 2.664,60 ",2806145907,CFD," 0,00 "
10/09/2024 12:03:24,Open Position,GER30/EUR," 499,99 ",0.493879," 0,00 "," 10.064,49 "," 2.164,61 ",2806151812,CFD," 0,00 "
10/09/2024 12:05:32,Open Position,GER30/EUR," 550,00 ",0.543326," 0,00 "," 10.064,49 "," 1.614,61 ",2806152140,CFD," 0,00 "
10/09/2024 12:06:36,Open Position,NSDQ100/USD," 499,99 ",0.535432," 0,00 "," 10.064,49 "," 1.114,62 ",2806152343,CFD," 0,00 "
10/09/2024 12:14:47,Position closed,NSDQ100/USD," 512,30 ",0.535432," 12,31 "," 10.076,80 "," 1.626,92 ",2806152343,CFD," 0,00 "
10/09/2024 12:15:41,Open Position,NSDQ100/USD," 999,99 ",1.069026," 0,00 "," 10.076,80 "," 626,93 ",2806154207,CFD," 0,00 "
10/09/2024 12:15:53,Open Position,NSDQ100/USD," 499,99 ",0.534544," 0,00 "," 10.076,80 "," 126,94 ",2806154236,CFD," 0,00 "
10/09/2024 12:19:47,Position closed,NSDQ100/USD," 502,92 ",0.534544," 2,93 "," 10.079,73 "," 629,86 ",2806154236,CFD," 0,00 "
10/09/2024 12:19:47,Position closed,NSDQ100/USD," 1.004,68 ",1.069026," 4,69 "," 10.084,42 "," 1.634,54 ",2806154207,CFD," 0,00 "
10/09/2024 12:20:12,Position closed,GER30/EUR," 497,66 ",0.493010,"(2,32)"," 10.082,10 "," 2.132,20 ",2806145226,CFD," 0,00 "
10/09/2024 12:22:51,Position closed,GER30/EUR," 1.498,76 ",1.478939,"(1,24)"," 10.080,86 "," 3.630,96 ",2806141462,CFD," 0,00 "
10/09/2024 12:24:24,Position closed,GER30/EUR," 976,34 ",0.984414,"(23,63)"," 10.057,23 "," 4.607,30 ",2806139953,CFD," 0,00 "
10/09/2024 12:24:24,Position closed,GER30/EUR," 976,36 ",0.984352,"(23,63)"," 10.033,60 "," 5.583,66 ",2806140088,CFD," 0,00 "
10/09/2024 12:24:24,Position closed,GER30/EUR," 609,31 ",0.592043," 9,31 "," 10.042,91 "," 6.192,97 ",2806143228,CFD," 0,00 "
10/09/2024 12:24:24,Position closed,GER30/EUR," 292,24 ",0.295265,"(7,75)"," 10.035,16 "," 6.485,21 ",2806140183,CFD," 0,00 "
10/09/2024 12:24:24,Position closed,GER30/EUR," 511,84 ",0.493606," 11,85 "," 10.047,01 "," 6.997,05 ",2806144236,CFD," 0,00 "
10/09/2024 12:24:24,Position closed,GER30/EUR," 506,93 ",0.493373," 6,94 "," 10.053,95 "," 7.503,98 ",2806144765,CFD," 0,00 "
10/09/2024 12:24:24,Position closed,GER30/EUR," 511,29 ",0.493619," 11,30 "," 10.065,25 "," 8.015,27 ",2806146766,CFD," 0,00 "
10/09/2024 12:24:24,Position closed,GER30/EUR," 1.040,06 ",0.988315," 40,07 "," 10.105,32 "," 9.055,33 ",2806147478,CFD," 0,00 "
10/09/2024 12:24:24,Position closed,GER30/EUR," 511,56 ",0.493879," 11,57 "," 10.116,89 "," 9.566,89 ",2806151812,CFD," 0,00 "
10/09/2024 12:24:24,Position closed,GER30/EUR," 566,64 ",0.543326," 16,64 "," 10.133,53 "," 10.133,53 ",2806152140,CFD," 0,00 "
10/09/2024 12:25:10,Open Position,GER30/EUR," 499,99 ",0.493144," 0,00 "," 10.133,53 "," 9.633,54 ",2806156067,CFD," 0,00 "
10/09/2024 12:27:53,Open Position,GER30/EUR," 499,99 ",0.493449," 0,00 "," 10.133,53 "," 9.133,55 ",2806156516,CFD," 0,00 "
10/09/2024 12:28:55,Open Position,NSDQ100/USD," 1.499,99 ",1.602451," 0,00 "," 10.133,53 "," 7.633,56 ",2806156634,CFD," 0,00 "
10/09/2024 12:29:28,Open Position,GER30/EUR," 999,99 ",0.987630," 0,00 "," 10.133,53 "," 6.633,57 ",2806156756,CFD," 0,00 "
10/09/2024 12:29:57,Open Position,NSDQ100/USD," 999,99 ",1.068267," 0,00 "," 10.133,53 "," 5.633,58 ",2806156944,CFD," 0,00 "
10/09/2024 12:31:25,Open Position,GER30/EUR," 499,99 ",0.493649," 0,00 "," 10.133,53 "," 5.133,59 ",2806157220,CFD," 0,00 "
10/09/2024 12:31:53,Open Position,GER30/EUR," 600,00 ",0.592497," 0,00 "," 10.133,53 "," 4.533,59 ",2806157713,CFD," 0,00 "
10/09/2024 12:32:57,Open Position,GER30/EUR," 1.199,99 ",1.184758," 0,00 "," 10.133,53 "," 3.333,60 ",2806158156,CFD," 0,00 "
10/09/2024 12:40:42,Open Position,GER30/EUR," 999,99 ",0.988204," 0,00 "," 10.133,53 "," 2.333,61 ",2806160453,CFD," 0,00 "
10/09/2024 12:40:56,Open Position,GER30/EUR," 600,00 ",0.592911," 0,00 "," 10.133,53 "," 1.733,61 ",2806160521,CFD," 0,00 "
10/09/2024 12:45:25,Position closed,NSDQ100/USD," 1.518,39 ",1.602451," 18,40 "," 10.151,93 "," 3.252,00 ",2806156634,CFD," 0,00 "
10/09/2024 12:45:25,Position closed,NSDQ100/USD," 1.011,61 ",1.068267," 11,62 "," 10.163,55 "," 4.263,61 ",2806156944,CFD," 0,00 "
10/09/2024 12:46:31,Position closed,GER30/EUR," 501,21 ",0.493649," 1,22 "," 10.164,77 "," 4.764,82 ",2806157220,CFD," 0,00 "
10/09/2024 12:46:31,Position closed,GER30/EUR," 1.007,89 ",0.987630," 7,90 "," 10.172,67 "," 5.772,71 ",2806156756,CFD," 0,00 "
10/09/2024 12:46:31,Position closed,GER30/EUR," 495,80 ",0.493144,"(4,19)"," 10.168,48 "," 6.268,51 ",2806156067,CFD," 0,00 "
10/09/2024 12:46:31,Position closed,GER30/EUR," 498,25 ",0.493449,"(1,74)"," 10.166,74 "," 6.766,76 ",2806156516,CFD," 0,00 "
10/09/2024 12:46:31,Position closed,GER30/EUR," 602,45 ",0.592497," 2,45 "," 10.169,19 "," 7.369,21 ",2806157713,CFD," 0,00 "
10/09/2024 12:46:31,Position closed,GER30/EUR," 1.023,69 ",0.988204," 23,70 "," 10.192,89 "," 8.392,90 ",2806160453,CFD," 0,00 "
10/09/2024 12:46:31,Position closed,GER30/EUR," 1.204,24 ",1.184758," 4,25 "," 10.197,14 "," 9.597,14 ",2806158156,CFD," 0,00 "
10/09/2024 12:46:31,Position closed,GER30/EUR," 613,56 ",0.592911," 13,56 "," 10.210,70 "," 10.210,70 ",2806160521,CFD," 0,00 "
10/09/2024 12:47:45,Open Position,NSDQ100/USD," 1.100,00 ",1.174028," 0,00 "," 10.210,70 "," 9.110,70 ",2806162438,CFD," 0,00 "
10/09/2024 12:48:58,Open Position,GER30/EUR," 499,98 ",0.493572," 0,00 "," 10.210,70 "," 8.610,72 ",2806162752,CFD," 0,00 "
10/09/2024 12:49:12,Open Position,GER30/EUR," 499,99 ",0.493635," 0,00 "," 10.210,70 "," 8.110,73 ",2806162786,CFD," 0,00 "
10/09/2024 12:49:39,Open Position,GER30/EUR," 299,99 ",0.296197," 0,00 "," 10.210,70 "," 7.810,74 ",2806162913,CFD," 0,00 "
10/09/2024 12:50:04,Open Position,GER30/EUR," 498,99 ",0.492737," 0,00 "," 10.210,70 "," 7.311,75 ",2806162979,CFD," 0,00 "
10/09/2024 12:51:29,Open Position,GER30/EUR," 999,99 ",0.987594," 0,00 "," 10.210,70 "," 6.311,76 ",2806163315,CFD," 0,00 "
10/09/2024 12:51:48,Open Position,GER30/EUR," 499,99 ",0.493797," 0,00 "," 10.210,70 "," 5.811,77 ",2806163375,CFD," 0,00 "
10/09/2024 12:52:30,Open Position,GER30/EUR," 499,99 ",0.493788," 0,00 "," 10.210,70 "," 5.311,78 ",2806163702,CFD," 0,00 "
10/09/2024 12:54:23,Open Position,GER30/EUR," 999,99 ",0.987979," 0,00 "," 10.210,70 "," 4.311,79 ",2806164144,CFD," 0,00 "
10/09/2024 12:55:19,Open Position,GER30/EUR," 400,00 ",0.395191," 0,00 "," 10.210,70 "," 3.911,79 ",2806164411,CFD," 0,00 "
10/09/2024 12:59:28,Position closed,NSDQ100/USD," 1.090,26 ",1.174028,"(9,74)"," 10.200,96 "," 5.002,05 ",2806162438,CFD," 0,00 "
10/09/2024 13:00:06,Position closed,GER30/EUR," 501,30 ",0.492737," 2,31 "," 10.203,27 "," 5.503,35 ",2806162979,CFD," 0,00 "
10/09/2024 13:00:06,Position closed,GER30/EUR," 300,40 ",0.296197," 0,41 "," 10.203,68 "," 5.803,75 ",2806162913,CFD," 0,00 "
10/09/2024 13:00:06,Position closed,GER30/EUR," 499,85 ",0.493572,"(0,13)"," 10.203,55 "," 6.303,60 ",2806162752,CFD," 0,00 "
10/09/2024 13:00:06,Position closed,GER30/EUR," 500,67 ",0.493635," 0,68 "," 10.204,23 "," 6.804,27 ",2806162786,CFD," 0,00 "
10/09/2024 13:00:06,Position closed,GER30/EUR," 502,58 ",0.493788," 2,59 "," 10.206,82 "," 7.306,85 ",2806163702,CFD," 0,00 "
10/09/2024 13:00:06,Position closed,GER30/EUR," 503,40 ",0.493797," 3,41 "," 10.210,23 "," 7.810,25 ",2806163375,CFD," 0,00 "
10/09/2024 13:00:06,Position closed,GER30/EUR," 1.011,16 ",0.987979," 11,17 "," 10.221,40 "," 8.821,41 ",2806164144,CFD," 0,00 "
10/09/2024 13:00:06,Position closed,GER30/EUR," 1.007,89 ",0.987594," 7,90 "," 10.229,30 "," 9.829,30 ",2806163315,CFD," 0,00 "
10/09/2024 13:00:06,Position closed,GER30/EUR," 405,12 ",0.395191," 5,12 "," 10.234,42 "," 10.234,42 ",2806164411,CFD," 0,00 "
10/09/2024 13:00:45,Open Position,GER30/EUR," 299,99 ",0.296227," 0,00 "," 10.234,42 "," 9.934,43 ",2806165623,CFD," 0,00 "
10/09/2024 13:01:01,Open Position,GER30/EUR," 299,98 ",0.296143," 0,00 "," 10.234,42 "," 9.634,45 ",2806165712,CFD," 0,00 "
10/09/2024 13:02:05,Open Position,GER30/EUR," 400,00 ",0.394998," 0,00 "," 10.234,42 "," 9.234,45 ",2806166015,CFD," 0,00 "
10/09/2024 13:02:14,Open Position,GER30/EUR," 999,99 ",0.987549," 0,00 "," 10.234,42 "," 8.234,46 ",2806166050,CFD," 0,00 "
10/09/2024 13:02:28,Open Position,GER30/EUR," 999,99 ",0.987702," 0,00 "," 10.234,42 "," 7.234,47 ",2806166096,CFD," 0,00 "
10/09/2024 13:02:44,Open Position,GER30/EUR," 499,99 ",0.493824," 0,00 "," 10.234,42 "," 6.734,48 ",2806166264,CFD," 0,00 "
10/09/2024 13:03:31,Open Position,GER30/EUR," 600,00 ",0.592535," 0,00 "," 10.234,42 "," 6.134,48 ",2806166571,CFD," 0,00 "
10/09/2024 13:04:22,Open Position,GER30/EUR," 499,99 ",0.493689," 0,00 "," 10.234,42 "," 5.634,49 ",2806166799,CFD," 0,00 "
10/09/2024 13:05:28,Open Position,GER30/EUR," 299,99 ",0.296149," 0,00 "," 10.234,42 "," 5.334,50 ",2806167105,CFD," 0,00 "
10/09/2024 13:06:20,Open Position,GER30/EUR," 499,99 ",0.493586," 0,00 "," 10.234,42 "," 4.834,51 ",2806167397,CFD," 0,00 "
10/09/2024 13:06:49,Open Position,GER30/EUR," 499,99 ",0.493662," 0,00 "," 10.234,42 "," 4.334,52 ",2806167526,CFD," 0,00 "
10/09/2024 13:07:45,Open Position,GER30/EUR," 600,00 ",0.592766," 0,00 "," 10.234,42 "," 3.734,52 ",2806167821,CFD," 0,00 "
10/09/2024 13:16:57,Open Position,GER30/EUR," 940,00 ",0.930290," 0,00 "," 10.234,42 "," 2.794,52 ",2806169669,CFD," 0,00 "
10/09/2024 13:17:33,Open Position,GER30/EUR," 699,98 ",0.692822," 0,00 "," 10.234,42 "," 2.094,54 ",2806170672,CFD," 0,00 "
10/09/2024 13:18:27,Open Position,GER30/EUR," 529,99 ",0.524725," 0,00 "," 10.234,42 "," 1.564,55 ",2806170804,CFD," 0,00 "
10/09/2024 13:29:18,Open Position,GER30/EUR," 499,98 ",0.493913," 0,00 "," 10.234,42 "," 1.064,57 ",2806173708,CFD," 0,00 "
10/09/2024 13:36:15,Open Position,GER30/EUR," 499,99 ",0.494938," 0,00 "," 10.234,42 "," 564,58 ",2806221283,CFD," 0,00 "
10/09/2024 14:14:11,Open Position,GER30/EUR," 499,99 ",0.497474," 0,00 "," 10.234,42 "," 64,59 ",2806308757,CFD," 0,00 "
10/09/2024 17:11:39,Position closed,GER30/EUR," 510,11 ",0.497474," 10,12 "," 10.244,54 "," 574,70 ",2806308757,CFD," 0,00 "
10/09/2024 17:14:27,Open Position,NSDQ100/USD," 399,99 ",0.427148," 0,00 "," 10.244,54 "," 174,71 ",2806525601,CFD," 0,00 "
10/09/2024 17:19:53,Position closed,GER30/EUR," 452,32 ",0.493913,"(47,66)"," 10.196,88 "," 627,03 ",2806173708,CFD," 0,00 "
10/09/2024 17:20:10,Open Position,NSDQ100/USD," 500,00 ",0.533645," 0,00 "," 10.196,88 "," 127,03 ",2806528337,CFD," 0,00 "
10/09/2024 17:21:10,Position closed,GER30/EUR," 534,96 ",0.592766,"(65,04)"," 10.131,84 "," 661,99 ",2806167821,CFD," 0,00 "
10/09/2024 17:21:26,Open Position,NSDQ100/USD," 599,99 ",0.640934," 0,00 "," 10.131,84 "," 62,00 ",2806530499,CFD," 0,00 "
10/09/2024 17:24:09,Position closed,GER30/EUR," 356,01 ",0.394998,"(43,99)"," 10.087,85 "," 418,01 ",2806166015,CFD," 0,00 "
10/09/2024 17:24:25,Open Position,NSDQ100/USD," 399,99 ",0.427109," 0,00 "," 10.087,85 "," 18,02 ",2806531943,CFD," 0,00 "
10/09/2024 17:28:20,Position closed,GER30/EUR," 448,28 ",0.493586,"(51,71)"," 10.036,14 "," 466,30 ",2806167397,CFD," 0,00 "
10/09/2024 17:28:35,Open Position,NSDQ100/USD," 399,99 ",0.427118," 0,00 "," 10.036,14 "," 66,31 ",2806533805,CFD," 0,00 "
10/09/2024 17:33:28,Position closed,GER30/EUR," 450,44 ",0.493662,"(49,55)"," 9.986,59 "," 516,75 ",2806167526,CFD," 0,00 "
10/09/2024 17:33:43,Open Position,NSDQ100/USD," 449,99 ",0.480613," 0,00 "," 9.986,59 "," 66,76 ",2806535644,CFD," 0,00 "
10/09/2024 17:55:14,Position closed,GER30/EUR," 458,87 ",0.493824,"(41,12)"," 9.945,47 "," 525,63 ",2806166264,CFD," 0,00 "
10/09/2024 17:55:34,Open Position,NSDQ100/USD," 460,00 ",0.490328," 0,00 "," 9.945,47 "," 65,63 ",2806546285,CFD," 0,00 "
10/09/2024 18:03:45,Position closed,GER30/EUR," 279,57 ",0.296149,"(20,42)"," 9.925,05 "," 345,20 ",2806167105,CFD," 0,00 "
10/09/2024 18:04:05,Open Position,NSDQ100/USD," 300,00 ",0.319219," 0,00 "," 9.925,05 "," 45,20 ",2806551104,CFD," 0,00 "
10/09/2024 18:18:04,Position closed,GER30/EUR," 527,64 ",0.524725,"(2,35)"," 9.922,70 "," 572,84 ",2806170804,CFD," 0,00 "
10/09/2024 18:18:20,Open Position,NSDQ100/USD," 500,00 ",0.531961," 0,00 "," 9.922,70 "," 72,84 ",2806559374,CFD," 0,00 "
10/09/2024 18:24:22,Position closed,GER30/EUR," 695,36 ",0.692822,"(4,62)"," 9.918,08 "," 768,20 ",2806170672,CFD," 0,00 "
10/09/2024 18:24:40,Open Position,NSDQ100/USD," 607,97 ",0.647058," 0,00 "," 9.918,08 "," 160,23 ",2806563050,CFD," 0,00 "
10/09/2024 18:28:08,Position closed,GER30/EUR," 497,78 ",0.494938,"(2,21)"," 9.915,87 "," 658,01 ",2806221283,CFD," 0,00 "
10/09/2024 18:28:22,Open Position,NSDQ100/USD," 500,00 ",0.532092," 0,00 "," 9.915,87 "," 158,01 ",2806564323,CFD," 0,00 "
10/09/2024 18:47:29,Position closed,GER30/EUR," 952,26 ",0.930290," 12,26 "," 9.928,13 "," 1.110,27 ",2806169669,CFD," 0,00 "
10/09/2024 18:47:53,Open Position,NSDQ100/USD," 899,99 ",0.957322," 0,00 "," 9.928,13 "," 210,28 ",2806571555,CFD," 0,00 "
10/09/2024 19:09:12,Position closed,GER30/EUR," 578,09 ",0.592535,"(21,91)"," 9.906,22 "," 788,37 ",2806166571,CFD," 0,00 "
10/09/2024 19:09:27,Open Position,NSDQ100/USD," 700,00 ",0.744691," 0,00 "," 9.906,22 "," 88,37 ",2806581338,CFD," 0,00 "
10/09/2024 19:10:33,Position closed,GER30/EUR," 966,74 ",0.987702,"(33,25)"," 9.872,97 "," 1.055,11 ",2806166096,CFD," 0,00 "
10/09/2024 19:10:46,Open Position,NSDQ100/USD," 949,99 ",1.010050," 0,00 "," 9.872,97 "," 105,12 ",2806581996,CFD," 0,00 "
10/09/2024 19:22:17,Position closed,GER30/EUR," 489,89 ",0.493689,"(10,10)"," 9.862,87 "," 595,01 ",2806166799,CFD," 0,00 "
10/09/2024 19:22:37,Open Position,NSDQ100/USD," 500,00 ",0.531673," 0,00 "," 9.862,87 "," 95,01 ",2806587321,CFD," 0,00 "
10/09/2024 19:25:59,Position closed,GER30/EUR," 971,08 ",0.987549,"(28,91)"," 9.833,96 "," 1.066,09 ",2806166050,CFD," 0,00 "
10/09/2024 19:26:16,Open Position,NSDQ100/USD," 799,99 ",0.850645," 0,00 "," 9.833,96 "," 266,10 ",2806590128,CFD," 0,00 "
10/09/2024 19:34:59,Position closed,GER30/EUR," 287,73 ",0.296227,"(12,26)"," 9.821,70 "," 553,83 ",2806165623,CFD," 0,00 "
10/09/2024 19:35:14,Open Position,NSDQ100/USD," 500,00 ",0.531134," 0,00 "," 9.821,70 "," 53,83 ",2806595736,CFD," 0,00 "
11/09/2024 00:48:32,Overnight fee,Daily,"(1,35)",-,"(1,35)"," 9.820,35 "," 52,48 ",2806165712,CFD," 0,00 "
11/09/2024 00:48:32,Overnight refund,Daily," 0,07 ",-," 0,07 "," 9.820,42 "," 52,55 ",2806563050,CFD," 0,00 "
11/09/2024 00:48:32,Overnight refund,Daily," 0,05 ",-," 0,05 "," 9.820,47 "," 52,60 ",2806531943,CFD," 0,00 "
11/09/2024 00:48:32,Overnight refund,Daily," 0,06 ",-," 0,06 "," 9.820,53 "," 52,66 ",2806564323,CFD," 0,00 "
11/09/2024 00:48:32,Overnight refund,Daily," 0,09 ",-," 0,09 "," 9.820,62 "," 52,75 ",2806590128,CFD," 0,00 "
11/09/2024 00:48:32,Overnight refund,Daily," 0,03 ",-," 0,03 "," 9.820,65 "," 52,78 ",2806551104,CFD," 0,00 "
11/09/2024 00:48:32,Overnight refund,Daily," 0,06 ",-," 0,06 "," 9.820,71 "," 52,84 ",2806595736,CFD," 0,00 "
11/09/2024 00:48:32,Overnight refund,Daily," 0,06 ",-," 0,06 "," 9.820,77 "," 52,90 ",2806559374,CFD," 0,00 "
11/09/2024 00:48:32,Overnight refund,Daily," 0,05 ",-," 0,05 "," 9.820,82 "," 52,95 ",2806535644,CFD," 0,00 "
11/09/2024 00:48:32,Overnight refund,Daily," 0,05 ",-," 0,05 "," 9.820,87 "," 53,00 ",2806525601,CFD," 0,00 "
11/09/2024 00:48:32,Overnight refund,Daily," 0,06 ",-," 0,06 "," 9.820,93 "," 53,06 ",2806587321,CFD," 0,00 "
11/09/2024 00:48:32,Overnight refund,Daily," 0,06 ",-," 0,06 "," 9.820,99 "," 53,12 ",2806528337,CFD," 0,00 "
11/09/2024 00:48:32,Overnight refund,Daily," 0,05 ",-," 0,05 "," 9.821,04 "," 53,17 ",2806533805,CFD," 0,00 "
11/09/2024 00:48:32,Overnight refund,Daily," 0,10 ",-," 0,10 "," 9.821,14 "," 53,27 ",2806571555,CFD," 0,00 "
11/09/2024 00:48:32,Overnight refund,Daily," 0,08 ",-," 0,08 "," 9.821,22 "," 53,35 ",2806581338,CFD," 0,00 "
11/09/2024 00:48:32,Overnight refund,Daily," 0,07 ",-," 0,07 "," 9.821,29 "," 53,42 ",2806530499,CFD," 0,00 "
11/09/2024 00:48:32,Overnight refund,Daily," 0,11 ",-," 0,11 "," 9.821,40 "," 53,53 ",2806581996,CFD," 0,00 "
11/09/2024 00:48:32,Overnight refund,Daily," 0,05 ",-," 0,05 "," 9.821,45 "," 53,58 ",2806546285,CFD," 0,00 "
11/09/2024 01:16:31,Position closed,NSDQ100/USD," 377,93 ",0.427109,"(22,06)"," 9.799,39 "," 431,51 ",2806531943,CFD," 0,00 "
11/09/2024 01:16:31,Position closed,NSDQ100/USD," 561,82 ",0.640934,"(38,17)"," 9.761,22 "," 993,33 ",2806530499,CFD," 0,00 "
11/09/2024 01:16:31,Position closed,NSDQ100/USD," 476,96 ",0.533645,"(23,04)"," 9.738,18 "," 1.470,29 ",2806528337,CFD," 0,00 "
11/09/2024 01:16:31,Position closed,NSDQ100/USD," 377,20 ",0.427148,"(22,79)"," 9.715,39 "," 1.847,49 ",2806525601,CFD," 0,00 "
11/09/2024 01:16:31,Position closed,NSDQ100/USD," 450,55 ",0.490328,"(9,45)"," 9.705,94 "," 2.298,04 ",2806546285,CFD," 0,00 "
11/09/2024 01:16:31,Position closed,NSDQ100/USD," 304,35 ",0.319219," 4,35 "," 9.710,29 "," 2.602,39 ",2806551104,CFD," 0,00 "
11/09/2024 01:16:31,Position closed,NSDQ100/USD," 423,00 ",0.480613,"(26,99)"," 9.683,30 "," 3.025,39 ",2806535644,CFD," 0,00 "
11/09/2024 01:16:31,Position closed,NSDQ100/USD," 377,75 ",0.427118,"(22,24)"," 9.661,06 "," 3.403,14 ",2806533805,CFD," 0,00 "
11/09/2024 01:16:31,Position closed,NSDQ100/USD," 919,36 ",0.957322," 19,37 "," 9.680,43 "," 4.322,50 ",2806571555,CFD," 0,00 "
11/09/2024 01:16:31,Position closed,NSDQ100/USD," 506,14 ",0.532092," 6,14 "," 9.686,57 "," 4.828,64 ",2806564323,CFD," 0,00 "
11/09/2024 01:16:31,Position closed,NSDQ100/USD," 508,58 ",0.531961," 8,58 "," 9.695,15 "," 5.337,22 ",2806559374,CFD," 0,00 "
11/09/2024 01:16:31,Position closed,NSDQ100/USD," 823,07 ",0.850645," 23,08 "," 9.718,23 "," 6.160,29 ",2806590128,CFD," 0,00 "
11/09/2024 01:16:31,Position closed,NSDQ100/USD," 614,46 ",0.647058," 6,49 "," 9.724,72 "," 6.774,75 ",2806563050,CFD," 0,00 "
11/09/2024 01:16:31,Position closed,NSDQ100/USD," 514,05 ",0.531673," 14,05 "," 9.738,77 "," 7.288,80 ",2806587321,CFD," 0,00 "
11/09/2024 01:16:31,Position closed,NSDQ100/USD," 713,13 ",0.744691," 13,13 "," 9.751,90 "," 8.001,93 ",2806581338,CFD," 0,00 "
11/09/2024 01:16:31,Position closed,NSDQ100/USD," 979,11 ",1.010050," 29,12 "," 9.781,02 "," 8.981,04 ",2806581996,CFD," 0,00 "
11/09/2024 01:16:32,Position closed,NSDQ100/USD," 524,18 ",0.531134," 24,18 "," 9.805,20 "," 9.505,22 ",2806595736,CFD," 0,00 "
11/09/2024 01:21:03,Open Position,NSDQ100/USD," 499,99 ",0.532265," 0,00 "," 9.805,20 "," 9.005,23 ",2806622005,CFD," 0,00 "
11/09/2024 01:27:39,Position closed,NSDQ100/USD," 501,42 ",0.532265," 1,43 "," 9.806,63 "," 9.506,65 ",2806622005,CFD," 0,00 "
11/09/2024 01:32:15,Open Position,NSDQ100/USD," 2.399,99 ",2.554184," 0,00 "," 9.806,63 "," 7.106,66 ",2806624049,CFD," 0,00 "
11/09/2024 01:33:28,Position closed,NSDQ100/USD," 2.439,27 ",2.554184," 39,28 "," 9.845,91 "," 9.545,93 ",2806624049,CFD," 0,00 "
11/09/2024 01:36:48,Open Position,NSDQ100/USD," 500,00 ",0.533632," 0,00 "," 9.845,91 "," 9.045,93 ",2806624433,CFD," 0,00 "
11/09/2024 01:37:44,Open Position,NSDQ100/USD," 499,98 ",0.533322," 0,00 "," 9.845,91 "," 8.545,95 ",2806624496,CFD," 0,00 "
11/09/2024 01:37:57,Position closed,NSDQ100/USD," 493,54 ",0.533632,"(6,46)"," 9.839,45 "," 9.039,49 ",2806624433,CFD," 0,00 "
11/09/2024 01:39:47,Position closed,NSDQ100/USD," 498,00 ",0.533322,"(1,98)"," 9.837,47 "," 9.537,49 ",2806624496,CFD," 0,00 "
11/09/2024 08:30:09,Open Position,NSDQ100/USD," 500,00 ",0.532184," 0,00 "," 9.837,47 "," 9.037,49 ",2806713604,CFD," 0,00 "
11/09/2024 08:31:51,Position closed,NSDQ100/USD," 505,79 ",0.532184," 5,79 "," 9.843,26 "," 9.543,28 ",2806713604,CFD," 0,00 "
11/09/2024 08:39:14,Open Position,NSDQ100/USD," 299,99 ",0.319851," 0,00 "," 9.843,26 "," 9.243,29 ",2806715462,CFD," 0,00 "
11/09/2024 08:40:23,Position closed,NSDQ100/USD," 300,59 ",0.319851," 0,60 "," 9.843,86 "," 9.543,88 ",2806715462,CFD," 0,00 "
11/09/2024 08:43:28,Open Position,NSDQ100/USD," 499,99 ",0.533270," 0,00 "," 9.843,86 "," 9.043,89 ",2806716261,CFD," 0,00 "
11/09/2024 08:44:31,Position closed,NSDQ100/USD," 496,57 ",0.533270,"(3,42)"," 9.840,44 "," 9.540,46 ",2806716261,CFD," 0,00 "
11/09/2024 08:45:14,Open Position,NSDQ100/USD," 2.399,99 ",2.560643," 0,00 "," 9.840,44 "," 7.140,47 ",2806716663,CFD," 0,00 "
11/09/2024 08:46:47,Open Position,NSDQ100/USD," 1.000,00 ",1.066951," 0,00 "," 9.840,44 "," 6.140,47 ",2806717087,CFD," 0,00 "
11/09/2024 08:49:58,Open Position,NSDQ100/USD," 999,99 ",1.065950," 0,00 "," 9.840,44 "," 5.140,48 ",2806719962,CFD," 0,00 "
11/09/2024 08:50:58,Open Position,NSDQ100/USD," 1.300,00 ",1.386452," 0,00 "," 9.840,44 "," 3.840,48 ",2806720073,CFD," 0,00 "
11/09/2024 08:55:06,Position closed,NSDQ100/USD," 1.308,86 ",1.386452," 8,86 "," 9.849,30 "," 5.149,34 ",2806720073,CFD," 0,00 "
11/09/2024 08:57:22,Position closed,NSDQ100/USD," 999,99 ",1.066951,"(0,01)"," 9.849,29 "," 6.149,33 ",2806717087,CFD," 0,00 "
11/09/2024 08:57:27,Position closed,NSDQ100/USD," 2.400,99 ",2.560643," 1,00 "," 9.850,29 "," 8.550,32 ",2806716663,CFD," 0,00 "
11/09/2024 08:58:52,Open Position,NSDQ100/USD," 499,99 ",0.533182," 0,00 "," 9.850,29 "," 8.050,33 ",2806721390,CFD," 0,00 "
11/09/2024 09:02:20,Position closed,NSDQ100/USD," 501,80 ",0.533182," 1,81 "," 9.852,10 "," 8.552,13 ",2806721390,CFD," 0,00 "
11/09/2024 09:03:22,Position closed,NSDQ100/USD," 994,54 ",1.065950,"(5,45)"," 9.846,65 "," 9.546,67 ",2806719962,CFD," 0,00 "
11/09/2024 09:26:31,Open Position,NSDQ100/USD," 499,99 ",0.533344," 0,00 "," 9.846,65 "," 9.046,68 ",2806725596,CFD," 0,00 "
11/09/2024 09:27:02,Position closed,NSDQ100/USD," 501,32 ",0.533344," 1,33 "," 9.847,98 "," 9.548,00 ",2806725596,CFD," 0,00 "
11/09/2024 11:14:54,Open Position,NSDQ100/USD," 1.000,00 ",1.064708," 0,00 "," 9.847,98 "," 8.548,00 ",2806742893,CFD," 0,00 "
11/09/2024 11:34:33,Open Position,NSDQ100/USD," 1.500,00 ",1.597036," 0,00 "," 9.847,98 "," 7.048,00 ",2806745009,CFD," 0,00 "
11/09/2024 12:11:09,Open Position,NSDQ100/USD," 1.000,00 ",1.063428," 0,00 "," 9.847,98 "," 6.048,00 ",2806752136,CFD," 0,00 "
11/09/2024 12:13:32,Open Position,NSDQ100/USD," 500,00 ",0.531530," 0,00 "," 9.847,98 "," 5.548,00 ",2806752648,CFD," 0,00 "
11/09/2024 12:30:40,Position closed,NSDQ100/USD," 533,48 ",0.531530," 33,48 "," 9.881,46 "," 6.081,48 ",2806752648,CFD," 0,00 "
11/09/2024 12:30:40,Position closed,NSDQ100/USD," 1.063,26 ",1.063428," 63,26 "," 9.944,72 "," 7.144,74 ",2806752136,CFD," 0,00 "
11/09/2024 12:30:40,Position closed,NSDQ100/USD," 1.039,28 ",1.064708," 39,28 "," 9.984,00 "," 8.184,02 ",2806742893,CFD," 0,00 "
11/09/2024 12:30:40,Position closed,NSDQ100/USD," 1.554,60 ",1.597036," 54,60 "," 10.038,60 "," 9.738,62 ",2806745009,CFD," 0,00 "
11/09/2024 12:32:10,Open Position,NSDQ100/USD," 1.000,00 ",1.066456," 0,00 "," 10.038,60 "," 8.738,62 ",2806762965,CFD," 0,00 "
11/09/2024 12:33:15,Open Position,NSDQ100/USD," 1.000,00 ",1.066235," 0,00 "," 10.038,60 "," 7.738,62 ",2806764941,CFD," 0,00 "
11/09/2024 12:34:10,Position closed,NSDQ100/USD," 1.010,44 ",1.066235," 10,44 "," 10.049,04 "," 8.749,06 ",2806764941,CFD," 0,00 "
11/09/2024 12:34:13,Position closed,NSDQ100/USD," 998,60 ",1.066456,"(1,40)"," 10.047,64 "," 9.747,66 ",2806762965,CFD," 0,00 "
11/09/2024 12:34:33,Open Position,NSDQ100/USD," 1.500,00 ",1.599642," 0,00 "," 10.047,64 "," 8.247,66 ",2806765811,CFD," 0,00 "
11/09/2024 12:36:04,Open Position,NSDQ100/USD," 500,00 ",0.533623," 0,00 "," 10.047,64 "," 7.747,66 ",2806766601,CFD," 0,00 "
11/09/2024 12:36:33,Open Position,NSDQ100/USD," 2.000,00 ",2.132856," 0,00 "," 10.047,64 "," 5.747,66 ",2806766870,CFD," 0,00 "
11/09/2024 12:37:05,Open Position,NSDQ100/USD," 999,99 ",1.066297," 0,00 "," 10.047,64 "," 4.747,67 ",2806767087,CFD," 0,00 "
11/09/2024 12:37:16,Position closed,NSDQ100/USD," 1.003,92 ",1.066297," 3,93 "," 10.051,57 "," 5.751,59 ",2806767087,CFD," 0,00 "
11/09/2024 12:37:27,Open Position,NSDQ100/USD," 1.500,00 ",1.598968," 0,00 "," 10.051,57 "," 4.251,59 ",2806767469,CFD," 0,00 "
11/09/2024 12:38:40,Open Position,NSDQ100/USD," 1.099,99 ",1.171628," 0,00 "," 10.051,57 "," 3.151,60 ",2806768357,CFD," 0,00 "
11/09/2024 12:40:37,Position closed,NSDQ100/USD," 1.121,89 ",1.171628," 21,90 "," 10.073,47 "," 4.273,49 ",2806768357,CFD," 0,00 "
11/09/2024 12:40:50,Position closed,NSDQ100/USD," 1.504,62 ",1.599642," 4,62 "," 10.078,09 "," 5.778,11 ",2806765811,CFD," 0,00 "
11/09/2024 12:40:57,Position closed,NSDQ100/USD," 1.520,13 ",1.598968," 20,13 "," 10.098,22 "," 7.298,24 ",2806767469,CFD," 0,00 "
11/09/2024 12:41:03,Position closed,NSDQ100/USD," 2.013,42 ",2.132856," 13,42 "," 10.111,64 "," 9.311,66 ",2806766870,CFD," 0,00 "
11/09/2024 12:41:07,Position closed,NSDQ100/USD," 494,66 ",0.533623,"(5,34)"," 10.106,30 "," 9.806,32 ",2806766601,CFD," 0,00 "
11/09/2024 12:42:24,Open Position,NSDQ100/USD," 500,00 ",0.533342," 0,00 "," 10.106,30 "," 9.306,32 ",2806771583,CFD," 0,00 "
11/09/2024 12:43:49,Open Position,NSDQ100/USD," 1.000,00 ",1.066610," 0,00 "," 10.106,30 "," 8.306,32 ",2806772000,CFD," 0,00 "
11/09/2024 12:44:39,Open Position,NSDQ100/USD," 1.000,00 ",1.066252," 0,00 "," 10.106,30 "," 7.306,32 ",2806772260,CFD," 0,00 "
11/09/2024 12:45:40,Open Position,NSDQ100/USD," 500,00 ",0.532876," 0,00 "," 10.106,30 "," 6.806,32 ",2806772769,CFD," 0,00 "
11/09/2024 12:46:34,Open Position,NSDQ100/USD," 1.000,00 ",1.065604," 0,00 "," 10.106,30 "," 5.806,32 ",2806773070,CFD," 0,00 "
11/09/2024 12:47:28,Open Position,NSDQ100/USD," 500,00 ",0.532572," 0,00 "," 10.106,30 "," 5.306,32 ",2806773479,CFD," 0,00 "
11/09/2024 12:50:31,Position closed,GER30/EUR," 302,82 ",0.296143," 2,84 "," 10.109,14 "," 5.609,14 ",2806165712,CFD," 0,00 "
11/09/2024 12:50:42,Open Position,NSDQ100/USD," 1.499,99 ",1.595709," 0,00 "," 10.109,14 "," 4.109,15 ",2806774613,CFD," 0,00 "
11/09/2024 12:56:06,Position closed,NSDQ100/USD," 1.527,40 ",1.595709," 27,41 "," 10.136,55 "," 5.636,55 ",2806774613,CFD," 0,00 "
11/09/2024 12:57:41,Open Position,NSDQ100/USD," 500,00 ",0.530969," 0,00 "," 10.136,55 "," 5.136,55 ",2806777043,CFD," 0,00 "
11/09/2024 12:57:59,Position closed,NSDQ100/USD," 492,07 ",0.530969,"(7,93)"," 10.128,62 "," 5.628,62 ",2806777043,CFD," 0,00 "
11/09/2024 12:59:42,Open Position,NSDQ100/USD," 500,00 ",0.530698," 0,00 "," 10.128,62 "," 5.128,62 ",2806777807,CFD," 0,00 "
11/09/2024 13:00:08,Open Position,NSDQ100/USD," 1.000,00 ",1.061757," 0,00 "," 10.128,62 "," 4.128,62 ",2806777924,CFD," 0,00 "
11/09/2024 13:05:34,Open Position,NSDQ100/USD," 499,99 ",0.529953," 0,00 "," 10.128,62 "," 3.628,63 ",2806781157,CFD," 0,00 "
11/09/2024 13:09:58,Position closed,NSDQ100/USD," 500,40 ",0.529953," 0,41 "," 10.129,03 "," 4.129,03 ",2806781157,CFD," 0,00 "
11/09/2024 13:11:38,Open Position,NSDQ100/USD," 499,99 ",0.529862," 0,00 "," 10.129,03 "," 3.629,04 ",2806783056,CFD," 0,00 "
11/09/2024 13:20:44,Open Position,NSDQ100/USD," 499,99 ",0.529427," 0,00 "," 10.129,03 "," 3.129,05 ",2806785788,CFD," 0,00 "
11/09/2024 13:20:53,Open Position,NSDQ100/USD," 789,99 ",0.836482," 0,00 "," 10.129,03 "," 2.339,06 ",2806785840,CFD," 0,00 "
11/09/2024 13:21:11,Open Position,NSDQ100/USD," 499,99 ",0.529391," 0,00 "," 10.129,03 "," 1.839,07 ",2806785903,CFD," 0,00 "
11/09/2024 13:26:34,Position closed,NSDQ100/USD," 508,72 ",0.529862," 8,73 "," 10.137,76 "," 2.347,79 ",2806783056,CFD," 0,00 "
11/09/2024 13:27:55,Position closed,NSDQ100/USD," 792,64 ",0.836482," 2,65 "," 10.140,41 "," 3.140,43 ",2806785840,CFD," 0,00 "
11/09/2024 13:28:26,Open Position,NSDQ100/USD," 499,99 ",0.529475," 0,00 "," 10.140,41 "," 2.640,44 ",2806788419,CFD," 0,00 "
11/09/2024 13:29:03,Open Position,NSDQ100/USD," 300,00 ",0.317857," 0,00 "," 10.140,41 "," 2.340,44 ",2806788549,CFD," 0,00 "
11/09/2024 13:29:43,Open Position,NSDQ100/USD," 399,99 ",0.423876," 0,00 "," 10.140,41 "," 1.940,45 ",2806788759,CFD," 0,00 "
11/09/2024 13:32:27,Open Position,NSDQ100/USD," 489,98 ",0.519556," 0,00 "," 10.140,41 "," 1.450,47 ",2806824734,CFD," 0,00 "
11/09/2024 13:34:08,Open Position,NSDQ100/USD," 370,00 ",0.392336," 0,00 "," 10.140,41 "," 1.080,47 ",2806827250,CFD," 0,00 "
11/09/2024 13:34:41,Open Position,NSDQ100/USD," 279,99 ",0.297197," 0,00 "," 10.140,41 "," 800,48 ",2806827859,CFD," 0,00 "
11/09/2024 13:39:29,Position closed,NSDQ100/USD," 1.000,66 ",1.061757," 0,66 "," 10.141,07 "," 1.801,14 ",2806777924,CFD," 0,00 "
11/09/2024 13:40:31,Position closed,NSDQ100/USD," 524,85 ",0.530698," 24,85 "," 10.165,92 "," 2.325,99 ",2806777807,CFD," 0,00 "
11/09/2024 13:41:10,Open Position,NSDQ100/USD," 499,99 ",0.531486," 0,00 "," 10.165,92 "," 1.826,00 ",2806837488,CFD," 0,00 "
11/09/2024 13:42:49,Position closed,NSDQ100/USD," 511,62 ",0.531486," 11,63 "," 10.177,55 "," 2.337,62 ",2806837488,CFD," 0,00 "
11/09/2024 13:44:09,Open Position,NSDQ100/USD," 589,99 ",0.626880," 0,00 "," 10.177,55 "," 1.747,63 ",2806842207,CFD," 0,00 "
11/09/2024 13:45:03,Position closed,NSDQ100/USD," 589,16 ",0.626880,"(0,83)"," 10.176,72 "," 2.336,79 ",2806842207,CFD," 0,00 "
11/09/2024 13:45:16,Open Position,NSDQ100/USD," 589,99 ",0.627214," 0,00 "," 10.176,72 "," 1.746,80 ",2806843613,CFD," 0,00 "
11/09/2024 13:46:14,Position closed,NSDQ100/USD," 601,27 ",0.627214," 11,28 "," 10.188,00 "," 2.348,07 ",2806843613,CFD," 0,00 "
11/09/2024 13:46:24,Open Position,NSDQ100/USD," 590,00 ",0.627407," 0,00 "," 10.188,00 "," 1.758,07 ",2806845953,CFD," 0,00 "
11/09/2024 13:47:29,Position closed,NSDQ100/USD," 501,83 ",0.532572," 1,83 "," 10.189,83 "," 2.259,90 ",2806773479,CFD," 0,00 "
11/09/2024 13:47:37,Open Position,NSDQ100/USD," 299,99 ",0.319452," 0,00 "," 10.189,83 "," 1.959,91 ",2806847446,CFD," 0,00 "
11/09/2024 13:48:41,Position closed,NSDQ100/USD," 306,02 ",0.319452," 6,03 "," 10.195,86 "," 2.265,93 ",2806847446,CFD," 0,00 "
11/09/2024 13:49:01,Open Position,NSDQ100/USD," 569,99 ",0.606530," 0,00 "," 10.195,86 "," 1.695,94 ",2806849604,CFD," 0,00 "
11/09/2024 13:50:07,Position closed,NSDQ100/USD," 577,62 ",0.606530," 7,63 "," 10.203,49 "," 2.273,56 ",2806849604,CFD," 0,00 "
11/09/2024 13:58:00,Open Position,NSDQ100/USD," 499,98 ",0.532604," 0,00 "," 10.203,49 "," 1.773,58 ",2806897846,CFD," 0,00 "
11/09/2024 13:59:00,Position closed,NSDQ100/USD," 1.012,83 ",1.065604," 12,83 "," 10.216,32 "," 2.786,41 ",2806773070,CFD," 0,00 "
11/09/2024 14:00:12,Position closed,NSDQ100/USD," 509,45 ",0.532876," 9,45 "," 10.225,77 "," 3.295,86 ",2806772769,CFD," 0,00 "
11/09/2024 14:00:29,Position closed,NSDQ100/USD," 1.023,50 ",1.066252," 23,50 "," 10.249,27 "," 4.319,36 ",2806772260,CFD," 0,00 "
11/09/2024 14:00:56,Position closed,NSDQ100/USD," 1.021,68 ",1.066610," 21,68 "," 10.270,95 "," 5.341,04 ",2806772000,CFD," 0,00 "
11/09/2024 14:01:13,Position closed,NSDQ100/USD," 499,27 ",0.533342,"(0,73)"," 10.270,22 "," 5.840,31 ",2806771583,CFD," 0,00 "
11/09/2024 14:01:43,Open Position,NSDQ100/USD," 499,99 ",0.533044," 0,00 "," 10.270,22 "," 5.340,32 ",2806902824,CFD," 0,00 "
11/09/2024 14:01:56,Position closed,NSDQ100/USD," 504,73 ",0.533044," 4,74 "," 10.274,96 "," 5.845,05 ",2806902824,CFD," 0,00 "
11/09/2024 14:02:46,Open Position,NSDQ100/USD," 499,98 ",0.533065," 0,00 "," 10.274,96 "," 5.345,07 ",2806904993,CFD," 0,00 "
11/09/2024 14:04:50,Position closed,NSDQ100/USD," 511,97 ",0.533065," 11,99 "," 10.286,95 "," 5.857,04 ",2806904993,CFD," 0,00 "
11/09/2024 14:06:15,Open Position,NSDQ100/USD," 499,99 ",0.533101," 0,00 "," 10.286,95 "," 5.357,05 ",2806910334,CFD," 0,00 "
11/09/2024 14:07:22,Open Position,NSDQ100/USD," 499,99 ",0.532970," 0,00 "," 10.286,95 "," 4.857,06 ",2806911112,CFD," 0,00 "
11/09/2024 14:08:04,Open Position,NSDQ100/USD," 499,99 ",0.533346," 0,00 "," 10.286,95 "," 4.357,07 ",2806911851,CFD," 0,00 "
11/09/2024 14:08:47,Position closed,NSDQ100/USD," 507,72 ",0.533346," 7,73 "," 10.294,68 "," 4.864,79 ",2806911851,CFD," 0,00 "
11/09/2024 14:08:53,Position closed,NSDQ100/USD," 500,84 ",0.533101," 0,85 "," 10.295,53 "," 5.365,63 ",2806910334,CFD," 0,00 "
11/09/2024 14:09:34,Open Position,NSDQ100/USD," 600,00 ",0.639974," 0,00 "," 10.295,53 "," 4.765,63 ",2806913702,CFD," 0,00 "
11/09/2024 14:10:27,Open Position,NSDQ100/USD," 499,99 ",0.533992," 0,00 "," 10.295,53 "," 4.265,64 ",2806914745,CFD," 0,00 "
11/09/2024 14:12:10,Position closed,NSDQ100/USD," 507,03 ",0.533992," 7,04 "," 10.302,57 "," 4.772,67 ",2806914745,CFD," 0,00 "
11/09/2024 14:13:41,Open Position,NSDQ100/USD," 999,98 ",1.068276," 0,00 "," 10.302,57 "," 3.772,69 ",2806918808,CFD," 0,00 "
11/09/2024 14:13:58,Position closed,NSDQ100/USD," 1.014,38 ",1.068276," 14,40 "," 10.316,97 "," 4.787,07 ",2806918808,CFD," 0,00 "
11/09/2024 14:14:39,Open Position,NSDQ100/USD," 999,99 ",1.068989," 0,00 "," 10.316,97 "," 3.787,08 ",2806920349,CFD," 0,00 "
11/09/2024 14:16:44,Open Position,NSDQ100/USD," 499,96 ",0.536283," 0,00 "," 10.316,97 "," 3.287,12 ",2806926645,CFD," 0,00 "
11/09/2024 14:18:46,Open Position,NSDQ100/USD," 499,99 ",0.536148," 0,00 "," 10.316,97 "," 2.787,13 ",2806928827,CFD," 0,00 "
11/09/2024 14:20:28,Open Position,NSDQ100/USD," 499,99 ",0.536692," 0,00 "," 10.316,97 "," 2.287,14 ",2806931912,CFD," 0,00 "
11/09/2024 14:22:34,Position closed,NSDQ100/USD," 504,40 ",0.536692," 4,41 "," 10.321,38 "," 2.791,54 ",2806931912,CFD," 0,00 "
11/09/2024 14:23:42,Position closed,NSDQ100/USD," 508,17 ",0.536283," 8,21 "," 10.329,59 "," 3.299,71 ",2806926645,CFD," 0,00 "
11/09/2024 14:31:48,Open Position,NSDQ100/USD," 499,99 ",0.537456," 0,00 "," 10.329,59 "," 2.799,72 ",2806946009,CFD," 0,00 "
11/09/2024 14:35:03,Open Position,NSDQ100/USD," 500,00 ",0.538052," 0,00 "," 10.329,59 "," 2.299,72 ",2806950919,CFD," 0,00 "
11/09/2024 14:36:34,Position closed,NSDQ100/USD," 502,31 ",0.537456," 2,32 "," 10.331,91 "," 2.802,03 ",2806946009,CFD," 0,00 "
11/09/2024 14:37:18,Open Position,NSDQ100/USD," 709,99 ",0.763233," 0,00 "," 10.331,91 "," 2.092,04 ",2806953353,CFD," 0,00 "
11/09/2024 14:38:10,Open Position,NSDQ100/USD," 530,00 ",0.569851," 0,00 "," 10.331,91 "," 1.562,04 ",2806954681,CFD," 0,00 "
11/09/2024 14:38:21,Position closed,NSDQ100/USD," 531,54 ",0.569851," 1,54 "," 10.333,45 "," 2.093,58 ",2806954681,CFD," 0,00 "
11/09/2024 14:38:38,Position closed,NSDQ100/USD," 721,67 ",0.763233," 11,68 "," 10.345,13 "," 2.815,25 ",2806953353,CFD," 0,00 "
11/09/2024 14:40:56,Open Position,NSDQ100/USD," 500,00 ",0.538052," 0,00 "," 10.345,13 "," 2.315,25 ",2806957691,CFD," 0,00 "
11/09/2024 14:41:50,Open Position,NSDQ100/USD," 1.000,00 ",1.076277," 0,00 "," 10.345,13 "," 1.315,25 ",2806958287,CFD," 0,00 "
11/09/2024 14:43:21,Position closed,NSDQ100/USD," 1.029,94 ",1.076277," 29,94 "," 10.375,07 "," 2.345,19 ",2806958287,CFD," 0,00 "
11/09/2024 14:43:54,Position closed,NSDQ100/USD," 517,66 ",0.538052," 17,66 "," 10.392,73 "," 2.862,85 ",2806957691,CFD," 0,00 "
11/09/2024 14:44:51,Open Position,NSDQ100/USD," 719,99 ",0.775947," 0,00 "," 10.392,73 "," 2.142,86 ",2806962989,CFD," 0,00 "
11/09/2024 14:44:59,Position closed,NSDQ100/USD," 511,79 ",0.538052," 11,79 "," 10.404,52 "," 2.654,65 ",2806950919,CFD," 0,00 "
11/09/2024 14:45:11,Open Position,NSDQ100/USD," 670,00 ",0.721424," 0,00 "," 10.404,52 "," 1.984,65 ",2806963945,CFD," 0,00 "
11/09/2024 14:46:05,Position closed,NSDQ100/USD," 723,96 ",0.775947," 3,97 "," 10.408,49 "," 2.708,61 ",2806962989,CFD," 0,00 "
11/09/2024 14:46:58,Position closed,NSDQ100/USD," 688,56 ",0.721424," 18,56 "," 10.427,05 "," 3.397,17 ",2806963945,CFD," 0,00 "
11/09/2024 14:47:15,Open Position,NSDQ100/USD," 850,00 ",0.917042," 0,00 "," 10.427,05 "," 2.547,17 ",2806965832,CFD," 0,00 "
11/09/2024 14:47:39,Open Position,NSDQ100/USD," 640,00 ",0.690288," 0,00 "," 10.427,05 "," 1.907,17 ",2806966574,CFD," 0,00 "
11/09/2024 14:48:21,Open Position,NSDQ100/USD," 480,00 ",0.517708," 0,00 "," 10.427,05 "," 1.427,17 ",2806967837,CFD," 0,00 "
11/09/2024 14:48:55,Open Position,NSDQ100/USD," 499,99 ",0.538768," 0,00 "," 10.427,05 "," 927,18 ",2806968542,CFD," 0,00 "
11/09/2024 14:49:10,Position closed,NSDQ100/USD," 494,99 ",0.538768,"(5,00)"," 10.422,05 "," 1.422,17 ",2806968542,CFD," 0,00 "
11/09/2024 14:51:01,Open Position,NSDQ100/USD," 359,97 ",0.388274," 0,00 "," 10.422,05 "," 1.062,20 ",2806970631,CFD," 0,00 "
11/09/2024 14:51:39,Position closed,NSDQ100/USD," 482,60 ",0.517708," 2,60 "," 10.424,65 "," 1.544,80 ",2806967837,CFD," 0,00 "
11/09/2024 14:51:47,Position closed,NSDQ100/USD," 851,03 ",0.917042," 1,03 "," 10.425,68 "," 2.395,83 ",2806965832,CFD," 0,00 "
11/09/2024 14:52:00,Position closed,NSDQ100/USD," 644,91 ",0.690288," 4,91 "," 10.430,59 "," 3.040,74 ",2806966574,CFD," 0,00 "
11/09/2024 14:52:40,Position closed,NSDQ100/USD," 363,98 ",0.388274," 4,01 "," 10.434,60 "," 3.404,72 ",2806970631,CFD," 0,00 "
11/09/2024 14:52:47,Open Position,NSDQ100/USD," 860,00 ",0.927951," 0,00 "," 10.434,60 "," 2.544,72 ",2806974663,CFD," 0,00 "
11/09/2024 14:53:14,Open Position,NSDQ100/USD," 640,00 ",0.690292," 0,00 "," 10.434,60 "," 1.904,72 ",2806975738,CFD," 0,00 "
11/09/2024 14:53:20,Open Position,NSDQ100/USD," 480,00 ",0.518001," 0,00 "," 10.434,60 "," 1.424,72 ",2806975793,CFD," 0,00 "
11/09/2024 14:53:44,Position closed,NSDQ100/USD," 645,67 ",0.690292," 5,67 "," 10.440,27 "," 2.070,39 ",2806975738,CFD," 0,00 "
11/09/2024 14:54:10,Open Position,NSDQ100/USD," 520,00 ",0.560859," 0,00 "," 10.440,27 "," 1.550,39 ",2806976369,CFD," 0,00 "
11/09/2024 14:54:14,Open Position,NSDQ100/USD," 389,99 ",0.420737," 0,00 "," 10.440,27 "," 1.160,40 ",2806976463,CFD," 0,00 "
11/09/2024 14:54:23,Open Position,NSDQ100/USD," 500,00 ",0.539244," 0,00 "," 10.440,27 "," 660,40 ",2806976610,CFD," 0,00 "
11/09/2024 14:55:28,Position closed,NSDQ100/USD," 504,49 ",0.539244," 4,49 "," 10.444,76 "," 1.164,89 ",2806976610,CFD," 0,00 "
11/09/2024 14:55:39,Position closed,NSDQ100/USD," 525,90 ",0.560859," 5,90 "," 10.450,66 "," 1.690,79 ",2806976369,CFD," 0,00 "
11/09/2024 14:55:52,Position closed,NSDQ100/USD," 867,63 ",0.927951," 7,63 "," 10.458,29 "," 2.558,42 ",2806974663,CFD," 0,00 "
11/09/2024 14:56:21,Open Position,NSDQ100/USD," 640,00 ",0.690218," 0,00 "," 10.458,29 "," 1.918,42 ",2806979978,CFD," 0,00 "
11/09/2024 14:56:28,Open Position,NSDQ100/USD," 999,99 ",1.078304," 0,00 "," 10.458,29 "," 918,43 ",2806980058,CFD," 0,00 "
11/09/2024 14:57:07,Position closed,NSDQ100/USD," 991,82 ",1.078304,"(8,17)"," 10.450,12 "," 1.910,25 ",2806980058,CFD," 0,00 "
11/09/2024 14:57:22,Position closed,NSDQ100/USD," 644,50 ",0.690218," 4,50 "," 10.454,62 "," 2.554,75 ",2806979978,CFD," 0,00 "
11/09/2024 14:57:45,Open Position,NSDQ100/USD," 640,00 ",0.690329," 0,00 "," 10.454,62 "," 1.914,75 ",2806983494,CFD," 0,00 "
11/09/2024 14:57:54,Open Position,NSDQ100/USD," 480,00 ",0.517677," 0,00 "," 10.454,62 "," 1.434,75 ",2806983785,CFD," 0,00 "
11/09/2024 14:58:11,Open Position,NSDQ100/USD," 500,00 ",0.539512," 0,00 "," 10.454,62 "," 934,75 ",2806983976,CFD," 0,00 "
11/09/2024 14:58:41,Open Position,NSDQ100/USD," 500,00 ",0.539349," 0,00 "," 10.454,62 "," 434,75 ",2806984309,CFD," 0,00 "
11/09/2024 15:00:13,Open Position,NSDQ100/USD," 399,99 ",0.430794," 0,00 "," 10.454,62 "," 34,76 ",2806986110,CFD," 0,00 "
11/09/2024 15:05:06,Position closed,NSDQ100/USD," 207,39 ",0.317857,"(92,61)"," 10.362,01 "," 242,15 ",2806788549,CFD," 0,00 "
11/09/2024 15:05:17,Open Position,NSDQ100/USD," 199,99 ",0.215140," 0,00 "," 10.362,01 "," 42,16 ",2806992336,CFD," 0,00 "
11/09/2024 15:18:19,Position closed,NSDQ100/USD," 500,37 ",0.536148," 0,38 "," 10.362,39 "," 542,53 ",2806928827,CFD," 0,00 "
11/09/2024 15:21:00,Open Position,NSDQ100/USD," 399,94 ",0.428856," 0,00 "," 10.362,39 "," 142,59 ",2807015991,CFD," 0,00 "
11/09/2024 15:23:57,Position closed,NSDQ100/USD," 402,73 ",0.428856," 2,79 "," 10.365,18 "," 545,32 ",2807015991,CFD," 0,00 "
11/09/2024 15:25:04,Open Position,NSDQ100/USD," 399,99 ",0.429132," 0,00 "," 10.365,18 "," 145,33 ",2807019390,CFD," 0,00 "
11/09/2024 15:29:54,Position closed,NSDQ100/USD," 389,82 ",0.429132,"(10,17)"," 10.355,01 "," 535,15 ",2807019390,CFD," 0,00 "
11/09/2024 15:30:04,Open Position,NSDQ100/USD," 499,99 ",0.535726," 0,00 "," 10.355,01 "," 35,16 ",2807060662,CFD," 0,00 "
11/09/2024 15:31:10,Position closed,NSDQ100/USD," 415,30 ",0.517677,"(64,70)"," 10.290,31 "," 450,46 ",2806983785,CFD," 0,00 "
11/09/2024 15:31:21,Open Position,NSDQ100/USD," 400,00 ",0.428555," 0,00 "," 10.290,31 "," 50,46 ",2807061803,CFD," 0,00 "
11/09/2024 15:31:55,Position closed,NSDQ100/USD," 427,03 ",0.539349,"(72,97)"," 10.217,34 "," 477,49 ",2806984309,CFD," 0,00 "
11/09/2024 15:32:03,Open Position,NSDQ100/USD," 399,99 ",0.428349," 0,00 "," 10.217,34 "," 77,50 ",2807062373,CFD," 0,00 "
11/09/2024 15:32:17,Position closed,NSDQ100/USD," 540,39 ",0.690329,"(99,61)"," 10.117,73 "," 617,89 ",2806983494,CFD," 0,00 "
11/09/2024 15:32:25,Open Position,NSDQ100/USD," 600,00 ",0.642149," 0,00 "," 10.117,73 "," 17,89 ",2807062598,CFD," 0,00 "
11/09/2024 15:34:32,Position closed,NSDQ100/USD," 403,12 ",0.428349," 3,13 "," 10.120,86 "," 421,01 ",2807062373,CFD," 0,00 "
11/09/2024 15:36:25,Position closed,NSDQ100/USD," 182,01 ",0.215140,"(17,98)"," 10.102,88 "," 603,02 ",2806992336,CFD," 0,00 "
11/09/2024 15:36:36,Open Position,NSDQ100/USD," 499,99 ",0.535364," 0,00 "," 10.102,88 "," 103,03 ",2807065454,CFD," 0,00 "
11/09/2024 15:37:47,Position closed,NSDQ100/USD," 412,93 ",0.539512,"(87,07)"," 10.015,81 "," 515,96 ",2806983976,CFD," 0,00 "
11/09/2024 15:37:55,Open Position,NSDQ100/USD," 499,99 ",0.534809," 0,00 "," 10.015,81 "," 15,97 ",2807066365,CFD," 0,00 "
11/09/2024 15:38:34,Position closed,NSDQ100/USD," 388,52 ",0.518001,"(91,48)"," 9.924,33 "," 404,49 ",2806975793,CFD," 0,00 "
11/09/2024 15:38:44,Open Position,NSDQ100/USD," 400,00 ",0.427586," 0,00 "," 9.924,33 "," 4,49 ",2807066838,CFD," 0,00 "
11/09/2024 15:39:14,Position closed,NSDQ100/USD," 308,87 ",0.420737,"(81,12)"," 9.843,21 "," 313,36 ",2806976463,CFD," 0,00 "
11/09/2024 15:39:23,Position closed,NSDQ100/USD," 329,99 ",0.430794,"(70,00)"," 9.773,21 "," 643,35 ",2806986110,CFD," 0,00 "
11/09/2024 15:39:32,Open Position,NSDQ100/USD," 599,99 ",0.640664," 0,00 "," 9.773,21 "," 43,36 ",2807067505,CFD," 0,00 "
11/09/2024 15:40:10,Position closed,NSDQ100/USD," 535,93 ",0.535726," 35,94 "," 9.809,15 "," 579,29 ",2807060662,CFD," 0,00 "
11/09/2024 15:40:43,Position closed,NSDQ100/USD," 531,04 ",0.535364," 31,05 "," 9.840,20 "," 1.110,33 ",2807065454,CFD," 0,00 "
11/09/2024 15:40:56,Position closed,NSDQ100/USD," 626,84 ",0.642149," 26,84 "," 9.867,04 "," 1.737,17 ",2807062598,CFD," 0,00 "
11/09/2024 15:41:41,Position closed,NSDQ100/USD," 589,23 ",0.640664,"(10,76)"," 9.856,28 "," 2.326,40 ",2807067505,CFD," 0,00 "
11/09/2024 15:42:44,Position closed,NSDQ100/USD," 604,60 ",0.639974," 4,60 "," 9.860,88 "," 2.931,00 ",2806913702,CFD," 0,00 "
11/09/2024 15:43:30,Position closed,NSDQ100/USD," 1.050,00 ",1.068989," 50,01 "," 9.910,89 "," 3.981,00 ",2806920349,CFD," 0,00 "
11/09/2024 15:44:28,Position closed,NSDQ100/USD," 502,54 ",0.532970," 2,55 "," 9.913,44 "," 4.483,54 ",2806911112,CFD," 0,00 "
11/09/2024 15:46:24,Position closed,NSDQ100/USD," 505,72 ",0.532604," 5,74 "," 9.919,18 "," 4.989,26 ",2806897846,CFD," 0,00 "
11/09/2024 15:48:27,Position closed,NSDQ100/USD," 449,58 ",0.428555," 49,58 "," 9.968,76 "," 5.438,84 ",2807061803,CFD," 0,00 "
11/09/2024 15:50:15,Position closed,NSDQ100/USD," 357,02 ",0.423876,"(42,97)"," 9.925,79 "," 5.795,86 ",2806788759,CFD," 0,00 "
11/09/2024 15:50:15,Position closed,NSDQ100/USD," 436,32 ",0.529391,"(63,67)"," 9.862,12 "," 6.232,18 ",2806785903,CFD," 0,00 "
11/09/2024 15:50:15,Position closed,NSDQ100/USD," 437,00 ",0.529427,"(62,99)"," 9.799,13 "," 6.669,18 ",2806785788,CFD," 0,00 "
11/09/2024 15:50:15,Position closed,NSDQ100/USD," 437,90 ",0.529475,"(62,09)"," 9.737,04 "," 7.107,08 ",2806788419,CFD," 0,00 "
11/09/2024 15:50:15,Position closed,NSDQ100/USD," 566,02 ",0.627407,"(23,98)"," 9.713,06 "," 7.673,10 ",2806845953,CFD," 0,00 "
11/09/2024 15:50:15,Position closed,NSDQ100/USD," 441,91 ",0.519556,"(48,07)"," 9.664,99 "," 8.115,01 ",2806824734,CFD," 0,00 "
11/09/2024 15:50:15,Position closed,NSDQ100/USD," 258,20 ",0.297197,"(21,79)"," 9.643,20 "," 8.373,21 ",2806827859,CFD," 0,00 "
11/09/2024 15:50:15,Position closed,NSDQ100/USD," 333,89 ",0.392336,"(36,11)"," 9.607,09 "," 8.707,10 ",2806827250,CFD," 0,00 "
11/09/2024 15:50:15,Position closed,NSDQ100/USD," 538,01 ",0.534809," 38,02 "," 9.645,11 "," 9.245,11 ",2807066365,CFD," 0,00 "
11/09/2024 15:50:16,Position closed,NSDQ100/USD," 425,52 ",0.427586," 25,52 "," 9.670,63 "," 9.670,63 ",2807066838,CFD," 0,00 "
11/09/2024 15:50:39,Open Position,NSDQ100/USD," 550,00 ",0.532809," 0,00 "," 9.670,63 "," 9.170,63 ",2807082596,CFD," 0,00 "
11/09/2024 15:51:00,Open Position,NSDQ100/USD," 1.100,00 ",1.065454," 0,00 "," 9.670,63 "," 8.170,63 ",2807082771,CFD," 0,00 "
11/09/2024 15:51:20,Open Position,NSDQ100/USD," 1.100,00 ",1.065454," 0,00 "," 9.670,63 "," 7.170,63 ",2807083046,CFD," 0,00 "
11/09/2024 15:51:34,Open Position,NSDQ100/USD," 2.200,97 ",2.131521," 0,00 "," 9.670,63 "," 5.170,64 ",2807083144,CFD," 0,00 "
11/09/2024 16:27:47,Open Position,NSDQ100/USD," 1.299,99 ",1.377605," 0,00 "," 9.670,63 "," 3.870,65 ",2807111984,CFD," 0,00 "
11/09/2024 16:29:06,Open Position,NSDQ100/USD," 1.499,99 ",1.588543," 0,00 "," 9.670,63 "," 2.370,66 ",2807112717,CFD," 0,00 "
11/09/2024 16:30:18,Open Position,NSDQ100/USD," 599,99 ",0.635060," 0,00 "," 9.670,63 "," 1.770,67 ",2807113339,CFD," 0,00 "
11/09/2024 16:31:51,Open Position,NSDQ100/USD," 500,00 ",0.529430," 0,00 "," 9.670,63 "," 1.270,67 ",2807114569,CFD," 0,00 "
11/09/2024 16:32:04,Open Position,NSDQ100/USD," 500,00 ",0.529491," 0,00 "," 9.670,63 "," 770,67 ",2807114697,CFD," 0,00 "
11/09/2024 17:10:16,Open Position,NSDQ100/USD," 500,00 ",0.528169," 0,00 "," 9.670,63 "," 270,67 ",2807136006,CFD," 0,00 "
11/09/2024 18:25:02,Deposit,4500.00 USDRON CreditCard," 968,94 ",-," 968,94 "," 10.639,57 "," 1.239,61 ",-,-," 0,00 "
11/09/2024 18:25:02,Deposit Conversion Fee,-,"(29,01)",-," 0,00 "," 10.639,57 "," 1.239,61 ",-,-," 0,00 "
11/09/2024 18:25:35,Open Position,NSDQ100/USD," 700,00 ",0.735389," 0,00 "," 10.639,57 "," 539,61 ",2807194344,CFD," 0,00 "
11/09/2024 18:26:06,Edit Stop Loss,-,"(100,00)",-," 0,00 "," 10.639,57 "," 439,61 ",2807082771,-," 0,00 "
11/09/2024 18:26:17,Edit Stop Loss,-,"(50,00)",-," 0,00 "," 10.639,57 "," 389,61 ",2807082596,-," 0,00 "
11/09/2024 18:26:31,Edit Stop Loss,-,"(100,00)",-," 0,00 "," 10.639,57 "," 289,61 ",2807083046,-," 0,00 "
11/09/2024 18:27:14,Edit Stop Loss,-,"(99,99)",-," 0,00 "," 10.639,57 "," 189,62 ",2807083144,-," 0,00 "
11/09/2024 18:57:53,Edit Stop Loss,-,"(100,99)",-," 0,00 "," 10.639,57 "," 88,63 ",2807083144,-," 0,00 "
11/09/2024 19:44:34,Open Position,NSDQ100/USD," 50,00 ",0.052189," 0,00 "," 10.639,57 "," 38,63 ",2807242298,CFD," 0,00 "
11/09/2024 20:40:03,Position closed,NSDQ100/USD," 53,32 ",0.052189," 3,32 "," 10.642,89 "," 91,95 ",2807242298,CFD," 0,00 "
12/09/2024 00:48:49,Overnight refund,Daily," 0,23 ",-," 0,23 "," 10.643,12 "," 92,18 ",2807083144,CFD," 0,00 "
12/09/2024 00:48:49,Overnight refund,Daily," 0,17 ",-," 0,17 "," 10.643,29 "," 92,35 ",2807112717,CFD," 0,00 "
12/09/2024 00:48:49,Overnight refund,Daily," 0,15 ",-," 0,15 "," 10.643,44 "," 92,50 ",2807111984,CFD," 0,00 "
12/09/2024 00:48:49,Overnight refund,Daily," 0,11 ",-," 0,11 "," 10.643,55 "," 92,61 ",2807082771,CFD," 0,00 "
12/09/2024 00:48:49,Overnight refund,Daily," 0,11 ",-," 0,11 "," 10.643,66 "," 92,72 ",2807083046,CFD," 0,00 "
12/09/2024 00:48:49,Overnight refund,Daily," 0,08 ",-," 0,08 "," 10.643,74 "," 92,80 ",2807194344,CFD," 0,00 "
12/09/2024 00:48:49,Overnight refund,Daily," 0,07 ",-," 0,07 "," 10.643,81 "," 92,87 ",2807113339,CFD," 0,00 "
12/09/2024 00:48:49,Overnight refund,Daily," 0,06 ",-," 0,06 "," 10.643,87 "," 92,93 ",2807136006,CFD," 0,00 "
12/09/2024 00:48:49,Overnight refund,Daily," 0,06 ",-," 0,06 "," 10.643,93 "," 92,99 ",2807114569,CFD," 0,00 "
12/09/2024 00:48:49,Overnight refund,Daily," 0,06 ",-," 0,06 "," 10.643,99 "," 93,05 ",2807082596,CFD," 0,00 "
12/09/2024 00:48:49,Overnight refund,Daily," 0,06 ",-," 0,06 "," 10.644,05 "," 93,11 ",2807114697,CFD," 0,00 "
12/09/2024 01:09:06,Index price adjustment,NSDQ100/USD,"(0,25)",-,"(0,25)"," 10.643,80 "," 92,86 ",2807082596,CFD," 0,00 "
12/09/2024 01:09:06,Index price adjustment,NSDQ100/USD,"(0,50)",-,"(0,50)"," 10.643,30 "," 92,36 ",2807082771,CFD," 0,00 "
12/09/2024 01:09:06,Index price adjustment,NSDQ100/USD,"(0,50)",-,"(0,50)"," 10.642,80 "," 91,86 ",2807083046,CFD," 0,00 "
12/09/2024 01:09:06,Index price adjustment,NSDQ100/USD,"(1,00)",-,"(1,00)"," 10.641,80 "," 90,86 ",2807083144,CFD," 0,00 "
12/09/2024 01:09:06,Index price adjustment,NSDQ100/USD,"(0,64)",-,"(0,64)"," 10.641,16 "," 90,22 ",2807111984,CFD," 0,00 "
12/09/2024 01:09:06,Index price adjustment,NSDQ100/USD,"(0,74)",-,"(0,74)"," 10.640,42 "," 89,48 ",2807112717,CFD," 0,00 "
12/09/2024 01:09:06,Index price adjustment,NSDQ100/USD,"(0,30)",-,"(0,30)"," 10.640,12 "," 89,18 ",2807113339,CFD," 0,00 "
12/09/2024 01:09:06,Index price adjustment,NSDQ100/USD,"(0,25)",-,"(0,25)"," 10.639,87 "," 88,93 ",2807114569,CFD," 0,00 "
12/09/2024 01:09:06,Index price adjustment,NSDQ100/USD,"(0,25)",-,"(0,25)"," 10.639,62 "," 88,68 ",2807114697,CFD," 0,00 "
12/09/2024 01:09:06,Index price adjustment,NSDQ100/USD,"(0,25)",-,"(0,25)"," 10.639,37 "," 88,43 ",2807136006,CFD," 0,00 "
12/09/2024 01:09:06,Index price adjustment,NSDQ100/USD,"(0,34)",-,"(0,34)"," 10.639,03 "," 88,09 ",2807194344,CFD," 0,00 "
12/09/2024 01:09:06,Index price adjustment,NSDQ100/USD," 0,02 ",-," 0,02 "," 10.639,05 "," 88,11 ",2807242298,CFD," 0,00 "
12/09/2024 06:02:08,Position closed,NSDQ100/USD," 541,92 ",1.065454,"(558,08)"," 10.080,97 "," 630,03 ",2807082771,CFD," 0,00 "
12/09/2024 06:03:55,Position closed,NSDQ100/USD," 265,26 ",0.532809,"(284,74)"," 9.796,23 "," 895,29 ",2807082596,CFD," 0,00 "
12/09/2024 06:05:21,Position closed,NSDQ100/USD," 1.048,01 ",2.131521,"(1.152,96)"," 8.643,27 "," 1.943,30 ",2807083144,CFD," 0,00 "
12/09/2024 06:05:28,Position closed,NSDQ100/USD," 530,40 ",1.065454,"(569,60)"," 8.073,67 "," 2.473,70 ",2807083046,CFD," 0,00 "
12/09/2024 06:05:39,Position closed,NSDQ100/USD," 701,39 ",1.377605,"(598,60)"," 7.475,07 "," 3.175,09 ",2807111984,CFD," 0,00 "
12/09/2024 06:06:29,Withdraw Fee,-,"(5,00)",-,"(5,00)"," 7.470,07 "," 3.170,09 ",-,-," 0,00 "
12/09/2024 06:06:29,Withdraw Request,-,"(995,00)",-,"(995,00)"," 6.475,07 "," 2.175,09 ",-,-," 0,00 "
12/09/2024 06:06:29,Withdrawal Conversion Fee,-," 0,00 ",-," 0,00 "," 6.475,07 "," 2.175,09 ",-,-," 0,00 "
12/09/2024 06:08:10,Position closed,NSDQ100/USD," 502,45 ",0.735389,"(197,55)"," 6.277,52 "," 2.677,54 ",2807194344,CFD," 0,00 "
12/09/2024 06:08:24,Position closed,NSDQ100/USD," 829,75 ",1.588543,"(670,24)"," 5.607,28 "," 3.507,29 ",2807112717,CFD," 0,00 "
12/09/2024 06:09:36,Withdraw Fee,-,"(5,00)",-,"(5,00)"," 5.602,28 "," 3.502,29 ",-,-," 0,00 "
12/09/2024 06:09:36,Withdraw Request,-,"(995,00)",-,"(995,00)"," 4.607,28 "," 2.507,29 ",-,-," 0,00 "
12/09/2024 06:09:36,Withdrawal Conversion Fee,-,"(13,38)",-," 0,00 "," 4.607,28 "," 2.507,29 ",-,-," 0,00 "
12/09/2024 06:10:16,Position closed,NSDQ100/USD," 273,29 ",0.529430,"(226,71)"," 4.380,57 "," 2.780,58 ",2807114569,CFD," 0,00 "
12/09/2024 06:10:16,Position closed,NSDQ100/USD," 297,65 ",0.528169,"(202,35)"," 4.178,22 "," 3.078,23 ",2807136006,CFD," 0,00 "
12/09/2024 06:10:16,Position closed,NSDQ100/USD," 272,10 ",0.529491,"(227,90)"," 3.950,32 "," 3.350,33 ",2807114697,CFD," 0,00 "
12/09/2024 06:10:16,Position closed,NSDQ100/USD," 332,87 ",0.635060,"(267,12)"," 3.683,20 "," 3.683,20 ",2807113339,CFD," 0,00 "
12/09/2024 06:10:53,Withdraw Fee,-,"(5,00)",-,"(5,00)"," 3.678,20 "," 3.678,20 ",-,-," 0,00 "
12/09/2024 06:10:53,Withdraw Request,-,"(995,00)",-,"(995,00)"," 2.683,20 "," 2.683,20 ",-,-," 0,00 "
12/09/2024 06:10:53,Withdrawal Conversion Fee,-,"(13,38)",-," 0,00 "," 2.683,20 "," 2.683,20 ",-,-," 0,00 "
12/09/2024 06:12:08,Open Position,NSDQ100/USD," 999,99 ",1.035429," 0,00 "," 2.683,20 "," 1.683,21 ",2807290845,CFD," 0,00 "
12/09/2024 06:24:39,Open Position,NSDQ100/USD," 499,99 ",0.518332," 0,00 "," 2.683,20 "," 1.183,22 ",2807293852,CFD," 0,00 "
12/09/2024 07:29:44,Position closed,NSDQ100/USD," 506,58 ",0.518332," 6,59 "," 2.689,79 "," 1.689,80 ",2807293852,CFD," 0,00 "
12/09/2024 07:30:05,Position closed,NSDQ100/USD," 993,98 ",1.035429,"(6,01)"," 2.683,78 "," 2.683,78 ",2807290845,CFD," 0,00 "
12/09/2024 07:51:38,Open Position,NSDQ100/USD," 999,99 ",1.037950," 0,00 "," 2.683,78 "," 1.683,79 ",2807338284,CFD," 0,00 "
12/09/2024 08:11:08,Open Position,NSDQ100/USD," 199,99 ",0.207745," 0,00 "," 2.683,78 "," 1.483,80 ",2807344350,CFD," 0,00 "
12/09/2024 08:36:36,Position closed,NSDQ100/USD," 204,02 ",0.207745," 4,03 "," 2.687,81 "," 1.687,82 ",2807344350,CFD," 0,00 "
12/09/2024 08:36:36,Position closed,NSDQ100/USD," 1.004,77 ",1.037950," 4,78 "," 2.692,59 "," 2.692,59 ",2807338284,CFD," 0,00 "
12/09/2024 08:41:03,Open Position,NSDQ100/USD," 499,99 ",0.518757," 0,00 "," 2.692,59 "," 2.192,60 ",2807353134,CFD," 0,00 "
12/09/2024 08:45:01,Position closed,NSDQ100/USD," 503,94 ",0.518757," 3,95 "," 2.696,54 "," 2.696,54 ",2807353134,CFD," 0,00 "
12/09/2024 08:45:19,Open Position,NSDQ100/USD," 499,98 ",0.518412," 0,00 "," 2.696,54 "," 2.196,56 ",2807353789,CFD," 0,00 "
12/09/2024 09:21:04,Position closed,NSDQ100/USD," 503,61 ",0.518412," 3,63 "," 2.700,17 "," 2.700,17 ",2807353789,CFD," 0,00 "
12/09/2024 09:33:32,Open Position,NSDQ100/USD," 799,99 ",0.829314," 0,00 "," 2.700,17 "," 1.900,18 ",2807361938,CFD," 0,00 "
12/09/2024 09:39:39,Position closed,NSDQ100/USD," 803,90 ",0.829314," 3,91 "," 2.704,08 "," 2.704,08 ",2807361938,CFD," 0,00 "
12/09/2024 09:40:19,Open Position,NSDQ100/USD," 999,99 ",1.036799," 0,00 "," 2.704,08 "," 1.704,09 ",2807363354,CFD," 0,00 "
12/09/2024 09:47:17,Open Position,NSDQ100/USD," 430,00 ",0.446214," 0,00 "," 2.704,08 "," 1.274,09 ",2807364302,CFD," 0,00 "
12/09/2024 09:48:06,Position closed,NSDQ100/USD," 430,72 ",0.446214," 0,72 "," 2.704,80 "," 1.704,81 ",2807364302,CFD," 0,00 "
12/09/2024 09:48:22,Open Position,NSDQ100/USD," 430,00 ",0.446417," 0,00 "," 2.704,80 "," 1.274,81 ",2807364489,CFD," 0,00 "
12/09/2024 09:48:54,Open Position,NSDQ100/USD," 499,99 ",0.518910," 0,00 "," 2.704,80 "," 774,82 ",2807364599,CFD," 0,00 "
12/09/2024 09:59:32,Position closed,NSDQ100/USD," 427,78 ",0.446417,"(2,22)"," 2.702,58 "," 1.202,60 ",2807364489,CFD," 0,00 "
12/09/2024 09:59:41,Open Position,NSDQ100/USD," 499,99 ",0.518891," 0,00 "," 2.702,58 "," 702,61 ",2807366422,CFD," 0,00 "
12/09/2024 10:05:25,Open Position,NSDQ100/USD," 300,00 ",0.311383," 0,00 "," 2.702,58 "," 402,61 ",2807367194,CFD," 0,00 "
12/09/2024 10:11:06,Position closed,NSDQ100/USD," 302,15 ",0.311383," 2,15 "," 2.704,73 "," 704,76 ",2807367194,CFD," 0,00 "
12/09/2024 10:11:13,Position closed,NSDQ100/USD," 502,38 ",0.518910," 2,39 "," 2.707,12 "," 1.207,14 ",2807364599,CFD," 0,00 "
12/09/2024 10:11:26,Position closed,NSDQ100/USD," 501,66 ",0.518891," 1,67 "," 2.708,79 "," 1.708,80 ",2807366422,CFD," 0,00 "
12/09/2024 10:11:51,Open Position,NSDQ100/USD," 429,99 ",0.446038," 0,00 "," 2.708,79 "," 1.278,81 ",2807368236,CFD," 0,00 "
12/09/2024 10:16:41,Open Position,NSDQ100/USD," 499,99 ",0.519077," 0,00 "," 2.708,79 "," 778,82 ",2807368829,CFD," 0,00 "
12/09/2024 10:23:23,Open Position,NSDQ100/USD," 300,00 ",0.311483," 0,00 "," 2.708,79 "," 478,82 ",2807369959,CFD," 0,00 "
12/09/2024 11:38:41,Open Position,NSDQ100/USD," 399,99 ",0.415373," 0,00 "," 2.708,79 "," 78,83 ",2807382017,CFD," 0,00 "
12/09/2024 11:39:27,Position closed,NSDQ100/USD," 299,04 ",0.311483,"(0,96)"," 2.707,83 "," 377,87 ",2807369959,CFD," 0,00 "
12/09/2024 11:48:58,Position closed,NSDQ100/USD," 501,08 ",0.519077," 1,09 "," 2.708,92 "," 878,95 ",2807368829,CFD," 0,00 "
12/09/2024 11:55:29,Open Position,NSDQ100/USD," 220,00 ",0.228309," 0,00 "," 2.708,92 "," 658,95 ",2807384634,CFD," 0,00 "
12/09/2024 12:01:39,Open Position,NSDQ100/USD," 499,99 ",0.518714," 0,00 "," 2.708,92 "," 158,96 ",2807386987,CFD," 0,00 "
12/09/2024 12:02:06,Position closed,NSDQ100/USD," 218,34 ",0.228309,"(1,66)"," 2.707,26 "," 377,30 ",2807384634,CFD," 0,00 "
12/09/2024 12:02:15,Open Position,NSDQ100/USD," 300,00 ",0.311220," 0,00 "," 2.707,26 "," 77,30 ",2807387250,CFD," 0,00 "
12/09/2024 12:17:27,Position closed,NSDQ100/USD," 499,89 ",0.518714,"(0,10)"," 2.707,16 "," 577,19 ",2807386987,CFD," 0,00 "
12/09/2024 12:17:39,Position closed,NSDQ100/USD," 301,25 ",0.311220," 1,25 "," 2.708,41 "," 878,44 ",2807387250,CFD," 0,00 "
12/09/2024 12:21:22,Position closed,NSDQ100/USD," 434,45 ",0.446038," 4,46 "," 2.712,87 "," 1.312,89 ",2807368236,CFD," 0,00 "
12/09/2024 12:21:41,Position closed,NSDQ100/USD," 1.000,21 ",1.036799," 0,22 "," 2.713,09 "," 2.313,10 ",2807363354,CFD," 0,00 "
12/09/2024 12:27:04,Position closed,NSDQ100/USD," 387,54 ",0.415373,"(12,45)"," 2.700,64 "," 2.700,64 ",2807382017,CFD," 0,00 "
12/09/2024 12:27:49,Open Position,NSDQ100/USD," 150,00 ",0.155570," 0,00 "," 2.700,64 "," 2.550,64 ",2807392562,CFD," 0,00 "
12/09/2024 12:42:07,Position closed,NSDQ100/USD," 156,10 ",0.155570," 6,10 "," 2.706,74 "," 2.706,74 ",2807392562,CFD," 0,00 "
12/09/2024 12:42:56,Open Position,NSDQ100/USD," 149,99 ",0.155914," 0,00 "," 2.706,74 "," 2.556,75 ",2807400038,CFD," 0,00 "
12/09/2024 12:43:42,Position closed,NSDQ100/USD," 147,81 ",0.155914,"(2,18)"," 2.704,56 "," 2.704,56 ",2807400038,CFD," 0,00 "
12/09/2024 12:43:56,Open Position,NSDQ100/USD," 280,00 ",0.290801," 0,00 "," 2.704,56 "," 2.424,56 ",2807400329,CFD," 0,00 "
12/09/2024 12:44:46,Position closed,NSDQ100/USD," 281,08 ",0.290801," 1,08 "," 2.705,64 "," 2.705,64 ",2807400329,CFD," 0,00 "
12/09/2024 12:54:59,Open Position,NSDQ100/USD," 399,99 ",0.415719," 0,00 "," 2.705,64 "," 2.305,65 ",2807404778,CFD," 0,00 "
12/09/2024 13:08:48,Position closed,NSDQ100/USD," 401,45 ",0.415719," 1,46 "," 2.707,10 "," 2.707,10 ",2807404778,CFD," 0,00 "
12/09/2024 13:09:27,Open Position,NSDQ100/USD," 499,99 ",0.519360," 0,00 "," 2.707,10 "," 2.207,11 ",2807412454,CFD," 0,00 "
12/09/2024 13:21:24,Open Position,NSDQ100/USD," 560,00 ",0.582019," 0,00 "," 2.707,10 "," 1.647,11 ",2807417150,CFD," 0,00 "
12/09/2024 13:30:48,Open Position,NSDQ100/USD," 99,99 ",0.104074," 0,00 "," 2.707,10 "," 1.547,12 ",2807461869,CFD," 0,00 "
12/09/2024 13:30:57,Open Position,NSDQ100/USD," 99,98 ",0.104085," 0,00 "," 2.707,10 "," 1.447,14 ",2807463225,CFD," 0,00 "
12/09/2024 13:32:09,Open Position,NSDQ100/USD," 370,00 ",0.385304," 0,00 "," 2.707,10 "," 1.077,14 ",2807466841,CFD," 0,00 "
12/09/2024 13:32:35,Open Position,NSDQ100/USD," 300,00 ",0.312561," 0,00 "," 2.707,10 "," 777,14 ",2807467489,CFD," 0,00 "
12/09/2024 13:33:13,Position closed,NSDQ100/USD," 290,82 ",0.312561,"(9,18)"," 2.697,92 "," 1.067,96 ",2807467489,CFD," 0,00 "
12/09/2024 13:33:17,Position closed,NSDQ100/USD," 375,94 ",0.385304," 5,94 "," 2.703,86 "," 1.443,90 ",2807466841,CFD," 0,00 "
12/09/2024 13:33:21,Position closed,NSDQ100/USD," 101,07 ",0.104085," 1,09 "," 2.704,95 "," 1.544,97 ",2807463225,CFD," 0,00 "
12/09/2024 13:33:39,Position closed,NSDQ100/USD," 102,19 ",0.104074," 2,20 "," 2.707,15 "," 1.647,16 ",2807461869,CFD," 0,00 "
12/09/2024 13:34:32,Position closed,NSDQ100/USD," 563,29 ",0.582019," 3,29 "," 2.710,44 "," 2.210,45 ",2807417150,CFD," 0,00 "
12/09/2024 13:34:40,Position closed,NSDQ100/USD," 499,61 ",0.519360,"(0,38)"," 2.710,06 "," 2.710,06 ",2807412454,CFD," 0,00 "
12/09/2024 13:35:49,Open Position,NSDQ100/USD," 279,99 ",0.291332," 0,00 "," 2.710,06 "," 2.430,07 ",2807473769,CFD," 0,00 "
12/09/2024 13:36:14,Position closed,NSDQ100/USD," 281,22 ",0.291332," 1,23 "," 2.711,29 "," 2.711,29 ",2807473769,CFD," 0,00 "
12/09/2024 13:36:29,Open Position,NSDQ100/USD," 279,99 ",0.291319," 0,00 "," 2.711,29 "," 2.431,30 ",2807475057,CFD," 0,00 "
12/09/2024 13:36:47,Position closed,NSDQ100/USD," 282,36 ",0.291319," 2,37 "," 2.713,66 "," 2.713,66 ",2807475057,CFD," 0,00 "
12/09/2024 13:37:33,Open Position,NSDQ100/USD," 279,99 ",0.290827," 0,00 "," 2.713,66 "," 2.433,67 ",2807476481,CFD," 0,00 "
12/09/2024 13:37:49,Position closed,NSDQ100/USD," 278,86 ",0.290827,"(1,13)"," 2.712,53 "," 2.712,53 ",2807476481,CFD," 0,00 "
12/09/2024 13:38:07,Open Position,NSDQ100/USD," 279,98 ",0.290679," 0,00 "," 2.712,53 "," 2.432,55 ",2807477291,CFD," 0,00 "
12/09/2024 13:38:52,Position closed,NSDQ100/USD," 277,80 ",0.290679,"(2,18)"," 2.710,35 "," 2.710,35 ",2807477291,CFD," 0,00 "
12/09/2024 13:42:55,Open Position,NSDQ100/USD," 499,99 ",0.519251," 0,00 "," 2.710,35 "," 2.210,36 ",2807484757,CFD," 0,00 "
12/09/2024 13:43:35,Open Position,NSDQ100/USD," 560,00 ",0.582014," 0,00 "," 2.710,35 "," 1.650,36 ",2807487648,CFD," 0,00 "
12/09/2024 13:44:10,Open Position,NSDQ100/USD," 299,99 ",0.311949," 0,00 "," 2.710,35 "," 1.350,37 ",2807488519,CFD," 0,00 "
12/09/2024 13:44:20,Position closed,NSDQ100/USD," 301,46 ",0.311949," 1,47 "," 2.711,82 "," 1.651,83 ",2807488519,CFD," 0,00 "
12/09/2024 13:44:43,Position closed,NSDQ100/USD," 561,81 ",0.582014," 1,81 "," 2.713,63 "," 2.213,64 ",2807487648,CFD," 0,00 "
12/09/2024 13:45:36,Open Position,NSDQ100/USD," 560,00 ",0.582153," 0,00 "," 2.713,63 "," 1.653,64 ",2807492442,CFD," 0,00 "
12/09/2024 13:45:43,Position closed,NSDQ100/USD," 566,18 ",0.582153," 6,18 "," 2.719,81 "," 2.219,82 ",2807492442,CFD," 0,00 "
12/09/2024 13:46:18,Open Position,NSDQ100/USD," 560,00 ",0.582265," 0,00 "," 2.719,81 "," 1.659,82 ",2807493984,CFD," 0,00 "
12/09/2024 13:46:36,Open Position,NSDQ100/USD," 420,00 ",0.436745," 0,00 "," 2.719,81 "," 1.239,82 ",2807494535,CFD," 0,00 "
12/09/2024 13:49:03,Open Position,NSDQ100/USD," 309,99 ",0.322757," 0,00 "," 2.719,81 "," 929,83 ",2807498629,CFD," 0,00 "
12/09/2024 13:50:42,Open Position,NSDQ100/USD," 239,99 ",0.250442," 0,00 "," 2.719,81 "," 689,84 ",2807501570,CFD," 0,00 "
12/09/2024 13:53:12,Position closed,NSDQ100/USD," 312,35 ",0.322757," 2,36 "," 2.722,17 "," 1.002,19 ",2807498629,CFD," 0,00 "
12/09/2024 13:54:48,Position closed,NSDQ100/USD," 421,58 ",0.436745," 1,58 "," 2.723,75 "," 1.423,77 ",2807494535,CFD," 0,00 "
12/09/2024 13:56:07,Open Position,NSDQ100/USD," 359,99 ",0.374769," 0,00 "," 2.723,75 "," 1.063,78 ",2807540429,CFD," 0,00 "
12/09/2024 13:57:05,Position closed,NSDQ100/USD," 361,80 ",0.374769," 1,81 "," 2.725,56 "," 1.425,58 ",2807540429,CFD," 0,00 "
12/09/2024 13:57:45,Position closed,NSDQ100/USD," 230,75 ",0.250442,"(9,24)"," 2.716,32 "," 1.656,33 ",2807501570,CFD," 0,00 "
12/09/2024 13:57:53,Open Position,NSDQ100/USD," 420,00 ",0.437420," 0,00 "," 2.716,32 "," 1.236,33 ",2807543398,CFD," 0,00 "
12/09/2024 13:58:28,Position closed,NSDQ100/USD," 422,11 ",0.437420," 2,11 "," 2.718,43 "," 1.658,44 ",2807543398,CFD," 0,00 "
12/09/2024 14:00:10,Position closed,NSDQ100/USD," 560,01 ",0.582265," 0,01 "," 2.718,44 "," 2.218,45 ",2807493984,CFD," 0,00 "
12/09/2024 14:04:09,Open Position,NSDQ100/USD," 560,00 ",0.582381," 0,00 "," 2.718,44 "," 1.658,45 ",2807555302,CFD," 0,00 "
12/09/2024 14:05:37,Open Position,NSDQ100/USD," 420,00 ",0.437165," 0,00 "," 2.718,44 "," 1.238,45 ",2807559304,CFD," 0,00 "
12/09/2024 14:06:07,Position closed,NSDQ100/USD," 428,58 ",0.437165," 8,58 "," 2.727,02 "," 1.667,03 ",2807559304,CFD," 0,00 "
12/09/2024 14:08:42,Open Position,NSDQ100/USD," 420,00 ",0.437233," 0,00 "," 2.727,02 "," 1.247,03 ",2807563349,CFD," 0,00 "
12/09/2024 14:09:09,Position closed,NSDQ100/USD," 422,46 ",0.437233," 2,46 "," 2.729,48 "," 1.669,49 ",2807563349,CFD," 0,00 "
12/09/2024 14:09:49,Open Position,NSDQ100/USD," 420,00 ",0.437165," 0,00 "," 2.729,48 "," 1.249,49 ",2807564657,CFD," 0,00 "
12/09/2024 14:10:03,Position closed,NSDQ100/USD," 422,24 ",0.437165," 2,24 "," 2.731,72 "," 1.671,73 ",2807564657,CFD," 0,00 "
12/09/2024 14:10:39,Position closed,NSDQ100/USD," 560,94 ",0.582381," 0,94 "," 2.732,66 "," 2.232,67 ",2807555302,CFD," 0,00 "
12/09/2024 14:11:22,Position closed,NSDQ100/USD," 492,73 ",0.519251,"(7,26)"," 2.725,40 "," 2.725,40 ",2807484757,CFD," 0,00 "
12/09/2024 14:12:07,Open Position,NSDQ100/USD," 99,99 ",0.103914," 0,00 "," 2.725,40 "," 2.625,41 ",2807567073,CFD," 0,00 "
12/09/2024 14:12:23,Position closed,NSDQ100/USD," 101,48 ",0.103914," 1,49 "," 2.726,89 "," 2.726,89 ",2807567073,CFD," 0,00 "
12/09/2024 14:12:59,Open Position,NSDQ100/USD," 279,99 ",0.290563," 0,00 "," 2.726,89 "," 2.446,90 ",2807568007,CFD," 0,00 "
12/09/2024 14:13:40,Position closed,NSDQ100/USD," 281,68 ",0.290563," 1,69 "," 2.728,58 "," 2.728,58 ",2807568007,CFD," 0,00 "
12/09/2024 14:14:01,Open Position,NSDQ100/USD," 499,98 ",0.518403," 0,00 "," 2.728,58 "," 2.228,60 ",2807569376,CFD," 0,00 "
12/09/2024 14:14:08,Position closed,NSDQ100/USD," 500,24 ",0.518403," 0,26 "," 2.728,84 "," 2.728,84 ",2807569376,CFD," 0,00 "
12/09/2024 14:15:34,Open Position,NSDQ100/USD," 279,99 ",0.290483," 0,00 "," 2.728,84 "," 2.448,85 ",2807589455,CFD," 0,00 "
12/09/2024 14:15:45,Position closed,NSDQ100/USD," 282,26 ",0.290483," 2,27 "," 2.731,11 "," 2.731,11 ",2807589455,CFD," 0,00 "
12/09/2024 14:17:15,Open Position,NSDQ100/USD," 279,99 ",0.290224," 0,00 "," 2.731,11 "," 2.451,12 ",2807591327,CFD," 0,00 "
12/09/2024 14:17:38,Position closed,NSDQ100/USD," 283,45 ",0.290224," 3,46 "," 2.734,57 "," 2.734,57 ",2807591327,CFD," 0,00 "
12/09/2024 14:18:07,Open Position,NSDQ100/USD," 279,99 ",0.289972," 0,00 "," 2.734,57 "," 2.454,58 ",2807592512,CFD," 0,00 "
12/09/2024 14:19:28,Position closed,NSDQ100/USD," 277,64 ",0.289972,"(2,35)"," 2.732,22 "," 2.732,22 ",2807592512,CFD," 0,00 "
12/09/2024 14:21:16,Open Position,NSDQ100/USD," 299,99 ",0.310727," 0,00 "," 2.732,22 "," 2.432,23 ",2807618052,CFD," 0,00 "
12/09/2024 14:21:27,Position closed,NSDQ100/USD," 300,21 ",0.310727," 0,22 "," 2.732,44 "," 2.732,44 ",2807618052,CFD," 0,00 "
12/09/2024 14:22:22,Open Position,NSDQ100/USD," 499,99 ",0.517780," 0,00 "," 2.732,44 "," 2.232,45 ",2807619498,CFD," 0,00 "
12/09/2024 14:22:53,Position closed,NSDQ100/USD," 501,75 ",0.517780," 1,76 "," 2.734,20 "," 2.734,20 ",2807619498,CFD," 0,00 "
12/09/2024 14:23:57,Open Position,NSDQ100/USD," 600,00 ",0.621304," 0,00 "," 2.734,20 "," 2.134,20 ",2807621708,CFD," 0,00 "
12/09/2024 14:24:29,Position closed,NSDQ100/USD," 593,41 ",0.621304,"(6,59)"," 2.727,61 "," 2.727,61 ",2807621708,CFD," 0,00 "
12/09/2024 14:25:11,Open Position,NSDQ100/USD," 279,99 ",0.290027," 0,00 "," 2.727,61 "," 2.447,62 ",2807623691,CFD," 0,00 "
12/09/2024 14:25:46,Position closed,NSDQ100/USD," 279,18 ",0.290027,"(0,81)"," 2.726,80 "," 2.726,80 ",2807623691,CFD," 0,00 "
12/09/2024 14:28:48,Open Position,NSDQ100/USD," 699,99 ",0.724697," 0,00 "," 2.726,80 "," 2.026,81 ",2807627028,CFD," 0,00 "
12/09/2024 14:30:33,Position closed,NSDQ100/USD," 697,02 ",0.724697,"(2,97)"," 2.723,83 "," 2.723,83 ",2807627028,CFD," 0,00 "
12/09/2024 14:31:41,Open Position,NSDQ100/USD," 499,99 ",0.517743," 0,00 "," 2.723,83 "," 2.223,84 ",2807629503,CFD," 0,00 "
12/09/2024 14:32:03,Position closed,NSDQ100/USD," 502,37 ",0.517743," 2,38 "," 2.726,21 "," 2.726,21 ",2807629503,CFD," 0,00 "
12/09/2024 14:57:26,Open Position,NSDQ100/USD," 499,99 ",0.518478," 0,00 "," 2.726,21 "," 2.226,22 ",2807656171,CFD," 0,00 "
12/09/2024 14:58:09,Position closed,NSDQ100/USD," 499,89 ",0.518478,"(0,10)"," 2.726,11 "," 2.726,11 ",2807656171,CFD," 0,00 "
12/09/2024 15:40:00,Open Position,NSDQ100/USD," 499,99 ",0.519377," 0,00 "," 2.726,11 "," 2.226,12 ",2807695663,CFD," 0,00 "
12/09/2024 15:40:16,Position closed,NSDQ100/USD," 503,01 ",0.519377," 3,02 "," 2.729,13 "," 2.729,13 ",2807695663,CFD," 0,00 "
12/09/2024 15:43:13,Open Position,NSDQ100/USD," 279,99 ",0.290774," 0,00 "," 2.729,13 "," 2.449,14 ",2807697766,CFD," 0,00 "
12/09/2024 15:43:29,Position closed,NSDQ100/USD," 281,94 ",0.290774," 1,95 "," 2.731,08 "," 2.731,08 ",2807697766,CFD," 0,00 "
12/09/2024 15:53:26,Open Position,NSDQ100/USD," 600,00 ",0.623205," 0,00 "," 2.731,08 "," 2.131,08 ",2807703717,CFD," 0,00 "
12/09/2024 16:03:34,Position closed,NSDQ100/USD," 603,43 ",0.623205," 3,43 "," 2.734,51 "," 2.734,51 ",2807703717,CFD," 0,00 "
12/09/2024 16:07:24,Open Position,NSDQ100/USD," 279,99 ",0.290723," 0,00 "," 2.734,51 "," 2.454,52 ",2807711518,CFD," 0,00 "
12/09/2024 16:08:11,Open Position,NSDQ100/USD," 619,98 ",0.644098," 0,00 "," 2.734,51 "," 1.834,54 ",2807711805,CFD," 0,00 "
12/09/2024 16:08:42,Position closed,NSDQ100/USD," 624,30 ",0.644098," 4,32 "," 2.738,83 "," 2.458,84 ",2807711805,CFD," 0,00 "
12/09/2024 16:08:50,Position closed,NSDQ100/USD," 280,37 ",0.290723," 0,38 "," 2.739,21 "," 2.739,21 ",2807711518,CFD," 0,00 "
12/09/2024 16:14:26,Open Position,NSDQ100/USD," 279,99 ",0.290498," 0,00 "," 2.739,21 "," 2.459,22 ",2807714941,CFD," 0,00 "
12/09/2024 16:15:01,Position closed,NSDQ100/USD," 280,52 ",0.290498," 0,53 "," 2.739,74 "," 2.739,74 ",2807714941,CFD," 0,00 "
12/09/2024 16:24:05,Open Position,NSDQ100/USD," 499,99 ",0.518922," 0,00 "," 2.739,74 "," 2.239,75 ",2807728281,CFD," 0,00 "
12/09/2024 16:24:24,Position closed,NSDQ100/USD," 500,62 ",0.518922," 0,63 "," 2.740,37 "," 2.740,37 ",2807728281,CFD," 0,00 "
12/09/2024 16:32:09,Open Position,NSDQ100/USD," 499,99 ",0.518425," 0,00 "," 2.740,37 "," 2.240,38 ",2807732752,CFD," 0,00 "
12/09/2024 16:32:55,Position closed,NSDQ100/USD," 497,61 ",0.518425,"(2,38)"," 2.737,99 "," 2.737,99 ",2807732752,CFD," 0,00 "
12/09/2024 16:36:08,Open Position,NSDQ100/USD," 500,00 ",0.518591," 0,00 "," 2.737,99 "," 2.237,99 ",2807734684,CFD," 0,00 "
12/09/2024 16:37:29,Open Position,NSDQ100/USD," 559,99 ",0.580985," 0,00 "," 2.737,99 "," 1.678,00 ",2807735263,CFD," 0,00 "
12/09/2024 16:38:09,Open Position,NSDQ100/USD," 419,99 ",0.435508," 0,00 "," 2.737,99 "," 1.258,01 ",2807735558,CFD," 0,00 "
12/09/2024 16:39:25,Position closed,NSDQ100/USD," 424,26 ",0.435508," 4,27 "," 2.742,26 "," 1.682,27 ",2807735558,CFD," 0,00 "
12/09/2024 16:39:25,Position closed,NSDQ100/USD," 559,76 ",0.580985,"(0,23)"," 2.742,03 "," 2.242,03 ",2807735263,CFD," 0,00 "
12/09/2024 16:39:25,Position closed,NSDQ100/USD," 502,60 ",0.518591," 2,60 "," 2.744,63 "," 2.744,63 ",2807734684,CFD," 0,00 "
12/09/2024 16:40:52,Open Position,NSDQ100/USD," 700,00 ",0.726728," 0,00 "," 2.744,63 "," 2.044,63 ",2807736645,CFD," 0,00 "
12/09/2024 16:42:06,Open Position,NSDQ100/USD," 510,00 ",0.529001," 0,00 "," 2.744,63 "," 1.534,63 ",2807737103,CFD," 0,00 "
12/09/2024 16:44:12,Position closed,NSDQ100/USD," 511,54 ",0.529001," 1,54 "," 2.746,17 "," 2.046,17 ",2807737103,CFD," 0,00 "
12/09/2024 16:45:13,Open Position,NSDQ100/USD," 510,00 ",0.529018," 0,00 "," 2.746,17 "," 1.536,17 ",2807742533,CFD," 0,00 "
12/09/2024 16:45:57,Open Position,NSDQ100/USD," 389,98 ",0.404407," 0,00 "," 2.746,17 "," 1.146,19 ",2807743231,CFD," 0,00 "
12/09/2024 16:47:36,Position closed,NSDQ100/USD," 389,46 ",0.404407,"(0,52)"," 2.745,65 "," 1.535,65 ",2807743231,CFD," 0,00 "
12/09/2024 16:48:43,Open Position,NSDQ100/USD," 700,00 ",0.725576," 0,00 "," 2.745,65 "," 835,65 ",2807744172,CFD," 0,00 "
12/09/2024 16:50:03,Open Position,NSDQ100/USD," 500,00 ",0.518097," 0,00 "," 2.745,65 "," 335,65 ",2807744759,CFD," 0,00 "
12/09/2024 16:51:48,Open Position,NSDQ100/USD," 300,00 ",0.310626," 0,00 "," 2.745,65 "," 35,65 ",2807745996,CFD," 0,00 "
12/09/2024 17:25:03,Position closed,NSDQ100/USD," 277,01 ",0.310626,"(22,99)"," 2.722,66 "," 312,66 ",2807745996,CFD," 0,00 "
12/09/2024 17:25:11,Position closed,NSDQ100/USD," 456,06 ",0.518097,"(43,94)"," 2.678,72 "," 768,72 ",2807744759,CFD," 0,00 "
12/09/2024 17:25:26,Open Position,NSDQ100/USD," 499,99 ",0.515915," 0,00 "," 2.678,72 "," 268,73 ",2807770134,CFD," 0,00 "
12/09/2024 17:28:59,Position closed,NSDQ100/USD," 502,10 ",0.515915," 2,11 "," 2.680,83 "," 770,83 ",2807770134,CFD," 0,00 "
12/09/2024 17:42:19,Position closed,NSDQ100/USD," 595,87 ",0.726728,"(104,13)"," 2.576,70 "," 1.366,70 ",2807736645,CFD," 0,00 "
12/09/2024 17:42:19,Position closed,NSDQ100/USD," 618,23 ",0.725576,"(81,77)"," 2.494,93 "," 1.984,93 ",2807744172,CFD," 0,00 "
12/09/2024 17:42:19,Position closed,NSDQ100/USD," 442,97 ",0.529018,"(67,03)"," 2.427,90 "," 2.427,90 ",2807742533,CFD," 0,00 "
12/09/2024 17:44:48,Open Position,NSDQ100/USD," 250,00 ",0.257765," 0,00 "," 2.427,90 "," 2.177,90 ",2807788621,CFD," 0,00 "
12/09/2024 17:53:20,Position closed,NSDQ100/USD," 258,55 ",0.257765," 8,55 "," 2.436,45 "," 2.436,45 ",2807788621,CFD," 0,00 "
12/09/2024 17:56:08,Open Position,NSDQ100/USD," 499,99 ",0.514273," 0,00 "," 2.436,45 "," 1.936,46 ",2807797938,CFD," 0,00 "
12/09/2024 18:08:54,Position closed,NSDQ100/USD," 492,57 ",0.514273,"(7,42)"," 2.429,03 "," 2.429,03 ",2807797938,CFD," 0,00 "
12/09/2024 20:16:26,Open Position,NSDQ100/USD," 2.000,00 ",2.062988," 0,00 "," 2.429,03 "," 429,03 ",2807877725,CFD," 0,00 "
12/09/2024 20:20:56,Open Position,NSDQ100/USD," 400,00 ",0.412604," 0,00 "," 2.429,03 "," 29,03 ",2807877982,CFD," 0,00 "
13/09/2024 00:48:37,Overnight refund,Daily," 0,22 ",-," 0,22 "," 2.429,25 "," 29,25 ",2807877725,CFD," 0,00 "
13/09/2024 00:48:37,Overnight refund,Daily," 0,04 ",-," 0,04 "," 2.429,29 "," 29,29 ",2807877982,CFD," 0,00 "
13/09/2024 06:35:38,Position closed,NSDQ100/USD," 1.941,41 ",2.062988,"(58,59)"," 2.370,70 "," 1.970,70 ",2807877725,CFD," 0,00 "
13/09/2024 06:35:45,Position closed,NSDQ100/USD," 388,08 ",0.412604,"(11,92)"," 2.358,78 "," 2.358,78 ",2807877982,CFD," 0,00 "
13/09/2024 06:36:08,Open Position,NSDQ100/USD," 1.699,99 ",1.751038," 0,00 "," 2.358,78 "," 658,79 ",2807913350,CFD," 0,00 "
13/09/2024 06:36:40,Open Position,NSDQ100/USD," 499,99 ",0.514992," 0,00 "," 2.358,78 "," 158,80 ",2807913385,CFD," 0,00 "
13/09/2024 06:49:49,Position closed,NSDQ100/USD," 1.702,95 ",1.751038," 2,96 "," 2.361,74 "," 1.861,75 ",2807913350,CFD," 0,00 "
13/09/2024 06:49:49,Position closed,NSDQ100/USD," 500,50 ",0.514992," 0,51 "," 2.362,25 "," 2.362,25 ",2807913385,CFD," 0,00 "
13/09/2024 06:50:33,Open Position,NSDQ100/USD," 999,99 ",1.029704," 0,00 "," 2.362,25 "," 1.362,26 ",2807914426,CFD," 0,00 "
13/09/2024 07:06:43,Position closed,NSDQ100/USD," 1.010,38 ",1.029704," 10,39 "," 2.372,64 "," 2.372,64 ",2807914426,CFD," 0,00 "
13/09/2024 07:07:15,Open Position,NSDQ100/USD," 999,99 ",1.028803," 0,00 "," 2.372,64 "," 1.372,65 ",2807932946,CFD," 0,00 "
13/09/2024 07:12:17,Open Position,NSDQ100/USD," 350,00 ",0.360077," 0,00 "," 2.372,64 "," 1.022,65 ",2807933730,CFD," 0,00 "
13/09/2024 07:14:09,Open Position,NSDQ100/USD," 260,00 ",0.267572," 0,00 "," 2.372,64 "," 762,65 ",2807933997,CFD," 0,00 "
13/09/2024 07:15:43,Open Position,NSDQ100/USD," 499,99 ",0.514542," 0,00 "," 2.372,64 "," 262,66 ",2807934205,CFD," 0,00 "
13/09/2024 07:23:25,Position closed,NSDQ100/USD," 260,75 ",0.267572," 0,75 "," 2.373,39 "," 523,41 ",2807933997,CFD," 0,00 "
13/09/2024 07:23:32,Position closed,NSDQ100/USD," 500,91 ",0.514542," 0,92 "," 2.374,31 "," 1.024,32 ",2807934205,CFD," 0,00 "
13/09/2024 07:24:13,Position closed,NSDQ100/USD," 1.000,28 ",1.028803," 0,29 "," 2.374,60 "," 2.024,60 ",2807932946,CFD," 0,00 "
13/09/2024 07:24:40,Position closed,NSDQ100/USD," 350,64 ",0.360077," 0,64 "," 2.375,24 "," 2.375,24 ",2807933730,CFD," 0,00 "
13/09/2024 07:27:26,Open Position,NSDQ100/USD," 299,99 ",0.308631," 0,00 "," 2.375,24 "," 2.075,25 ",2807946022,CFD," 0,00 "
13/09/2024 07:29:30,Open Position,NSDQ100/USD," 299,99 ",0.308473," 0,00 "," 2.375,24 "," 1.775,26 ",2807946647,CFD," 0,00 "
13/09/2024 07:30:23,Position closed,NSDQ100/USD," 299,98 ",0.308473,"(0,01)"," 2.375,23 "," 2.075,24 ",2807946647,CFD," 0,00 "
13/09/2024 07:32:02,Position closed,NSDQ100/USD," 300,42 ",0.308631," 0,43 "," 2.375,66 "," 2.375,66 ",2807946022,CFD," 0,00 "
13/09/2024 07:33:19,Open Position,NSDQ100/USD," 399,99 ",0.411627," 0,00 "," 2.375,66 "," 1.975,67 ",2807949577,CFD," 0,00 "
13/09/2024 07:36:33,Position closed,NSDQ100/USD," 400,07 ",0.411627," 0,08 "," 2.375,74 "," 2.375,74 ",2807949577,CFD," 0,00 "
13/09/2024 07:38:57,Open Position,NSDQ100/USD," 499,99 ",0.514414," 0,00 "," 2.375,74 "," 1.875,75 ",2807950460,CFD," 0,00 "
13/09/2024 07:39:11,Open Position,NSDQ100/USD," 999,99 ",1.028798," 0,00 "," 2.375,74 "," 875,76 ",2807950493,CFD," 0,00 "
13/09/2024 07:51:23,Open Position,NSDQ100/USD," 499,99 ",0.514852," 0,00 "," 2.375,74 "," 375,77 ",2807952894,CFD," 0,00 "
13/09/2024 08:07:16,Open Position,NSDQ100/USD," 320,00 ",0.329597," 0,00 "," 2.375,74 "," 55,77 ",2807956831,CFD," 0,00 "
13/09/2024 09:40:41,Position closed,NSDQ100/USD," 505,54 ",0.514414," 5,55 "," 2.381,29 "," 561,31 ",2807950460,CFD," 0,00 "
13/09/2024 09:40:41,Position closed,NSDQ100/USD," 1.010,87 ",1.028798," 10,88 "," 2.392,17 "," 1.572,18 ",2807950493,CFD," 0,00 "
13/09/2024 09:40:42,Position closed,NSDQ100/USD," 514,25 ",0.514852," 14,26 "," 2.406,43 "," 2.086,43 ",2807952894,CFD," 0,00 "
13/09/2024 09:40:42,Position closed,NSDQ100/USD," 331,40 ",0.329597," 11,40 "," 2.417,83 "," 2.417,83 ",2807956831,CFD," 0,00 "
13/09/2024 10:01:12,Open Position,NSDQ100/USD," 300,00 ",0.308706," 0,00 "," 2.417,83 "," 2.117,83 ",2807980067,CFD," 0,00 "
13/09/2024 10:08:56,Position closed,NSDQ100/USD," 302,43 ",0.308706," 2,43 "," 2.420,26 "," 2.420,26 ",2807980067,CFD," 0,00 "
13/09/2024 10:15:15,Open Position,NSDQ100/USD," 300,00 ",0.308563," 0,00 "," 2.420,26 "," 2.120,26 ",2807982285,CFD," 0,00 "
13/09/2024 10:17:09,Open Position,NSDQ100/USD," 300,00 ",0.308583," 0,00 "," 2.420,26 "," 1.820,26 ",2807982545,CFD," 0,00 "
13/09/2024 10:33:40,Open Position,NSDQ100/USD," 300,00 ",0.308536," 0,00 "," 2.420,26 "," 1.520,26 ",2807985171,CFD," 0,00 "
13/09/2024 10:39:54,Open Position,NSDQ100/USD," 300,00 ",0.308647," 0,00 "," 2.420,26 "," 1.220,26 ",2807986097,CFD," 0,00 "
13/09/2024 10:55:44,Position closed,NSDQ100/USD," 300,73 ",0.308647," 0,73 "," 2.420,99 "," 1.520,99 ",2807986097,CFD," 0,00 "
13/09/2024 10:56:23,Position closed,NSDQ100/USD," 298,98 ",0.308583,"(1,02)"," 2.419,97 "," 1.819,97 ",2807982545,CFD," 0,00 "
13/09/2024 11:41:49,Open Position,NSDQ100/USD," 459,99 ",0.473581," 0,00 "," 2.419,97 "," 1.359,98 ",2808000329,CFD," 0,00 "
13/09/2024 13:13:49,Open Position,NSDQ100/USD," 499,99 ",0.515051," 0,00 "," 2.419,97 "," 859,99 ",2808021074,CFD," 0,00 "
13/09/2024 13:22:04,Open Position,NSDQ100/USD," 399,99 ",0.412314," 0,00 "," 2.419,97 "," 460,00 ",2808023026,CFD," 0,00 "
13/09/2024 13:27:11,Open Position,NSDQ100/USD," 199,98 ",0.206048," 0,00 "," 2.419,97 "," 260,02 ",2808025078,CFD," 0,00 "
13/09/2024 13:30:15,Open Position,NSDQ100/USD," 200,00 ",0.206243," 0,00 "," 2.419,97 "," 60,02 ",2808032683,CFD," 0,00 "
13/09/2024 13:37:31,Position closed,NSDQ100/USD," 301,31 ",0.308536," 1,31 "," 2.421,28 "," 361,33 ",2807985171,CFD," 0,00 "
13/09/2024 13:37:31,Position closed,NSDQ100/USD," 301,83 ",0.308563," 1,83 "," 2.423,11 "," 663,16 ",2807982285,CFD," 0,00 "
13/09/2024 13:40:35,Position closed,NSDQ100/USD," 471,52 ",0.473581," 11,53 "," 2.434,64 "," 1.134,68 ",2808000329,CFD," 0,00 "
13/09/2024 13:40:35,Position closed,NSDQ100/USD," 518,19 ",0.515051," 18,20 "," 2.452,84 "," 1.652,87 ",2808021074,CFD," 0,00 "
13/09/2024 13:40:35,Position closed,NSDQ100/USD," 419,84 ",0.412314," 19,85 "," 2.472,69 "," 2.072,71 ",2808023026,CFD," 0,00 "
13/09/2024 13:40:35,Position closed,NSDQ100/USD," 207,98 ",0.206048," 8,00 "," 2.480,69 "," 2.280,69 ",2808025078,CFD," 0,00 "
13/09/2024 13:40:35,Position closed,NSDQ100/USD," 211,71 ",0.206243," 11,71 "," 2.492,40 "," 2.492,40 ",2808032683,CFD," 0,00 "
13/09/2024 13:41:31,Open Position,NSDQ100/USD," 400,00 ",0.411577," 0,00 "," 2.492,40 "," 2.092,40 ",2808099178,CFD," 0,00 "
13/09/2024 13:41:52,Open Position,NSDQ100/USD," 530,00 ",0.545211," 0,00 "," 2.492,40 "," 1.562,40 ",2808099702,CFD," 0,00 "
13/09/2024 13:43:00,Position closed,NSDQ100/USD," 535,17 ",0.545211," 5,17 "," 2.497,57 "," 2.097,57 ",2808099702,CFD," 0,00 "
13/09/2024 13:43:00,Position closed,NSDQ100/USD," 405,80 ",0.411577," 5,80 "," 2.503,37 "," 2.503,37 ",2808099178,CFD," 0,00 "
13/09/2024 13:43:23,Open Position,NSDQ100/USD," 499,99 ",0.514024," 0,00 "," 2.503,37 "," 2.003,38 ",2808101704,CFD," 0,00 "
13/09/2024 13:43:45,Open Position,NSDQ100/USD," 509,99 ",0.523941," 0,00 "," 2.503,37 "," 1.493,39 ",2808102205,CFD," 0,00 "
13/09/2024 13:43:59,Position closed,NSDQ100/USD," 509,46 ",0.523941,"(0,53)"," 2.502,84 "," 2.002,85 ",2808102205,CFD," 0,00 "
13/09/2024 13:44:18,Position closed,NSDQ100/USD," 510,00 ",0.514024," 10,01 "," 2.512,85 "," 2.512,85 ",2808101704,CFD," 0,00 "
13/09/2024 13:44:43,Open Position,NSDQ100/USD," 400,00 ",0.410964," 0,00 "," 2.512,85 "," 2.112,85 ",2808103303,CFD," 0,00 "
13/09/2024 13:45:25,Open Position,NSDQ100/USD," 200,00 ",0.205534," 0,00 "," 2.512,85 "," 1.912,85 ",2808104340,CFD," 0,00 "
13/09/2024 13:45:42,Open Position,NSDQ100/USD," 499,99 ",0.514104," 0,00 "," 2.512,85 "," 1.412,86 ",2808104585,CFD," 0,00 "
13/09/2024 13:47:48,Open Position,NVDA/USD," 249,97 ",10.500822," 0,00 "," 2.512,85 "," 1.162,89 ",2808107155,CFD," 0,00 "
13/09/2024 13:48:18,Open Position,NSDQ100/USD," 149,99 ",0.154095," 0,00 "," 2.512,85 "," 1.012,90 ",2808108438,CFD," 0,00 "
13/09/2024 13:49:57,Open Position,NSDQ100/USD," 299,99 ",0.308405," 0,00 "," 2.512,85 "," 712,91 ",2808110198,CFD," 0,00 "
13/09/2024 14:06:37,Open Position,NVDA/USD," 180,00 ",1.507663," 0,00 "," 2.512,85 "," 532,91 ",2808182843,Stocks," 0,00 "
13/09/2024 14:06:51,Position closed,NVDA/USD," 180,09 ",1.507663," 0,09 "," 2.512,94 "," 713,00 ",2808182843,Stocks," 0,00 "
13/09/2024 14:07:14,Open Position,NVDA/USD," 179,99 ",7.514440," 0,00 "," 2.512,94 "," 533,01 ",2808187473,CFD," 0,00 "
13/09/2024 14:14:03,Position closed,NSDQ100/USD," 302,82 ",0.308405," 2,83 "," 2.515,77 "," 835,83 ",2808110198,CFD," 0,00 "
13/09/2024 14:14:03,Position closed,NSDQ100/USD," 200,55 ",0.205534," 0,55 "," 2.516,32 "," 1.036,38 ",2808104340,CFD," 0,00 "
13/09/2024 14:14:03,Position closed,NSDQ100/USD," 399,05 ",0.410964,"(0,95)"," 2.515,37 "," 1.435,43 ",2808103303,CFD," 0,00 "
13/09/2024 14:14:03,Position closed,NSDQ100/USD," 506,56 ",0.514104," 6,57 "," 2.521,94 "," 1.941,99 ",2808104585,CFD," 0,00 "
13/09/2024 14:14:03,Position closed,NSDQ100/USD," 149,32 ",0.154095,"(0,67)"," 2.521,27 "," 2.091,31 ",2808108438,CFD," 0,00 "
13/09/2024 14:14:41,Open Position,NSDQ100/USD," 530,00 ",0.544608," 0,00 "," 2.521,27 "," 1.561,31 ",2808215899,CFD," 0,00 "
13/09/2024 14:15:12,Open Position,NSDQ100/USD," 400,00 ",0.410763," 0,00 "," 2.521,27 "," 1.161,31 ",2808216622,CFD," 0,00 "
13/09/2024 14:16:32,Open Position,NSDQ100/USD," 299,99 ",0.307974," 0,00 "," 2.521,27 "," 861,32 ",2808218026,CFD," 0,00 "
13/09/2024 14:23:15,Open Position,NSDQ100/USD," 499,99 ",0.512912," 0,00 "," 2.521,27 "," 361,33 ",2808228490,CFD," 0,00 "
13/09/2024 14:25:49,Position closed,NSDQ100/USD," 505,26 ",0.512912," 5,27 "," 2.526,54 "," 866,59 ",2808228490,CFD," 0,00 "
13/09/2024 14:25:49,Position closed,NSDQ100/USD," 307,59 ",0.307974," 7,60 "," 2.534,14 "," 1.174,18 ",2808218026,CFD," 0,00 "
13/09/2024 14:25:49,Position closed,NSDQ100/USD," 553,57 ",0.544608," 23,57 "," 2.557,71 "," 1.727,75 ",2808215899,CFD," 0,00 "
13/09/2024 14:25:49,Position closed,NSDQ100/USD," 412,68 ",0.410763," 12,68 "," 2.570,39 "," 2.140,43 ",2808216622,CFD," 0,00 "
13/09/2024 14:44:16,Open Position,NSDQ100/USD," 540,00 ",0.553584," 0,00 "," 2.570,39 "," 1.600,43 ",2808272117,CFD," 0,00 "
13/09/2024 14:45:05,Position closed,NSDQ100/USD," 537,16 ",0.553584,"(2,84)"," 2.567,55 "," 2.137,59 ",2808272117,CFD," 0,00 "
13/09/2024 14:54:30,Open Position,NSDQ100/USD," 540,00 ",0.553896," 0,00 "," 2.567,55 "," 1.597,59 ",2808340946,CFD," 0,00 "
13/09/2024 15:01:32,Open Position,NSDQ100/USD," 400,00 ",0.410277," 0,00 "," 2.567,55 "," 1.197,59 ",2808348088,CFD," 0,00 "
13/09/2024 15:07:56,Open Position,NSDQ100/USD," 299,99 ",0.307594," 0,00 "," 2.567,55 "," 897,60 ",2808354189,CFD," 0,00 "
13/09/2024 15:20:29,Open Position,NSDQ100/USD," 499,99 ",0.512786," 0,00 "," 2.567,55 "," 397,61 ",2808367407,CFD," 0,00 "
13/09/2024 15:26:35,Position closed,NSDQ100/USD," 546,25 ",0.553896," 6,25 "," 2.573,80 "," 943,86 ",2808340946,CFD," 0,00 "
13/09/2024 15:26:35,Position closed,NSDQ100/USD," 504,24 ",0.512786," 4,25 "," 2.578,05 "," 1.448,10 ",2808367407,CFD," 0,00 "
13/09/2024 15:26:35,Position closed,NSDQ100/USD," 404,30 ",0.410277," 4,30 "," 2.582,35 "," 1.852,40 ",2808348088,CFD," 0,00 "
13/09/2024 15:26:35,Position closed,NSDQ100/USD," 301,00 ",0.307594," 1,01 "," 2.583,36 "," 2.153,40 ",2808354189,CFD," 0,00 "
13/09/2024 15:27:21,Open Position,NSDQ100/USD," 540,00 ",0.553462," 0,00 "," 2.583,36 "," 1.613,40 ",2808373628,CFD," 0,00 "
13/09/2024 15:32:26,Position closed,NSDQ100/USD," 536,72 ",0.553462,"(3,28)"," 2.580,08 "," 2.150,12 ",2808373628,CFD," 0,00 "
13/09/2024 15:39:29,Open Position,NSDQ100/USD," 299,99 ",0.307804," 0,00 "," 2.580,08 "," 1.850,13 ",2808383714,CFD," 0,00 "
13/09/2024 15:39:47,Open Position,NSDQ100/USD," 200,00 ",0.205218," 0,00 "," 2.580,08 "," 1.650,13 ",2808383878,CFD," 0,00 "
13/09/2024 15:40:07,Open Position,NSDQ100/USD," 299,99 ",0.307703," 0,00 "," 2.580,08 "," 1.350,14 ",2808384142,CFD," 0,00 "
13/09/2024 15:40:53,Position closed,NSDQ100/USD," 302,29 ",0.307703," 2,30 "," 2.582,38 "," 1.652,43 ",2808384142,CFD," 0,00 "
13/09/2024 15:40:53,Position closed,NSDQ100/USD," 304,26 ",0.307804," 4,27 "," 2.586,65 "," 1.956,69 ",2808383714,CFD," 0,00 "
13/09/2024 15:40:53,Position closed,NSDQ100/USD," 203,16 ",0.205218," 3,16 "," 2.589,81 "," 2.159,85 ",2808383878,CFD," 0,00 "
13/09/2024 15:41:32,Open Position,NSDQ100/USD," 200,00 ",0.205043," 0,00 "," 2.589,81 "," 1.959,85 ",2808384823,CFD," 0,00 "
13/09/2024 15:42:33,Open Position,NSDQ100/USD," 489,99 ",0.502509," 0,00 "," 2.589,81 "," 1.469,86 ",2808385652,CFD," 0,00 "
13/09/2024 15:44:19,Open Position,NSDQ100/USD," 370,00 ",0.379432," 0,00 "," 2.589,81 "," 1.099,86 ",2808386899,CFD," 0,00 "
13/09/2024 15:44:32,Open Position,NSDQ100/USD," 279,99 ",0.287219," 0,00 "," 2.589,81 "," 819,87 ",2808387039,CFD," 0,00 "
13/09/2024 15:44:45,Open Position,NSDQ100/USD," 210,00 ",0.215381," 0,00 "," 2.589,81 "," 609,87 ",2808387419,CFD," 0,00 "
13/09/2024 15:47:57,Position closed,NSDQ100/USD," 373,74 ",0.379432," 3,74 "," 2.593,55 "," 983,61 ",2808386899,CFD," 0,00 "
13/09/2024 15:47:57,Position closed,NSDQ100/USD," 200,96 ",0.205043," 0,96 "," 2.594,51 "," 1.184,57 ",2808384823,CFD," 0,00 "
13/09/2024 15:47:57,Position closed,NSDQ100/USD," 495,30 ",0.502509," 5,31 "," 2.599,82 "," 1.679,87 ",2808385652,CFD," 0,00 "
13/09/2024 15:47:57,Position closed,NSDQ100/USD," 284,41 ",0.287219," 4,42 "," 2.604,24 "," 1.964,28 ",2808387039,CFD," 0,00 "
13/09/2024 15:47:57,Position closed,NSDQ100/USD," 212,67 ",0.215381," 2,67 "," 2.606,91 "," 2.176,95 ",2808387419,CFD," 0,00 "
13/09/2024 15:48:16,Open Position,NSDQ100/USD," 550,00 ",0.563535," 0,00 "," 2.606,91 "," 1.626,95 ",2808389438,CFD," 0,00 "
13/09/2024 15:48:29,Position closed,NSDQ100/USD," 549,70 ",0.563535,"(0,30)"," 2.606,61 "," 2.176,65 ",2808389438,CFD," 0,00 "
13/09/2024 16:06:12,Open Position,NSDQ100/USD," 50,00 ",0.051231," 0,00 "," 2.606,61 "," 2.126,65 ",2808403449,CFD," 0,00 "
13/09/2024 16:06:43,Position closed,NSDQ100/USD," 49,63 ",0.051231,"(0,37)"," 2.606,24 "," 2.176,28 ",2808403449,CFD," 0,00 "
13/09/2024 16:07:14,Open Position,NSDQ100/USD," 50,00 ",0.051257," 0,00 "," 2.606,24 "," 2.126,28 ",2808404020,CFD," 0,00 "
13/09/2024 17:50:35,Position closed,NSDQ100/USD," 51,97 ",0.051257," 1,97 "," 2.608,21 "," 2.178,25 ",2808404020,CFD," 0,00 "
13/09/2024 17:51:44,Position closed,NVDA/USD," 248,64 ",10.500822,"(1,33)"," 2.606,88 "," 2.426,89 ",2808107155,CFD," 0,00 "
13/09/2024 17:51:51,Position closed,NVDA/USD," 173,17 ",7.514440,"(6,82)"," 2.600,06 "," 2.600,06 ",2808187473,CFD," 0,00 "
16/09/2024 01:15:03,Open Position,NSDQ100/USD," 200,00 ",0.205200," 0,00 "," 2.600,06 "," 2.400,06 ",2808630037,CFD," 0,00 "
16/09/2024 06:43:59,Position closed,NSDQ100/USD," 204,16 ",0.205200," 4,16 "," 2.604,22 "," 2.604,22 ",2808630037,CFD," 0,00 "
16/09/2024 06:48:20,Open Position,NSDQ100/USD," 300,00 ",0.308102," 0,00 "," 2.604,22 "," 2.304,22 ",2808650948,CFD," 0,00 "
16/09/2024 07:05:01,Open Position,NSDQ100/USD," 580,00 ",0.595603," 0,00 "," 2.604,22 "," 1.724,22 ",2808684105,CFD," 0,00 "
16/09/2024 07:05:27,Open Position,NSDQ100/USD," 300,00 ",0.308062," 0,00 "," 2.604,22 "," 1.424,22 ",2808684184,CFD," 0,00 "
16/09/2024 07:05:37,Open Position,NSDQ100/USD," 199,99 ",0.205365," 0,00 "," 2.604,22 "," 1.224,23 ",2808684219,CFD," 0,00 "
16/09/2024 07:15:10,Position closed,NSDQ100/USD," 584,81 ",0.595603," 4,81 "," 2.609,03 "," 1.809,04 ",2808684105,CFD," 0,00 "
16/09/2024 07:15:10,Position closed,NSDQ100/USD," 302,34 ",0.308062," 2,34 "," 2.611,37 "," 2.111,38 ",2808684184,CFD," 0,00 "
16/09/2024 07:15:10,Position closed,NSDQ100/USD," 201,36 ",0.205365," 1,37 "," 2.612,74 "," 2.312,74 ",2808684219,CFD," 0,00 "
16/09/2024 07:15:10,Position closed,NSDQ100/USD," 303,11 ",0.308102," 3,11 "," 2.615,85 "," 2.615,85 ",2808650948,CFD," 0,00 "
16/09/2024 07:25:18,Open Position,NSDQ100/USD," 100,00 ",0.102636," 0,00 "," 2.615,85 "," 2.515,85 ",2808716759,CFD," 0,00 "
16/09/2024 07:58:13,Position closed,NSDQ100/USD," 101,60 ",0.102636," 1,60 "," 2.617,45 "," 2.617,45 ",2808716759,CFD," 0,00 "
16/09/2024 08:09:36,Open Position,NSDQ100/USD," 150,00 ",0.153684," 0,00 "," 2.617,45 "," 2.467,45 ",2808731118,CFD," 0,00 "
16/09/2024 08:14:06,Position closed,NSDQ100/USD," 149,89 ",0.153684,"(0,11)"," 2.617,34 "," 2.617,34 ",2808731118,CFD," 0,00 "
16/09/2024 08:28:43,Open Position,NSDQ100/USD," 399,99 ",0.409780," 0,00 "," 2.617,34 "," 2.217,35 ",2808735537,CFD," 0,00 "
16/09/2024 08:38:18,Position closed,NSDQ100/USD," 405,35 ",0.409780," 5,36 "," 2.622,70 "," 2.622,70 ",2808735537,CFD," 0,00 "
16/09/2024 08:41:08,Open Position,NSDQ100/USD," 270,00 ",0.276754," 0,00 "," 2.622,70 "," 2.352,70 ",2808739172,CFD," 0,00 "
16/09/2024 08:41:43,Position closed,NSDQ100/USD," 268,77 ",0.276754,"(1,23)"," 2.621,47 "," 2.621,47 ",2808739172,CFD," 0,00 "
16/09/2024 08:47:41,Open Position,NSDQ100/USD," 999,99 ",1.025122," 0,00 "," 2.621,47 "," 1.621,48 ",2808740554,CFD," 0,00 "
16/09/2024 10:43:40,Open Position,NSDQ100/USD," 600,00 ",0.616511," 0,00 "," 2.621,47 "," 1.021,48 ",2808771719,CFD," 0,00 "
16/09/2024 10:45:29,Open Position,NSDQ100/USD," 499,99 ",0.513688," 0,00 "," 2.621,47 "," 521,49 ",2808772104,CFD," 0,00 "
16/09/2024 13:07:18,Open Position,NSDQ100/USD," 300,00 ",0.308930," 0,00 "," 2.621,47 "," 221,49 ",2808804601,CFD," 0,00 "
16/09/2024 13:25:23,Position closed,NSDQ100/USD," 295,86 ",0.308930,"(4,14)"," 2.617,33 "," 517,35 ",2808804601,CFD," 0,00 "
16/09/2024 13:34:13,Open Position,NSDQ100/USD," 129,98 ",0.134448," 0,00 "," 2.617,33 "," 387,37 ",2808980348,CFD," 0,00 "
16/09/2024 13:36:56,Open Position,NSDQ100/USD," 299,99 ",0.310428," 0,00 "," 2.617,33 "," 87,38 ",2808986654,CFD," 0,00 "
16/09/2024 13:37:51,Position closed,NSDQ100/USD," 303,19 ",0.310428," 3,20 "," 2.620,53 "," 390,57 ",2808986654,CFD," 0,00 "
16/09/2024 13:38:38,Open Position,NSDQ100/USD," 99,99 ",0.103297," 0,00 "," 2.620,53 "," 290,58 ",2808991223,CFD," 0,00 "
16/09/2024 13:39:24,Position closed,NSDQ100/USD," 131,58 ",0.134448," 1,60 "," 2.622,13 "," 422,16 ",2808980348,CFD," 0,00 "
16/09/2024 13:39:31,Position closed,NSDQ100/USD," 99,13 ",0.103297,"(0,86)"," 2.621,27 "," 521,29 ",2808991223,CFD," 0,00 "
16/09/2024 13:44:09,Open Position,NSDQ100/USD," 99,99 ",0.103282," 0,00 "," 2.621,27 "," 421,30 ",2809001494,CFD," 0,00 "
16/09/2024 13:53:17,Position closed,NSDQ100/USD," 95,00 ",0.103282,"(4,99)"," 2.616,28 "," 516,30 ",2809001494,CFD," 0,00 "
16/09/2024 14:05:21,Open Position,NSDQ100/USD," 200,00 ",0.205767," 0,00 "," 2.616,28 "," 316,30 ",2809244422,CFD," 0,00 "
16/09/2024 14:16:29,Open Position,NSDQ100/USD," 200,00 ",0.205785," 0,00 "," 2.616,28 "," 116,30 ",2809259291,CFD," 0,00 "
16/09/2024 14:25:23,Deposit,8000.00 USDRON CreditCard," 1.738,42 ",-," 1.738,42 "," 4.354,70 "," 1.854,72 ",-,-," 0,00 "
16/09/2024 14:25:23,Deposit Conversion Fee,-,"(52,54)",-," 0,00 "," 4.354,70 "," 1.854,72 ",-,-," 0,00 "
16/09/2024 14:27:08,Open Position,NSDQ100/USD," 469,99 ",0.485191," 0,00 "," 4.354,70 "," 1.384,73 ",2809271268,CFD," 0,00 "
16/09/2024 14:29:39,Open Position,NSDQ100/USD," 350,00 ",0.361286," 0,00 "," 4.354,70 "," 1.034,73 ",2809274355,CFD," 0,00 "
16/09/2024 14:31:08,Open Position,NSDQ100/USD," 259,99 ",0.268775," 0,00 "," 4.354,70 "," 774,74 ",2809275957,CFD," 0,00 "
16/09/2024 14:32:59,Open Position,NSDQ100/USD," 199,99 ",0.206924," 0,00 "," 4.354,70 "," 574,75 ",2809277893,CFD," 0,00 "
16/09/2024 14:34:23,Position closed,NSDQ100/USD," 206,72 ",0.206924," 6,73 "," 4.361,43 "," 781,47 ",2809277893,CFD," 0,00 "
16/09/2024 14:35:36,Open Position,NSDQ100/USD," 200,00 ",0.207140," 0,00 "," 4.361,43 "," 581,47 ",2809283114,CFD," 0,00 "
16/09/2024 14:36:42,Position closed,NSDQ100/USD," 202,75 ",0.207140," 2,75 "," 4.364,18 "," 784,22 ",2809283114,CFD," 0,00 "
16/09/2024 14:37:00,Open Position,NSDQ100/USD," 300,00 ",0.310517," 0,00 "," 4.364,18 "," 484,22 ",2809285363,CFD," 0,00 "
16/09/2024 14:37:18,Position closed,NSDQ100/USD," 256,47 ",0.268775,"(3,52)"," 4.360,66 "," 740,69 ",2809275957,CFD," 0,00 "
16/09/2024 14:42:22,Open Position,NSDQ100/USD," 189,99 ",0.196467," 0,00 "," 4.360,66 "," 550,70 ",2809295389,CFD," 0,00 "
16/09/2024 14:44:05,Position closed,NSDQ100/USD," 190,93 ",0.196467," 0,94 "," 4.361,60 "," 741,63 ",2809295389,CFD," 0,00 "
16/09/2024 14:45:14,Open Position,NSDQ100/USD," 299,99 ",0.310218," 0,00 "," 4.361,60 "," 441,64 ",2809300476,CFD," 0,00 "
16/09/2024 14:45:35,Position closed,NSDQ100/USD," 297,97 ",0.310218,"(2,02)"," 4.359,58 "," 739,61 ",2809300476,CFD," 0,00 "
16/09/2024 14:47:03,Position closed,NSDQ100/USD," 301,52 ",0.310517," 1,52 "," 4.361,10 "," 1.041,13 ",2809285363,CFD," 0,00 "
16/09/2024 14:51:10,Open Position,NSDQ100/USD," 270,00 ",0.279136," 0,00 "," 4.361,10 "," 771,13 ",2809307915,CFD," 0,00 "
16/09/2024 14:51:47,Position closed,NSDQ100/USD," 270,36 ",0.279136," 0,36 "," 4.361,46 "," 1.041,49 ",2809307915,CFD," 0,00 "
16/09/2024 14:52:48,Open Position,NSDQ100/USD," 300,00 ",0.310396," 0,00 "," 4.361,46 "," 741,49 ",2809310324,CFD," 0,00 "
16/09/2024 14:54:00,Open Position,NSDQ100/USD," 300,00 ",0.310063," 0,00 "," 4.361,46 "," 441,49 ",2809311987,CFD," 0,00 "
16/09/2024 14:56:08,Position closed,NSDQ100/USD," 306,95 ",0.310063," 6,95 "," 4.368,41 "," 748,44 ",2809311987,CFD," 0,00 "
16/09/2024 14:56:16,Position closed,NSDQ100/USD," 298,73 ",0.310396,"(1,27)"," 4.367,14 "," 1.047,17 ",2809310324,CFD," 0,00 "
16/09/2024 14:58:17,Open Position,NSDQ100/USD," 269,99 ",0.279229," 0,00 "," 4.367,14 "," 777,18 ",2809316203,CFD," 0,00 "
16/09/2024 14:58:27,Position closed,NSDQ100/USD," 271,97 ",0.279229," 1,98 "," 4.369,12 "," 1.049,15 ",2809316203,CFD," 0,00 "
16/09/2024 14:59:44,Open Position,NSDQ100/USD," 270,00 ",0.279487," 0,00 "," 4.369,12 "," 779,15 ",2809318204,CFD," 0,00 "
16/09/2024 15:00:05,Open Position,NSDQ100/USD," 199,99 ",0.207006," 0,00 "," 4.369,12 "," 579,16 ",2809318592,CFD," 0,00 "
16/09/2024 15:00:22,Position closed,NSDQ100/USD," 272,66 ",0.279487," 2,66 "," 4.371,78 "," 851,82 ",2809318204,CFD," 0,00 "
16/09/2024 15:00:27,Position closed,NSDQ100/USD," 197,61 ",0.207006,"(2,38)"," 4.369,40 "," 1.049,43 ",2809318592,CFD," 0,00 "
16/09/2024 15:01:18,Open Position,NSDQ100/USD," 269,99 ",0.279621," 0,00 "," 4.369,40 "," 779,44 ",2809321392,CFD," 0,00 "
16/09/2024 15:01:28,Open Position,NSDQ100/USD," 50,00 ",0.051775," 0,00 "," 4.369,40 "," 729,44 ",2809321577,CFD," 0,00 "
16/09/2024 15:05:47,Position closed,NSDQ100/USD," 270,02 ",0.279621," 0,03 "," 4.369,43 "," 999,46 ",2809321392,CFD," 0,00 "
16/09/2024 15:06:16,Position closed,NSDQ100/USD," 49,93 ",0.051775,"(0,07)"," 4.369,36 "," 1.049,39 ",2809321577,CFD," 0,00 "
16/09/2024 15:07:18,Open Position,NSDQ100/USD," 270,00 ",0.279500," 0,00 "," 4.369,36 "," 779,39 ",2809328223,CFD," 0,00 "
16/09/2024 15:07:30,Open Position,NSDQ100/USD," 199,99 ",0.206986," 0,00 "," 4.369,36 "," 579,40 ",2809329739,CFD," 0,00 "
16/09/2024 15:11:07,Open Position,NSDQ100/USD," 300,00 ",0.310226," 0,00 "," 4.369,36 "," 279,40 ",2809332196,CFD," 0,00 "
16/09/2024 15:11:57,Position closed,NSDQ100/USD," 342,55 ",0.361286,"(7,45)"," 4.361,91 "," 621,95 ",2809274355,CFD," 0,00 "
16/09/2024 15:12:25,Open Position,NSDQ100/USD," 399,99 ",0.413419," 0,00 "," 4.361,91 "," 221,96 ",2809334979,CFD," 0,00 "
16/09/2024 15:17:49,Open Position,NSDQ100/USD," 199,99 ",0.206564," 0,00 "," 4.361,91 "," 21,97 ",2809362560,CFD," 0,00 "
16/09/2024 15:19:30,Position closed,NSDQ100/USD," 197,12 ",0.206564,"(2,87)"," 4.359,04 "," 219,09 ",2809362560,CFD," 0,00 "
16/09/2024 15:20:01,Open Position,NSDQ100/USD," 200,00 ",0.206422," 0,00 "," 4.359,04 "," 19,09 ",2809364507,CFD," 0,00 "
16/09/2024 15:23:09,Position closed,NSDQ100/USD," 388,86 ",0.413419,"(11,13)"," 4.347,91 "," 407,95 ",2809334979,CFD," 0,00 "
16/09/2024 15:23:23,Open Position,NSDQ100/USD," 299,99 ",0.309603," 0,00 "," 4.347,91 "," 107,96 ",2809366649,CFD," 0,00 "
16/09/2024 15:23:38,Position closed,NSDQ100/USD," 288,39 ",0.310226,"(11,61)"," 4.336,30 "," 396,35 ",2809332196,CFD," 0,00 "
16/09/2024 15:23:50,Open Position,NSDQ100/USD," 299,99 ",0.309602," 0,00 "," 4.336,30 "," 96,36 ",2809367156,CFD," 0,00 "
16/09/2024 15:24:23,Position closed,NSDQ100/USD," 187,73 ",0.206986,"(12,26)"," 4.324,04 "," 284,09 ",2809329739,CFD," 0,00 "
16/09/2024 15:24:32,Open Position,NSDQ100/USD," 200,00 ",0.206347," 0,00 "," 4.324,04 "," 84,09 ",2809367696,CFD," 0,00 "
16/09/2024 15:24:58,Position closed,NSDQ100/USD," 249,71 ",0.279500,"(20,29)"," 4.303,75 "," 333,80 ",2809328223,CFD," 0,00 "
16/09/2024 15:25:41,Position closed,NSDQ100/USD," 475,52 ",0.485191," 5,53 "," 4.309,28 "," 809,32 ",2809271268,CFD," 0,00 "
16/09/2024 15:25:58,Position closed,NSDQ100/USD," 200,08 ",0.206422," 0,08 "," 4.309,36 "," 1.009,40 ",2809364507,CFD," 0,00 "
16/09/2024 15:27:24,Open Position,NSDQ100/USD," 299,99 ",0.309640," 0,00 "," 4.309,36 "," 709,41 ",2809371008,CFD," 0,00 "
16/09/2024 15:28:34,Position closed,NSDQ100/USD," 299,40 ",0.309640,"(0,59)"," 4.308,77 "," 1.008,81 ",2809371008,CFD," 0,00 "
16/09/2024 15:32:37,Position closed,NSDQ100/USD," 300,88 ",0.309602," 0,89 "," 4.309,66 "," 1.309,69 ",2809367156,CFD," 0,00 "
16/09/2024 15:34:57,Position closed,NSDQ100/USD," 300,30 ",0.309603," 0,31 "," 4.309,97 "," 1.609,99 ",2809366649,CFD," 0,00 "
16/09/2024 15:35:58,Open Position,NSDQ100/USD," 410,00 ",0.423341," 0,00 "," 4.309,97 "," 1.199,99 ",2809375817,CFD," 0,00 "
16/09/2024 15:37:11,Open Position,NSDQ100/USD," 299,99 ",0.309947," 0,00 "," 4.309,97 "," 900,00 ",2809377228,CFD," 0,00 "
16/09/2024 15:38:54,Open Position,NSDQ100/USD," 299,99 ",0.310019," 0,00 "," 4.309,97 "," 600,01 ",2809378773,CFD," 0,00 "
16/09/2024 15:39:32,Position closed,NSDQ100/USD," 300,80 ",0.310019," 0,81 "," 4.310,78 "," 900,81 ",2809378773,CFD," 0,00 "
16/09/2024 15:44:12,Open Position,NSDQ100/USD," 400,00 ",0.413646," 0,00 "," 4.310,78 "," 500,81 ",2809383225,CFD," 0,00 "
16/09/2024 15:47:24,Open Position,NSDQ100/USD," 200,00 ",0.207016," 0,00 "," 4.310,78 "," 300,81 ",2809384851,CFD," 0,00 "
16/09/2024 16:03:04,Position closed,NSDQ100/USD," 206,04 ",0.207016," 6,04 "," 4.316,82 "," 506,85 ",2809384851,CFD," 0,00 "
16/09/2024 16:06:33,Position closed,NSDQ100/USD," 404,76 ",0.413646," 4,76 "," 4.321,58 "," 911,61 ",2809383225,CFD," 0,00 "
16/09/2024 16:08:25,Open Position,NSDQ100/USD," 229,99 ",0.237560," 0,00 "," 4.321,58 "," 681,62 ",2809396909,CFD," 0,00 "
16/09/2024 16:19:22,Open Position,NSDQ100/USD," 499,99 ",0.517692," 0,00 "," 4.321,58 "," 181,63 ",2809423939,CFD," 0,00 "
16/09/2024 16:21:38,Open Position,NSDQ100/USD," 149,99 ",0.155391," 0,00 "," 4.321,58 "," 31,64 ",2809425427,CFD," 0,00 "
16/09/2024 16:50:45,Position closed,NSDQ100/USD," 156,28 ",0.155391," 6,29 "," 4.327,87 "," 187,92 ",2809425427,CFD," 0,00 "
16/09/2024 16:51:32,Position closed,NSDQ100/USD," 519,46 ",0.517692," 19,47 "," 4.347,34 "," 707,38 ",2809423939,CFD," 0,00 "
16/09/2024 16:52:14,Position closed,NSDQ100/USD," 299,56 ",0.309947,"(0,43)"," 4.346,91 "," 1.006,94 ",2809377228,CFD," 0,00 "
16/09/2024 17:53:29,Position closed,NSDQ100/USD," 242,82 ",0.237560," 12,83 "," 4.359,74 "," 1.249,76 ",2809396909,CFD," 0,00 "
16/09/2024 17:53:36,Position closed,NSDQ100/USD," 206,72 ",0.206347," 6,72 "," 4.366,46 "," 1.456,48 ",2809367696,CFD," 0,00 "
16/09/2024 17:55:38,Position closed,NSDQ100/USD," 425,91 ",0.423341," 15,91 "," 4.382,37 "," 1.882,39 ",2809375817,CFD," 0,00 "
16/09/2024 18:20:58,Open Position,NSDQ100/USD," 299,99 ",0.309181," 0,00 "," 4.382,37 "," 1.582,40 ",2809489959,CFD," 0,00 "
16/09/2024 18:21:26,Open Position,NSDQ100/USD," 400,00 ",0.412131," 0,00 "," 4.382,37 "," 1.182,40 ",2809490041,CFD," 0,00 "
16/09/2024 18:37:31,Position closed,NSDQ100/USD," 302,86 ",0.309181," 2,87 "," 4.385,24 "," 1.485,26 ",2809489959,CFD," 0,00 "
16/09/2024 18:38:24,Open Position,NSDQ100/USD," 380,00 ",0.391538," 0,00 "," 4.385,24 "," 1.105,26 ",2809495489,CFD," 0,00 "
16/09/2024 18:42:53,Open Position,NSDQ100/USD," 279,99 ",0.288680," 0,00 "," 4.385,24 "," 825,27 ",2809496995,CFD," 0,00 "
16/09/2024 18:45:37,Open Position,NSDQ100/USD," 210,00 ",0.216653," 0,00 "," 4.385,24 "," 615,27 ",2809497865,CFD," 0,00 "
16/09/2024 18:46:38,Position closed,NSDQ100/USD," 210,99 ",0.216653," 0,99 "," 4.386,23 "," 826,26 ",2809497865,CFD," 0,00 "
16/09/2024 18:48:46,Position closed,NSDQ100/USD," 280,24 ",0.288680," 0,25 "," 4.386,48 "," 1.106,50 ",2809496995,CFD," 0,00 "
16/09/2024 18:52:35,Open Position,NSDQ100/USD," 279,99 ",0.288769," 0,00 "," 4.386,48 "," 826,51 ",2809499853,CFD," 0,00 "
16/09/2024 19:03:09,Position closed,NSDQ100/USD," 400,78 ",0.412131," 0,78 "," 4.387,26 "," 1.227,29 ",2809490041,CFD," 0,00 "
16/09/2024 19:03:17,Position closed,NSDQ100/USD," 285,36 ",0.288769," 5,37 "," 4.392,63 "," 1.512,65 ",2809499853,CFD," 0,00 "
16/09/2024 19:03:24,Position closed,NSDQ100/USD," 380,82 ",0.391538," 0,82 "," 4.393,45 "," 1.893,47 ",2809495489,CFD," 0,00 "
16/09/2024 19:07:33,Position closed,NSDQ100/USD," 195,32 ",0.205785,"(4,68)"," 4.388,77 "," 2.088,79 ",2809259291,CFD," 0,00 "
16/09/2024 19:18:05,Open Position,NSDQ100/USD," 200,00 ",0.206205," 0,00 "," 4.388,77 "," 1.888,79 ",2809510330,CFD," 0,00 "
16/09/2024 19:18:15,Open Position,NSDQ100/USD," 200,00 ",0.206220," 0,00 "," 4.388,77 "," 1.688,79 ",2809510366,CFD," 0,00 "
16/09/2024 19:18:54,Open Position,NSDQ100/USD," 99,99 ",0.103094," 0,00 "," 4.388,77 "," 1.588,80 ",2809510586,CFD," 0,00 "
16/09/2024 19:41:49,Position closed,NSDQ100/USD," 102,65 ",0.103094," 2,66 "," 4.391,43 "," 1.691,45 ",2809510586,CFD," 0,00 "
16/09/2024 19:41:56,Position closed,NSDQ100/USD," 205,87 ",0.206220," 5,87 "," 4.397,30 "," 1.897,32 ",2809510366,CFD," 0,00 "
16/09/2024 19:42:07,Position closed,NSDQ100/USD," 205,77 ",0.206205," 5,77 "," 4.403,07 "," 2.103,09 ",2809510330,CFD," 0,00 "
16/09/2024 19:42:19,Position closed,NSDQ100/USD," 197,32 ",0.205767,"(2,68)"," 4.400,39 "," 2.300,41 ",2809244422,CFD," 0,00 "
16/09/2024 19:42:53,Position closed,NSDQ100/USD," 477,20 ",0.513688,"(22,79)"," 4.377,60 "," 2.777,61 ",2808772104,CFD," 0,00 "
16/09/2024 19:47:04,Open Position,NSDQ100/USD," 299,99 ",0.308832," 0,00 "," 4.377,60 "," 2.477,62 ",2809522961,CFD," 0,00 "
16/09/2024 19:47:18,Position closed,NSDQ100/USD," 299,03 ",0.308832,"(0,96)"," 4.376,64 "," 2.776,65 ",2809522961,CFD," 0,00 "
16/09/2024 19:47:31,Open Position,NSDQ100/USD," 300,00 ",0.308950," 0,00 "," 4.376,64 "," 2.476,65 ",2809523170,CFD," 0,00 "
16/09/2024 19:47:49,Open Position,NSDQ100/USD," 399,99 ",0.411836," 0,00 "," 4.376,64 "," 2.076,66 ",2809523245,CFD," 0,00 "
16/09/2024 19:55:42,Open Position,NSDQ100/USD," 520,00 ",0.535230," 0,00 "," 4.376,64 "," 1.556,66 ",2809526873,CFD," 0,00 "
16/09/2024 20:01:08,Position closed,NSDQ100/USD," 527,25 ",0.535230," 7,25 "," 4.383,89 "," 2.083,91 ",2809526873,CFD," 0,00 "
16/09/2024 20:01:25,Position closed,NSDQ100/USD," 402,07 ",0.411836," 2,08 "," 4.385,97 "," 2.485,98 ",2809523245,CFD," 0,00 "
16/09/2024 20:01:32,Position closed,NSDQ100/USD," 300,51 ",0.308950," 0,51 "," 4.386,48 "," 2.786,49 ",2809523170,CFD," 0,00 "
16/09/2024 20:05:12,Open Position,NSDQ100/USD," 399,99 ",0.412157," 0,00 "," 4.386,48 "," 2.386,50 ",2809529559,CFD," 0,00 "
16/09/2024 20:05:27,Open Position,NSDQ100/USD," 299,99 ",0.309102," 0,00 "," 4.386,48 "," 2.086,51 ",2809529566,CFD," 0,00 "
16/09/2024 20:05:44,Open Position,NSDQ100/USD," 400,00 ",0.412164," 0,00 "," 4.386,48 "," 1.686,51 ",2809529581,CFD," 0,00 "
16/09/2024 20:42:59,Position closed,NSDQ100/USD," 299,12 ",0.309102,"(0,87)"," 4.385,61 "," 1.985,63 ",2809529566,CFD," 0,00 "
16/09/2024 20:43:13,Position closed,NSDQ100/USD," 398,43 ",0.412164,"(1,57)"," 4.384,04 "," 2.384,06 ",2809529581,CFD," 0,00 "
16/09/2024 20:43:41,Position closed,NSDQ100/USD," 399,24 ",0.412157,"(0,75)"," 4.383,29 "," 2.783,30 ",2809529559,CFD," 0,00 "
17/09/2024 00:35:32,Index price adjustment,NSDQ100/USD," 0,41 ",-," 0,41 "," 4.383,70 "," 2.783,71 ",2808740554,CFD," 0,00 "
17/09/2024 00:35:32,Index price adjustment,NSDQ100/USD," 0,24 ",-," 0,24 "," 4.383,94 "," 2.783,95 ",2808771719,CFD," 0,00 "
17/09/2024 00:35:32,Index price adjustment,NSDQ100/USD,"(0,12)",-,"(0,12)"," 4.383,82 "," 2.783,83 ",2809523170,CFD," 0,00 "
17/09/2024 00:35:32,Index price adjustment,NSDQ100/USD,"(0,16)",-,"(0,16)"," 4.383,66 "," 2.783,67 ",2809523245,CFD," 0,00 "
17/09/2024 00:35:32,Index price adjustment,NSDQ100/USD,"(0,21)",-,"(0,21)"," 4.383,45 "," 2.783,46 ",2809526873,CFD," 0,00 "
17/09/2024 00:48:28,Overnight fee,Daily,"(3,16)",-,"(3,16)"," 4.380,29 "," 2.780,30 ",2808771719,CFD," 0,00 "
17/09/2024 00:48:28,Overnight fee,Daily,"(5,25)",-,"(5,25)"," 4.375,04 "," 2.775,05 ",2808740554,CFD," 0,00 "
17/09/2024 06:14:37,Position closed,NSDQ100/USD," 582,54 ",0.616511,"(17,46)"," 4.357,58 "," 3.357,59 ",2808771719,CFD," 0,00 "
17/09/2024 06:35:00,Open Position,NSDQ100/USD," 500,00 ",0.514129," 0,00 "," 4.357,58 "," 2.857,59 ",2809557249,CFD," 0,00 "
17/09/2024 06:36:02,Position closed,NSDQ100/USD," 500,04 ",0.514129," 0,04 "," 4.357,62 "," 3.357,63 ",2809557249,CFD," 0,00 "
17/09/2024 06:36:24,Open Position,NSDQ100/USD," 499,99 ",0.514126," 0,00 "," 4.357,62 "," 2.857,64 ",2809558438,CFD," 0,00 "
17/09/2024 06:36:55,Position closed,NSDQ100/USD," 497,56 ",0.514126,"(2,43)"," 4.355,19 "," 3.355,20 ",2809558438,CFD," 0,00 "
17/09/2024 06:51:30,Open Position,NSDQ100/USD," 400,00 ",0.411380," 0,00 "," 4.355,19 "," 2.955,20 ",2809560696,CFD," 0,00 "
17/09/2024 06:58:09,Open Position,NSDQ100/USD," 199,99 ",0.205663," 0,00 "," 4.355,19 "," 2.755,21 ",2809561298,CFD," 0,00 "
17/09/2024 07:02:43,Position closed,NSDQ100/USD," 201,55 ",0.205663," 1,56 "," 4.356,75 "," 2.956,76 ",2809561298,CFD," 0,00 "
17/09/2024 07:03:29,Position closed,NSDQ100/USD," 398,51 ",0.411380,"(1,49)"," 4.355,26 "," 3.355,27 ",2809560696,CFD," 0,00 "
17/09/2024 07:04:02,Open Position,NSDQ100/USD," 300,00 ",0.308431," 0,00 "," 4.355,26 "," 3.055,27 ",2809587301,CFD," 0,00 "
17/09/2024 07:13:18,Position closed,NSDQ100/USD," 300,02 ",0.308431," 0,02 "," 4.355,28 "," 3.355,29 ",2809587301,CFD," 0,00 "
17/09/2024 07:16:20,Position closed,NSDQ100/USD," 963,05 ",1.025122,"(36,94)"," 4.318,34 "," 4.318,34 ",2808740554,CFD," 0,00 "
17/09/2024 07:17:37,Open Position,NSDQ100/USD," 500,00 ",0.513612," 0,00 "," 4.318,34 "," 3.818,34 ",2809590867,CFD," 0,00 "
17/09/2024 07:22:17,Position closed,NSDQ100/USD," 501,68 ",0.513612," 1,68 "," 4.320,02 "," 4.320,02 ",2809590867,CFD," 0,00 "
17/09/2024 07:51:25,Open Position,NSDQ100/USD," 300,00 ",0.307839," 0,00 "," 4.320,02 "," 4.020,02 ",2809613940,CFD," 0,00 "
17/09/2024 07:54:08,Position closed,NSDQ100/USD," 297,01 ",0.307839,"(2,99)"," 4.317,03 "," 4.317,03 ",2809613940,CFD," 0,00 "
17/09/2024 09:41:04,Open Position,NSDQ100/USD," 50,00 ",0.051210," 0,00 "," 4.317,03 "," 4.267,03 ",2809646572,CFD," 0,00 "
17/09/2024 09:54:51,Position closed,NSDQ100/USD," 50,40 ",0.051210," 0,40 "," 4.317,43 "," 4.317,43 ",2809646572,CFD," 0,00 "
17/09/2024 09:57:22,Open Position,NSDQ100/USD," 399,98 ",0.409650," 0,00 "," 4.317,43 "," 3.917,45 ",2809653356,CFD," 0,00 "
17/09/2024 10:03:28,Position closed,NSDQ100/USD," 396,45 ",0.409650,"(3,53)"," 4.313,90 "," 4.313,90 ",2809653356,CFD," 0,00 "
17/09/2024 10:05:47,Open Position,NSDQ100/USD," 440,00 ",0.450442," 0,00 "," 4.313,90 "," 3.873,90 ",2809656390,CFD," 0,00 "
17/09/2024 10:10:31,Open Position,NSDQ100/USD," 299,99 ",0.307110," 0,00 "," 4.313,90 "," 3.573,91 ",2809657091,CFD," 0,00 "
17/09/2024 10:15:47,Position closed,NSDQ100/USD," 441,15 ",0.450442," 1,15 "," 4.315,05 "," 4.015,06 ",2809656390,CFD," 0,00 "
17/09/2024 10:15:58,Position closed,NSDQ100/USD," 301,30 ",0.307110," 1,31 "," 4.316,36 "," 4.316,36 ",2809657091,CFD," 0,00 "
17/09/2024 10:50:43,Open Position,NSDQ100/USD," 299,99 ",0.307489," 0,00 "," 4.316,36 "," 4.016,37 ",2809665683,CFD," 0,00 "
17/09/2024 11:00:49,Position closed,NSDQ100/USD," 301,24 ",0.307489," 1,25 "," 4.317,61 "," 4.317,61 ",2809665683,CFD," 0,00 "
17/09/2024 11:08:20,Open Position,NSDQ100/USD," 299,99 ",0.307526," 0,00 "," 4.317,61 "," 4.017,62 ",2809669863,CFD," 0,00 "
17/09/2024 11:09:25,Position closed,NSDQ100/USD," 299,30 ",0.307526,"(0,69)"," 4.316,92 "," 4.316,92 ",2809669863,CFD," 0,00 "
17/09/2024 11:32:48,Open Position,NSDQ100/USD," 250,00 ",0.256286," 0,00 "," 4.316,92 "," 4.066,92 ",2809675178,CFD," 0,00 "
17/09/2024 11:54:33,Open Position,NSDQ100/USD," 199,99 ",0.204615," 0,00 "," 4.316,92 "," 3.866,93 ",2809679676,CFD," 0,00 "
17/09/2024 11:55:20,Open Position,NSDQ100/USD," 300,00 ",0.306997," 0,00 "," 4.316,92 "," 3.566,93 ",2809679809,CFD," 0,00 "
17/09/2024 11:55:52,Position closed,NSDQ100/USD," 240,15 ",0.256286,"(9,85)"," 4.307,07 "," 3.807,08 ",2809675178,CFD," 0,00 "
17/09/2024 11:56:38,Open Position,NSDQ100/USD," 300,00 ",0.306937," 0,00 "," 4.307,07 "," 3.507,08 ",2809680084,CFD," 0,00 "
17/09/2024 11:58:41,Open Position,NSDQ100/USD," 300,00 ",0.306777," 0,00 "," 4.307,07 "," 3.207,08 ",2809680662,CFD," 0,00 "
17/09/2024 12:04:16,Position closed,NSDQ100/USD," 301,19 ",0.306997," 1,19 "," 4.308,26 "," 3.508,27 ",2809679809,CFD," 0,00 "
17/09/2024 12:04:31,Position closed,NSDQ100/USD," 299,65 ",0.306937,"(0,35)"," 4.307,91 "," 3.807,92 ",2809680084,CFD," 0,00 "
17/09/2024 12:04:42,Position closed,NSDQ100/USD," 199,53 ",0.204615,"(0,46)"," 4.307,45 "," 4.007,45 ",2809679676,CFD," 0,00 "
17/09/2024 12:05:06,Open Position,NSDQ100/USD," 100,00 ",0.102294," 0,00 "," 4.307,45 "," 3.907,45 ",2809683798,CFD," 0,00 "
17/09/2024 12:43:27,Open Position,NSDQ100/USD," 399,99 ",0.409444," 0,00 "," 4.307,45 "," 3.507,46 ",2809694042,CFD," 0,00 "
17/09/2024 13:03:24,Position closed,NSDQ100/USD," 298,86 ",0.306777,"(1,14)"," 4.306,31 "," 3.806,32 ",2809680662,CFD," 0,00 "
17/09/2024 13:03:24,Position closed,NSDQ100/USD," 100,31 ",0.102294," 0,31 "," 4.306,62 "," 3.906,63 ",2809683798,CFD," 0,00 "
17/09/2024 13:03:24,Position closed,NSDQ100/USD," 406,45 ",0.409444," 6,46 "," 4.313,08 "," 4.313,08 ",2809694042,CFD," 0,00 "
17/09/2024 13:07:55,Open Position,NSDQ100/USD," 350,00 ",0.357793," 0,00 "," 4.313,08 "," 3.963,08 ",2809699400,CFD," 0,00 "
17/09/2024 13:09:03,Open Position,NSDQ100/USD," 249,99 ",0.255554," 0,00 "," 4.313,08 "," 3.713,09 ",2809699635,CFD," 0,00 "
17/09/2024 13:09:23,Open Position,NSDQ100/USD," 300,00 ",0.306644," 0,00 "," 4.313,08 "," 3.413,09 ",2809699691,CFD," 0,00 "
17/09/2024 13:15:28,Open Position,NSDQ100/USD," 300,00 ",0.306706," 0,00 "," 4.313,08 "," 3.113,09 ",2809701064,CFD," 0,00 "
17/09/2024 13:21:55,Open Position,NSDQ100/USD," 120,00 ",0.122785," 0,00 "," 4.313,08 "," 2.993,09 ",2809702604,CFD," 0,00 "
17/09/2024 13:27:38,Open Position,NSDQ100/USD," 50,00 ",0.051186," 0,00 "," 4.313,08 "," 2.943,09 ",2809703931,CFD," 0,00 "
17/09/2024 13:30:05,Open Position,NSDQ100/USD," 299,98 ",0.306742," 0,00 "," 4.313,08 "," 2.643,11 ",2809704603,CFD," 0,00 "
17/09/2024 13:31:16,Position closed,NSDQ100/USD," 251,12 ",0.255554," 1,13 "," 4.314,21 "," 2.894,23 ",2809699635,CFD," 0,00 "
17/09/2024 13:31:16,Position closed,NSDQ100/USD," 300,93 ",0.306644," 0,93 "," 4.315,14 "," 3.195,16 ",2809699691,CFD," 0,00 "
17/09/2024 13:31:16,Position closed,NSDQ100/USD," 351,90 ",0.357793," 1,90 "," 4.317,04 "," 3.547,06 ",2809699400,CFD," 0,00 "
17/09/2024 13:31:16,Position closed,NSDQ100/USD," 302,15 ",0.306706," 2,15 "," 4.319,19 "," 3.849,21 ",2809701064,CFD," 0,00 "
17/09/2024 13:31:16,Position closed,NSDQ100/USD," 122,86 ",0.122785," 2,86 "," 4.322,05 "," 3.972,07 ",2809702604,CFD," 0,00 "
17/09/2024 13:31:16,Position closed,NSDQ100/USD," 303,04 ",0.306742," 3,06 "," 4.325,11 "," 4.275,11 ",2809704603,CFD," 0,00 "
17/09/2024 13:31:16,Position closed,NSDQ100/USD," 51,71 ",0.051186," 1,71 "," 4.326,82 "," 4.326,82 ",2809703931,CFD," 0,00 "
17/09/2024 13:32:07,Open Position,NSDQ100/USD," 299,99 ",0.306687," 0,00 "," 4.326,82 "," 4.026,83 ",2809752390,CFD," 0,00 "
17/09/2024 13:32:19,Open Position,NSDQ100/USD," 250,00 ",0.255511," 0,00 "," 4.326,82 "," 3.776,83 ",2809752641,CFD," 0,00 "
17/09/2024 13:33:01,Position closed,NSDQ100/USD," 251,06 ",0.255511," 1,06 "," 4.327,88 "," 4.027,89 ",2809752641,CFD," 0,00 "
17/09/2024 13:33:01,Position closed,NSDQ100/USD," 302,71 ",0.306687," 2,72 "," 4.330,60 "," 4.330,60 ",2809752390,CFD," 0,00 "
17/09/2024 13:33:23,Open Position,NSDQ100/USD," 200,00 ",0.204435," 0,00 "," 4.330,60 "," 4.130,60 ",2809754880,CFD," 0,00 "
17/09/2024 13:33:38,Open Position,NSDQ100/USD," 99,99 ",0.102273," 0,00 "," 4.330,60 "," 4.030,61 ",2809755520,CFD," 0,00 "
17/09/2024 13:35:36,Open Position,NSDQ100/USD," 200,00 ",0.204779," 0,00 "," 4.330,60 "," 3.830,61 ",2809758804,CFD," 0,00 "
17/09/2024 13:35:52,Open Position,NSDQ100/USD," 199,99 ",0.204888," 0,00 "," 4.330,60 "," 3.630,62 ",2809759870,CFD," 0,00 "
17/09/2024 13:36:12,Position closed,NSDQ100/USD," 196,07 ",0.204888,"(3,92)"," 4.326,68 "," 3.826,69 ",2809759870,CFD," 0,00 "
17/09/2024 13:36:50,Open Position,NSDQ100/USD," 400,00 ",0.409332," 0,00 "," 4.326,68 "," 3.426,69 ",2809762467,CFD," 0,00 "
17/09/2024 13:38:59,Open Position,NSDQ100/USD," 149,99 ",0.153542," 0,00 "," 4.326,68 "," 3.276,70 ",2809765469,CFD," 0,00 "
17/09/2024 13:40:31,Open Position,NSDQ100/USD," 299,99 ",0.307087," 0,00 "," 4.326,68 "," 2.976,71 ",2809769090,CFD," 0,00 "
17/09/2024 13:42:30,Open Position,NSDQ100/USD," 299,99 ",0.307134," 0,00 "," 4.326,68 "," 2.676,72 ",2809772895,CFD," 0,00 "
17/09/2024 13:43:36,Open Position,NSDQ100/USD," 139,99 ",0.143319," 0,00 "," 4.326,68 "," 2.536,73 ",2809775921,CFD," 0,00 "
17/09/2024 13:45:13,Position closed,NSDQ100/USD," 404,20 ",0.409332," 4,20 "," 4.330,88 "," 2.940,93 ",2809762467,CFD," 0,00 "
17/09/2024 13:45:13,Position closed,NSDQ100/USD," 99,87 ",0.102273,"(0,12)"," 4.330,76 "," 3.040,80 ",2809755520,CFD," 0,00 "
17/09/2024 13:45:13,Position closed,NSDQ100/USD," 197,58 ",0.204435,"(2,42)"," 4.328,34 "," 3.238,38 ",2809754880,CFD," 0,00 "
17/09/2024 13:45:13,Position closed,NSDQ100/USD," 204,29 ",0.204779," 4,29 "," 4.332,63 "," 3.442,67 ",2809758804,CFD," 0,00 "
17/09/2024 13:45:13,Position closed,NSDQ100/USD," 304,83 ",0.307087," 4,84 "," 4.337,47 "," 3.747,50 ",2809769090,CFD," 0,00 "
17/09/2024 13:45:13,Position closed,NSDQ100/USD," 142,49 ",0.143319," 2,50 "," 4.339,97 "," 3.889,99 ",2809775921,CFD," 0,00 "
17/09/2024 13:45:13,Position closed,NSDQ100/USD," 305,75 ",0.307134," 5,76 "," 4.345,73 "," 4.195,74 ",2809772895,CFD," 0,00 "
17/09/2024 13:45:13,Position closed,NSDQ100/USD," 152,38 ",0.153542," 2,39 "," 4.348,12 "," 4.348,12 ",2809765469,CFD," 0,00 "
17/09/2024 13:45:31,Open Position,NSDQ100/USD," 299,99 ",0.306859," 0,00 "," 4.348,12 "," 4.048,13 ",2809778899,CFD," 0,00 "
17/09/2024 13:45:48,Open Position,NSDQ100/USD," 99,99 ",0.102300," 0,00 "," 4.348,12 "," 3.948,14 ",2809779171,CFD," 0,00 "
17/09/2024 13:46:11,Open Position,NSDQ100/USD," 149,99 ",0.153457," 0,00 "," 4.348,12 "," 3.798,15 ",2809779609,CFD," 0,00 "
17/09/2024 13:48:14,Open Position,NSDQ100/USD," 299,99 ",0.306880," 0,00 "," 4.348,12 "," 3.498,16 ",2809783089,CFD," 0,00 "
17/09/2024 13:48:28,Open Position,NSDQ100/USD," 349,99 ",0.358111," 0,00 "," 4.348,12 "," 3.148,17 ",2809783519,CFD," 0,00 "
17/09/2024 13:48:50,Open Position,NSDQ100/USD," 400,00 ",0.409393," 0,00 "," 4.348,12 "," 2.748,17 ",2809783856,CFD," 0,00 "
17/09/2024 13:49:16,Open Position,NSDQ100/USD," 299,99 ",0.307220," 0,00 "," 4.348,12 "," 2.448,18 ",2809784297,CFD," 0,00 "
17/09/2024 13:50:15,Open Position,NSDQ100/USD," 200,00 ",0.205133," 0,00 "," 4.348,12 "," 2.248,18 ",2809785401,CFD," 0,00 "
17/09/2024 13:50:46,Open Position,NSDQ100/USD," 99,99 ",0.102514," 0,00 "," 4.348,12 "," 2.148,19 ",2809786279,CFD," 0,00 "
17/09/2024 13:52:01,Open Position,NSDQ100/USD," 299,99 ",0.307565," 0,00 "," 4.348,12 "," 1.848,20 ",2809823465,CFD," 0,00 "
17/09/2024 13:57:06,Open Position,NSDQ100/USD," 200,00 ",0.205081," 0,00 "," 4.348,12 "," 1.648,20 ",2809831277,CFD," 0,00 "
17/09/2024 13:58:33,Position closed,NSDQ100/USD," 203,11 ",0.205081," 3,11 "," 4.351,23 "," 1.851,31 ",2809831277,CFD," 0,00 "
17/09/2024 13:58:41,Position closed,NSDQ100/USD," 100,87 ",0.102514," 0,88 "," 4.352,11 "," 1.952,18 ",2809786279,CFD," 0,00 "
17/09/2024 13:58:48,Position closed,NSDQ100/USD," 301,36 ",0.307565," 1,37 "," 4.353,48 "," 2.253,54 ",2809823465,CFD," 0,00 "
17/09/2024 13:58:53,Position closed,NSDQ100/USD," 202,52 ",0.205133," 2,52 "," 4.356,00 "," 2.456,06 ",2809785401,CFD," 0,00 "
17/09/2024 13:59:32,Open Position,NSDQ100/USD," 299,98 ",0.307319," 0,00 "," 4.356,00 "," 2.156,08 ",2809836018,CFD," 0,00 "
17/09/2024 14:03:33,Position closed,NSDQ100/USD," 301,23 ",0.307319," 1,25 "," 4.357,25 "," 2.457,31 ",2809836018,CFD," 0,00 "
17/09/2024 14:03:48,Position closed,NSDQ100/USD," 300,50 ",0.307220," 0,51 "," 4.357,76 "," 2.757,81 ",2809784297,CFD," 0,00 "
17/09/2024 14:06:30,Position closed,NSDQ100/USD," 398,76 ",0.409393,"(1,24)"," 4.356,52 "," 3.156,57 ",2809783856,CFD," 0,00 "
17/09/2024 14:07:03,Open Position,NSDQ100/USD," 200,00 ",0.204613," 0,00 "," 4.356,52 "," 2.956,57 ",2809858021,CFD," 0,00 "
17/09/2024 14:07:25,Open Position,NSDQ100/USD," 99,99 ",0.102346," 0,00 "," 4.356,52 "," 2.856,58 ",2809858592,CFD," 0,00 "
17/09/2024 14:08:19,Position closed,NSDQ100/USD," 101,50 ",0.102346," 1,51 "," 4.358,03 "," 2.958,08 ",2809858592,CFD," 0,00 "
17/09/2024 14:08:32,Position closed,NSDQ100/USD," 202,57 ",0.204613," 2,57 "," 4.360,60 "," 3.160,65 ",2809858021,CFD," 0,00 "
17/09/2024 14:08:48,Position closed,NSDQ100/USD," 100,66 ",0.102300," 0,67 "," 4.361,27 "," 3.261,31 ",2809779171,CFD," 0,00 "
17/09/2024 14:08:48,Position closed,NSDQ100/USD," 301,58 ",0.306880," 1,59 "," 4.362,86 "," 3.562,89 ",2809783089,CFD," 0,00 "
17/09/2024 14:08:48,Position closed,NSDQ100/USD," 151,12 ",0.153457," 1,13 "," 4.363,99 "," 3.714,01 ",2809779609,CFD," 0,00 "
17/09/2024 14:08:48,Position closed,NSDQ100/USD," 301,18 ",0.306859," 1,19 "," 4.365,18 "," 4.015,19 ",2809778899,CFD," 0,00 "
17/09/2024 14:08:48,Position closed,NSDQ100/USD," 353,49 ",0.358111," 3,50 "," 4.368,68 "," 4.368,68 ",2809783519,CFD," 0,00 "
17/09/2024 14:09:12,Open Position,NSDQ100/USD," 299,97 ",0.306781," 0,00 "," 4.368,68 "," 4.068,71 ",2809861456,CFD," 0,00 "
17/09/2024 14:09:23,Open Position,NSDQ100/USD," 200,00 ",0.204557," 0,00 "," 4.368,68 "," 3.868,71 ",2809865193,CFD," 0,00 "
17/09/2024 14:09:49,Open Position,NSDQ100/USD," 299,99 ",0.306770," 0,00 "," 4.368,68 "," 3.568,72 ",2809865681,CFD," 0,00 "
17/09/2024 14:12:52,Open Position,NSDQ100/USD," 299,99 ",0.306509," 0,00 "," 4.368,68 "," 3.268,73 ",2809869509,CFD," 0,00 "
17/09/2024 14:13:10,Position closed,NSDQ100/USD," 300,96 ",0.306770," 0,97 "," 4.369,65 "," 3.569,69 ",2809865681,CFD," 0,00 "
17/09/2024 14:13:48,Open Position,NSDQ100/USD," 299,99 ",0.307019," 0,00 "," 4.369,65 "," 3.269,70 ",2809881510,CFD," 0,00 "
17/09/2024 14:14:13,Open Position,NSDQ100/USD," 99,99 ",0.102275," 0,00 "," 4.369,65 "," 3.169,71 ",2809881924,CFD," 0,00 "
17/09/2024 14:17:29,Position closed,NSDQ100/USD," 302,22 ",0.307019," 2,23 "," 4.371,88 "," 3.471,93 ",2809881510,CFD," 0,00 "
17/09/2024 14:19:55,Position closed,NSDQ100/USD," 200,69 ",0.204557," 0,69 "," 4.372,57 "," 3.672,62 ",2809865193,CFD," 0,00 "
17/09/2024 14:20:36,Open Position,NSDQ100/USD," 399,99 ",0.409470," 0,00 "," 4.372,57 "," 3.272,63 ",2809917403,CFD," 0,00 "
17/09/2024 14:20:57,Open Position,NSDQ100/USD," 99,99 ",0.102339," 0,00 "," 4.372,57 "," 3.172,64 ",2809917849,CFD," 0,00 "
17/09/2024 14:25:52,Position closed,NSDQ100/USD," 302,69 ",0.306781," 2,72 "," 4.375,29 "," 3.475,33 ",2809861456,CFD," 0,00 "
17/09/2024 14:25:52,Position closed,NSDQ100/USD," 101,01 ",0.102275," 1,02 "," 4.376,31 "," 3.576,34 ",2809881924,CFD," 0,00 "
17/09/2024 14:25:52,Position closed,NSDQ100/USD," 296,88 ",0.306509,"(3,11)"," 4.373,20 "," 3.873,22 ",2809869509,CFD," 0,00 "
17/09/2024 14:25:52,Position closed,NSDQ100/USD," 411,44 ",0.409470," 11,45 "," 4.384,65 "," 4.284,66 ",2809917403,CFD," 0,00 "
17/09/2024 14:25:53,Position closed,NSDQ100/USD," 102,28 ",0.102339," 2,29 "," 4.386,94 "," 4.386,94 ",2809917849,CFD," 0,00 "
17/09/2024 14:26:20,Open Position,NSDQ100/USD," 299,99 ",0.306660," 0,00 "," 4.386,94 "," 4.086,95 ",2809924089,CFD," 0,00 "
17/09/2024 14:27:17,Open Position,NSDQ100/USD," 299,99 ",0.306831," 0,00 "," 4.386,94 "," 3.786,96 ",2809924979,CFD," 0,00 "
17/09/2024 14:29:05,Position closed,NSDQ100/USD," 301,61 ",0.306831," 1,62 "," 4.388,56 "," 4.088,57 ",2809924979,CFD," 0,00 "
17/09/2024 14:29:27,Open Position,NSDQ100/USD," 299,99 ",0.306742," 0,00 "," 4.388,56 "," 3.788,58 ",2809939043,CFD," 0,00 "
17/09/2024 14:31:59,Open Position,NSDQ100/USD," 499,99 ",0.511390," 0,00 "," 4.388,56 "," 3.288,59 ",2809945535,CFD," 0,00 "
17/09/2024 14:34:49,Open Position,NSDQ100/USD," 399,98 ",0.409466," 0,00 "," 4.388,56 "," 2.888,61 ",2809960857,CFD," 0,00 "
17/09/2024 14:36:57,Open Position,NSDQ100/USD," 149,99 ",0.153667," 0,00 "," 4.388,56 "," 2.738,62 ",2809965257,CFD," 0,00 "
17/09/2024 14:37:36,Position closed,NSDQ100/USD," 150,77 ",0.153667," 0,78 "," 4.389,34 "," 2.889,39 ",2809965257,CFD," 0,00 "
17/09/2024 14:37:49,Open Position,NSDQ100/USD," 200,00 ",0.204791," 0,00 "," 4.389,34 "," 2.689,39 ",2809966347,CFD," 0,00 "
17/09/2024 14:38:23,Position closed,NSDQ100/USD," 399,80 ",0.409466,"(0,18)"," 4.389,16 "," 3.089,19 ",2809960857,CFD," 0,00 "
17/09/2024 14:38:44,Position closed,NSDQ100/USD," 202,92 ",0.204791," 2,92 "," 4.392,08 "," 3.292,11 ",2809966347,CFD," 0,00 "
17/09/2024 14:39:02,Open Position,NSDQ100/USD," 299,99 ",0.306842," 0,00 "," 4.392,08 "," 2.992,12 ",2809967442,CFD," 0,00 "
17/09/2024 14:42:41,Position closed,NSDQ100/USD," 501,15 ",0.511390," 1,16 "," 4.393,24 "," 3.493,27 ",2809945535,CFD," 0,00 "
17/09/2024 14:42:53,Position closed,NSDQ100/USD," 301,55 ",0.306842," 1,56 "," 4.394,80 "," 3.794,82 ",2809967442,CFD," 0,00 "
17/09/2024 14:42:57,Position closed,NSDQ100/USD," 299,09 ",0.306742,"(0,90)"," 4.393,90 "," 4.093,91 ",2809939043,CFD," 0,00 "
17/09/2024 14:44:08,Open Position,NSDQ100/USD," 149,99 ",0.153327," 0,00 "," 4.393,90 "," 3.943,92 ",2809985244,CFD," 0,00 "
17/09/2024 14:44:30,Position closed,NSDQ100/USD," 300,32 ",0.306660," 0,33 "," 4.394,23 "," 4.244,24 ",2809924089,CFD," 0,00 "
17/09/2024 14:45:18,Position closed,NSDQ100/USD," 154,08 ",0.153327," 4,09 "," 4.398,32 "," 4.398,32 ",2809985244,CFD," 0,00 "
17/09/2024 14:45:30,Open Position,NSDQ100/USD," 200,00 ",0.204117," 0,00 "," 4.398,32 "," 4.198,32 ",2809986437,CFD," 0,00 "
17/09/2024 14:47:12,Position closed,NSDQ100/USD," 199,73 ",0.204117,"(0,27)"," 4.398,05 "," 4.398,05 ",2809986437,CFD," 0,00 "
17/09/2024 14:47:39,Open Position,NSDQ100/USD," 299,99 ",0.306294," 0,00 "," 4.398,05 "," 4.098,06 ",2809988925,CFD," 0,00 "
17/09/2024 14:48:21,Open Position,NSDQ100/USD," 200,00 ",0.204128," 0,00 "," 4.398,05 "," 3.898,06 ",2809990023,CFD," 0,00 "
17/09/2024 14:48:49,Open Position,NSDQ100/USD," 200,00 ",0.204092," 0,00 "," 4.398,05 "," 3.698,06 ",2809990289,CFD," 0,00 "
17/09/2024 14:50:46,Position closed,NSDQ100/USD," 300,80 ",0.306294," 0,81 "," 4.398,86 "," 3.998,86 ",2809988925,CFD," 0,00 "
17/09/2024 14:50:51,Position closed,NSDQ100/USD," 199,32 ",0.204128,"(0,68)"," 4.398,18 "," 4.198,18 ",2809990023,CFD," 0,00 "
17/09/2024 14:51:12,Open Position,NSDQ100/USD," 299,99 ",0.306397," 0,00 "," 4.398,18 "," 3.898,19 ",2809993389,CFD," 0,00 "
17/09/2024 14:55:12,Open Position,NSDQ100/USD," 149,99 ",0.153244," 0,00 "," 4.398,18 "," 3.748,20 ",2809998639,CFD," 0,00 "
17/09/2024 14:56:32,Open Position,NSDQ100/USD," 299,99 ",0.306644," 0,00 "," 4.398,18 "," 3.448,21 ",2810000164,CFD," 0,00 "
17/09/2024 15:01:41,Open Position,NSDQ100/USD," 299,99 ",0.307323," 0,00 "," 4.398,18 "," 3.148,22 ",2810016738,CFD," 0,00 "
17/09/2024 15:01:55,Open Position,NSDQ100/USD," 200,00 ",0.204890," 0,00 "," 4.398,18 "," 2.948,22 ",2810017148,CFD," 0,00 "
17/09/2024 15:02:32,Open Position,NSDQ100/USD," 299,99 ",0.307109," 0,00 "," 4.398,18 "," 2.648,23 ",2810018126,CFD," 0,00 "
17/09/2024 15:04:11,Position closed,NSDQ100/USD," 299,73 ",0.307323,"(0,26)"," 4.397,92 "," 2.947,96 ",2810016738,CFD," 0,00 "
17/09/2024 15:04:21,Position closed,NSDQ100/USD," 200,30 ",0.204890," 0,30 "," 4.398,22 "," 3.148,26 ",2810017148,CFD," 0,00 "
17/09/2024 15:04:43,Open Position,NSDQ100/USD," 400,00 ",0.409865," 0,00 "," 4.398,22 "," 2.748,26 ",2810020655,CFD," 0,00 "
17/09/2024 15:05:26,Position closed,NSDQ100/USD," 404,95 ",0.409865," 4,95 "," 4.403,17 "," 3.153,21 ",2810020655,CFD," 0,00 "
17/09/2024 15:07:03,Open Position,NSDQ100/USD," 299,99 ",0.307153," 0,00 "," 4.403,17 "," 2.853,22 ",2810022796,CFD," 0,00 "
17/09/2024 15:09:19,Position closed,NSDQ100/USD," 300,87 ",0.307109," 0,88 "," 4.404,05 "," 3.154,09 ",2810018126,CFD," 0,00 "
17/09/2024 15:10:33,Position closed,NSDQ100/USD," 302,31 ",0.307153," 2,32 "," 4.406,37 "," 3.456,40 ",2810022796,CFD," 0,00 "
17/09/2024 15:11:00,Open Position,NSDQ100/USD," 299,99 ",0.306942," 0,00 "," 4.406,37 "," 3.156,41 ",2810026492,CFD," 0,00 "
17/09/2024 15:12:49,Open Position,NSDQ100/USD," 299,97 ",0.306961," 0,00 "," 4.406,37 "," 2.856,44 ",2810028964,CFD," 0,00 "
17/09/2024 15:13:17,Position closed,NSDQ100/USD," 300,33 ",0.306961," 0,36 "," 4.406,73 "," 3.156,77 ",2810028964,CFD," 0,00 "
17/09/2024 15:14:37,Open Position,NSDQ100/USD," 299,99 ",0.306781," 0,00 "," 4.406,73 "," 2.856,78 ",2810036418,CFD," 0,00 "
17/09/2024 15:14:42,Position closed,NSDQ100/USD," 302,47 ",0.306942," 2,48 "," 4.409,21 "," 3.159,25 ",2810026492,CFD," 0,00 "
17/09/2024 15:15:08,Position closed,NSDQ100/USD," 299,09 ",0.306781,"(0,90)"," 4.408,31 "," 3.458,34 ",2810036418,CFD," 0,00 "
17/09/2024 15:17:07,Position closed,NSDQ100/USD," 300,56 ",0.306644," 0,57 "," 4.408,88 "," 3.758,90 ",2810000164,CFD," 0,00 "
17/09/2024 15:18:10,Open Position,NSDQ100/USD," 299,99 ",0.306707," 0,00 "," 4.408,88 "," 3.458,91 ",2810040726,CFD," 0,00 "
17/09/2024 15:18:27,Open Position,NSDQ100/USD," 200,00 ",0.204529," 0,00 "," 4.408,88 "," 3.258,91 ",2810040889,CFD," 0,00 "
17/09/2024 15:18:55,Open Position,NSDQ100/USD," 149,99 ",0.153359," 0,00 "," 4.408,88 "," 3.108,92 ",2810041257,CFD," 0,00 "
17/09/2024 15:21:17,Open Position,NSDQ100/USD," 400,00 ",0.409648," 0,00 "," 4.408,88 "," 2.708,92 ",2810046737,CFD," 0,00 "
17/09/2024 15:24:10,Position closed,NSDQ100/USD," 402,48 ",0.409648," 2,48 "," 4.411,36 "," 3.111,40 ",2810046737,CFD," 0,00 "
17/09/2024 15:24:33,Open Position,NSDQ100/USD," 299,99 ",0.307035," 0,00 "," 4.411,36 "," 2.811,41 ",2810050148,CFD," 0,00 "
17/09/2024 15:26:36,Open Position,NSDQ100/USD," 499,99 ",0.511799," 0,00 "," 4.411,36 "," 2.311,42 ",2810052366,CFD," 0,00 "
17/09/2024 15:39:53,Open Position,NSDQ100/USD," 580,00 ",0.594407," 0,00 "," 4.411,36 "," 1.731,42 ",2810083484,CFD," 0,00 "
17/09/2024 15:42:58,Position closed,NSDQ100/USD," 578,20 ",0.594407,"(1,80)"," 4.409,56 "," 2.309,62 ",2810083484,CFD," 0,00 "
17/09/2024 15:45:28,Open Position,NSDQ100/USD," 200,00 ",0.204939," 0,00 "," 4.409,56 "," 2.109,62 ",2810086561,CFD," 0,00 "
17/09/2024 15:46:40,Position closed,NSDQ100/USD," 201,76 ",0.204939," 1,76 "," 4.411,32 "," 2.311,38 ",2810086561,CFD," 0,00 "
17/09/2024 15:48:28,Open Position,NSDQ100/USD," 299,99 ",0.307331," 0,00 "," 4.411,32 "," 2.011,39 ",2810091385,CFD," 0,00 "
17/09/2024 15:51:31,Position closed,NSDQ100/USD," 301,30 ",0.307331," 1,31 "," 4.412,63 "," 2.312,69 ",2810091385,CFD," 0,00 "
17/09/2024 15:56:54,Open Position,NSDQ100/USD," 299,98 ",0.307287," 0,00 "," 4.412,63 "," 2.012,71 ",2810095878,CFD," 0,00 "
17/09/2024 15:57:27,Position closed,NSDQ100/USD," 302,00 ",0.307287," 2,02 "," 4.414,65 "," 2.314,71 ",2810095878,CFD," 0,00 "
17/09/2024 16:02:58,Position closed,NSDQ100/USD," 498,13 ",0.511799,"(1,86)"," 4.412,79 "," 2.812,84 ",2810052366,CFD," 0,00 "
17/09/2024 16:04:49,Open Position,NSDQ100/USD," 350,00 ",0.358574," 0,00 "," 4.412,79 "," 2.462,84 ",2810103136,CFD," 0,00 "
17/09/2024 16:05:38,Position closed,NSDQ100/USD," 352,43 ",0.358574," 2,43 "," 4.415,22 "," 2.815,27 ",2810103136,CFD," 0,00 "
17/09/2024 16:08:12,Open Position,NSDQ100/USD," 350,00 ",0.358635," 0,00 "," 4.415,22 "," 2.465,27 ",2810104656,CFD," 0,00 "
17/09/2024 16:10:03,Open Position,NSDQ100/USD," 299,99 ",0.307491," 0,00 "," 4.415,22 "," 2.165,28 ",2810105331,CFD," 0,00 "
17/09/2024 16:21:50,Open Position,NSDQ100/USD," 149,99 ",0.154202," 0,00 "," 4.415,22 "," 2.015,29 ",2810112486,CFD," 0,00 "
17/09/2024 16:22:04,Position closed,NSDQ100/USD," 148,46 ",0.154202,"(1,53)"," 4.413,69 "," 2.163,75 ",2810112486,CFD," 0,00 "
17/09/2024 16:29:53,Open Position,NSDQ100/USD," 299,99 ",0.308419," 0,00 "," 4.413,69 "," 1.863,76 ",2810118655,CFD," 0,00 "
17/09/2024 16:51:30,Open Position,NSDQ100/USD," 299,99 ",0.309477," 0,00 "," 4.413,69 "," 1.563,77 ",2810132771,CFD," 0,00 "
17/09/2024 16:54:58,Position closed,NSDQ100/USD," 302,65 ",0.309477," 2,66 "," 4.416,35 "," 1.866,42 ",2810132771,CFD," 0,00 "
17/09/2024 17:02:19,Open Position,NSDQ100/USD," 299,99 ",0.309359," 0,00 "," 4.416,35 "," 1.566,43 ",2810143034,CFD," 0,00 "
17/09/2024 17:04:08,Open Position,NSDQ100/USD," 299,99 ",0.309399," 0,00 "," 4.416,35 "," 1.266,44 ",2810143727,CFD," 0,00 "
17/09/2024 17:05:46,Position closed,NSDQ100/USD," 301,22 ",0.309399," 1,23 "," 4.417,58 "," 1.567,66 ",2810143727,CFD," 0,00 "
17/09/2024 17:05:51,Position closed,NSDQ100/USD," 300,30 ",0.309359," 0,31 "," 4.417,89 "," 1.867,96 ",2810143034,CFD," 0,00 "
17/09/2024 17:07:33,Open Position,NSDQ100/USD," 299,99 ",0.309452," 0,00 "," 4.417,89 "," 1.567,97 ",2810145150,CFD," 0,00 "
17/09/2024 17:08:48,Position closed,NSDQ100/USD," 301,32 ",0.309452," 1,33 "," 4.419,22 "," 1.869,29 ",2810145150,CFD," 0,00 "
17/09/2024 17:11:03,Open Position,NSDQ100/USD," 299,99 ",0.309523," 0,00 "," 4.419,22 "," 1.569,30 ",2810147025,CFD," 0,00 "
17/09/2024 17:11:29,Open Position,NSDQ100/USD," 299,99 ",0.309594," 0,00 "," 4.419,22 "," 1.269,31 ",2810147297,CFD," 0,00 "
17/09/2024 17:13:32,Position closed,NSDQ100/USD," 300,95 ",0.309523," 0,96 "," 4.420,18 "," 1.570,26 ",2810147025,CFD," 0,00 "
17/09/2024 17:13:49,Position closed,NSDQ100/USD," 304,75 ",0.309594," 4,76 "," 4.424,94 "," 1.875,01 ",2810147297,CFD," 0,00 "
17/09/2024 17:28:18,Position closed,NSDQ100/USD," 294,96 ",0.308419,"(5,03)"," 4.419,91 "," 2.169,97 ",2810118655,CFD," 0,00 "
17/09/2024 17:29:45,Open Position,NSDQ100/USD," 200,00 ",0.205832," 0,00 "," 4.419,91 "," 1.969,97 ",2810156699,CFD," 0,00 "
17/09/2024 17:32:06,Position closed,NSDQ100/USD," 199,92 ",0.205832,"(0,08)"," 4.419,83 "," 2.169,89 ",2810156699,CFD," 0,00 "
17/09/2024 17:33:25,Open Position,NSDQ100/USD," 400,00 ",0.411778," 0,00 "," 4.419,83 "," 1.769,89 ",2810159041,CFD," 0,00 "
17/09/2024 17:48:08,Open Position,NSDQ100/USD," 299,99 ",0.309704," 0,00 "," 4.419,83 "," 1.469,90 ",2810167252,CFD," 0,00 "
17/09/2024 17:50:35,Position closed,NSDQ100/USD," 307,79 ",0.309704," 7,80 "," 4.427,63 "," 1.777,69 ",2810167252,CFD," 0,00 "
17/09/2024 18:04:46,Position closed,NSDQ100/USD," 398,64 ",0.411778,"(1,36)"," 4.426,27 "," 2.176,33 ",2810159041,CFD," 0,00 "
17/09/2024 18:14:03,Open Position,NSDQ100/USD," 299,97 ",0.309058," 0,00 "," 4.426,27 "," 1.876,36 ",2810179622,CFD," 0,00 "
17/09/2024 18:19:46,Open Position,NSDQ100/USD," 200,00 ",0.206078," 0,00 "," 4.426,27 "," 1.676,36 ",2810182860,CFD," 0,00 "
17/09/2024 18:20:59,Open Position,NSDQ100/USD," 299,99 ",0.309252," 0,00 "," 4.426,27 "," 1.376,37 ",2810183276,CFD," 0,00 "
17/09/2024 18:21:28,Position closed,NSDQ100/USD," 304,10 ",0.309252," 4,11 "," 4.430,38 "," 1.680,47 ",2810183276,CFD," 0,00 "
17/09/2024 18:21:34,Position closed,NSDQ100/USD," 301,48 ",0.309058," 1,51 "," 4.431,89 "," 1.981,95 ",2810179622,CFD," 0,00 "
17/09/2024 18:21:44,Position closed,NSDQ100/USD," 201,98 ",0.206078," 1,98 "," 4.433,87 "," 2.183,93 ",2810182860,CFD," 0,00 "
17/09/2024 18:26:12,Open Position,NSDQ100/USD," 250,00 ",0.257295," 0,00 "," 4.433,87 "," 1.933,93 ",2810184765,CFD," 0,00 "
17/09/2024 18:28:12,Open Position,NSDQ100/USD," 489,99 ",0.505105," 0,00 "," 4.433,87 "," 1.443,94 ",2810185208,CFD," 0,00 "
17/09/2024 18:28:50,Position closed,NSDQ100/USD," 496,80 ",0.505105," 6,81 "," 4.440,68 "," 1.940,74 ",2810185208,CFD," 0,00 "
17/09/2024 18:29:28,Open Position,NSDQ100/USD," 200,00 ",0.205975," 0,00 "," 4.440,68 "," 1.740,74 ",2810185736,CFD," 0,00 "
17/09/2024 18:30:12,Open Position,NSDQ100/USD," 439,99 ",0.453379," 0,00 "," 4.440,68 "," 1.300,75 ",2810186223,CFD," 0,00 "
17/09/2024 18:30:34,Open Position,NSDQ100/USD," 200,00 ",0.206129," 0,00 "," 4.440,68 "," 1.100,75 ",2810186554,CFD," 0,00 "
17/09/2024 18:33:48,Position closed,NSDQ100/USD," 440,39 ",0.453379," 0,40 "," 4.441,08 "," 1.541,14 ",2810186223,CFD," 0,00 "
17/09/2024 18:34:24,Position closed,NSDQ100/USD," 200,97 ",0.206129," 0,97 "," 4.442,05 "," 1.742,11 ",2810186554,CFD," 0,00 "
17/09/2024 18:34:44,Open Position,NSDQ100/USD," 299,99 ",0.309096," 0,00 "," 4.442,05 "," 1.442,12 ",2810189893,CFD," 0,00 "
17/09/2024 18:36:02,Open Position,NSDQ100/USD," 370,00 ",0.381170," 0,00 "," 4.442,05 "," 1.072,12 ",2810190228,CFD," 0,00 "
17/09/2024 18:37:37,Position closed,NSDQ100/USD," 199,50 ",0.205975,"(0,50)"," 4.441,55 "," 1.271,62 ",2810185736,CFD," 0,00 "
17/09/2024 18:37:55,Open Position,NSDQ100/USD," 319,99 ",0.329640," 0,00 "," 4.441,55 "," 951,63 ",2810190913,CFD," 0,00 "
17/09/2024 18:41:38,Open Position,NSDQ100/USD," 240,00 ",0.247253," 0,00 "," 4.441,55 "," 711,63 ",2810192255,CFD," 0,00 "
17/09/2024 18:44:45,Position closed,NSDQ100/USD," 247,12 ",0.257295,"(2,88)"," 4.438,67 "," 958,75 ",2810184765,CFD," 0,00 "
17/09/2024 18:44:50,Position closed,NSDQ100/USD," 302,99 ",0.309096," 3,00 "," 4.441,67 "," 1.261,74 ",2810189893,CFD," 0,00 "
17/09/2024 18:44:56,Position closed,NSDQ100/USD," 373,05 ",0.381170," 3,05 "," 4.444,72 "," 1.634,79 ",2810190228,CFD," 0,00 "
17/09/2024 18:45:01,Position closed,NSDQ100/USD," 321,93 ",0.329640," 1,94 "," 4.446,66 "," 1.956,72 ",2810190913,CFD," 0,00 "
17/09/2024 18:45:06,Position closed,NSDQ100/USD," 242,03 ",0.247253," 2,03 "," 4.448,69 "," 2.198,75 ",2810192255,CFD," 0,00 "
17/09/2024 18:45:54,Open Position,NSDQ100/USD," 550,00 ",0.566519," 0,00 "," 4.448,69 "," 1.648,75 ",2810194277,CFD," 0,00 "
17/09/2024 18:46:07,Open Position,NSDQ100/USD," 420,00 ",0.432813," 0,00 "," 4.448,69 "," 1.228,75 ",2810194377,CFD," 0,00 "
17/09/2024 18:47:00,Open Position,NSDQ100/USD," 200,00 ",0.206063," 0,00 "," 4.448,69 "," 1.028,75 ",2810194927,CFD," 0,00 "
17/09/2024 18:47:17,Open Position,NSDQ100/USD," 259,99 ",0.267915," 0,00 "," 4.448,69 "," 768,76 ",2810195007,CFD," 0,00 "
17/09/2024 18:58:17,Open Position,NSDQ100/USD," 299,99 ",0.309432," 0,00 "," 4.448,69 "," 468,77 ",2810199190,CFD," 0,00 "
17/09/2024 20:06:31,Position closed,NSDQ100/USD," 314,51 ",0.309432," 14,52 "," 4.463,21 "," 783,28 ",2810199190,CFD," 0,00 "
17/09/2024 20:06:38,Position closed,NSDQ100/USD," 267,69 ",0.267915," 7,70 "," 4.470,91 "," 1.050,97 ",2810195007,CFD," 0,00 "
17/09/2024 20:06:45,Position closed,NSDQ100/USD," 205,59 ",0.206063," 5,59 "," 4.476,50 "," 1.256,56 ",2810194927,CFD," 0,00 "
17/09/2024 20:06:54,Position closed,NSDQ100/USD," 562,94 ",0.566519," 12,94 "," 4.489,44 "," 1.819,50 ",2810194277,CFD," 0,00 "
17/09/2024 20:07:25,Position closed,NSDQ100/USD," 433,82 ",0.432813," 13,82 "," 4.503,26 "," 2.253,32 ",2810194377,CFD," 0,00 "
17/09/2024 20:08:14,Open Position,NSDQ100/USD," 300,00 ",0.308668," 0,00 "," 4.503,26 "," 1.953,32 ",2810230598,CFD," 0,00 "
17/09/2024 20:11:06,Open Position,NSDQ100/USD," 300,00 ",0.308633," 0,00 "," 4.503,26 "," 1.653,32 ",2810230758,CFD," 0,00 "
17/09/2024 20:18:10,Position closed,NSDQ100/USD," 303,17 ",0.308668," 3,17 "," 4.506,43 "," 1.956,49 ",2810230598,CFD," 0,00 "
17/09/2024 20:18:17,Position closed,NSDQ100/USD," 302,49 ",0.308633," 2,49 "," 4.508,92 "," 2.258,98 ",2810230758,CFD," 0,00 "
17/09/2024 20:19:56,Open Position,NSDQ100/USD," 300,00 ",0.308406," 0,00 "," 4.508,92 "," 1.958,98 ",2810231197,CFD," 0,00 "
17/09/2024 20:49:22,Open Position,NSDQ100/USD," 119,99 ",0.123424," 0,00 "," 4.508,92 "," 1.838,99 ",2810232803,CFD," 0,00 "
17/09/2024 20:52:21,Open Position,NSDQ100/USD," 149,99 ",0.154296," 0,00 "," 4.508,92 "," 1.689,00 ",2810232937,CFD," 0,00 "
17/09/2024 20:55:52,Position closed,NSDQ100/USD," 120,23 ",0.123424," 0,24 "," 4.509,16 "," 1.809,23 ",2810232803,CFD," 0,00 "
17/09/2024 20:56:31,Open Position,NSDQ100/USD," 349,99 ",0.360107," 0,00 "," 4.509,16 "," 1.459,24 ",2810233090,CFD," 0,00 "
17/09/2024 20:57:24,Open Position,NSDQ100/USD," 100,00 ",0.102877," 0,00 "," 4.509,16 "," 1.359,24 ",2810233121,CFD," 0,00 "
17/09/2024 22:51:50,Position closed,NSDQ100/USD," 344,44 ",0.360107,"(5,55)"," 4.503,61 "," 1.703,68 ",2810233090,CFD," 0,00 "
17/09/2024 22:52:06,Open Position,NSDQ100/USD," 300,00 ",0.308391," 0,00 "," 4.503,61 "," 1.403,68 ",2810235825,CFD," 0,00 "
18/09/2024 00:48:39,Overnight refund,Daily," 0,04 ",-," 0,04 "," 4.503,65 "," 1.403,72 ",2810233090,CFD," 0,00 "
18/09/2024 00:48:39,Overnight fee,Daily,"(0,53)",-,"(0,53)"," 4.503,12 "," 1.403,19 ",2810233121,CFD," 0,00 "
18/09/2024 00:48:39,Overnight fee,Daily,"(0,78)",-,"(0,78)"," 4.502,34 "," 1.402,41 ",2809998639,CFD," 0,00 "
18/09/2024 00:48:39,Overnight fee,Daily,"(0,78)",-,"(0,78)"," 4.501,56 "," 1.401,63 ",2810041257,CFD," 0,00 "
18/09/2024 00:48:39,Overnight fee,Daily,"(0,79)",-,"(0,79)"," 4.500,77 "," 1.400,84 ",2810232937,CFD," 0,00 "
18/09/2024 00:48:39,Overnight fee,Daily,"(1,04)",-,"(1,04)"," 4.499,73 "," 1.399,80 ",2809990289,CFD," 0,00 "
18/09/2024 00:48:39,Overnight fee,Daily,"(1,05)",-,"(1,05)"," 4.498,68 "," 1.398,75 ",2810040889,CFD," 0,00 "
18/09/2024 00:48:39,Overnight fee,Daily,"(1,57)",-,"(1,57)"," 4.497,11 "," 1.397,18 ",2810105331,CFD," 0,00 "
18/09/2024 00:48:39,Overnight fee,Daily,"(1,57)",-,"(1,57)"," 4.495,54 "," 1.395,61 ",2809993389,CFD," 0,00 "
18/09/2024 00:48:39,Overnight fee,Daily,"(1,57)",-,"(1,57)"," 4.493,97 "," 1.394,04 ",2810050148,CFD," 0,00 "
18/09/2024 00:48:39,Overnight fee,Daily,"(1,57)",-,"(1,57)"," 4.492,40 "," 1.392,47 ",2810040726,CFD," 0,00 "
18/09/2024 00:48:39,Overnight fee,Daily,"(1,58)",-,"(1,58)"," 4.490,82 "," 1.390,89 ",2810231197,CFD," 0,00 "
18/09/2024 00:48:39,Overnight fee,Daily,"(1,84)",-,"(1,84)"," 4.488,98 "," 1.389,05 ",2810104656,CFD," 0,00 "
18/09/2024 06:31:14,Position closed,NSDQ100/USD," 303,76 ",0.308391," 3,76 "," 4.492,74 "," 1.692,81 ",2810235825,CFD," 0,00 "
18/09/2024 06:35:54,Position closed,NSDQ100/USD," 303,08 ",0.308406," 3,08 "," 4.495,82 "," 1.995,89 ",2810231197,CFD," 0,00 "
18/09/2024 06:36:13,Position closed,NSDQ100/USD," 153,01 ",0.154296," 3,02 "," 4.498,84 "," 2.148,90 ",2810232937,CFD," 0,00 "
18/09/2024 06:36:20,Position closed,NSDQ100/USD," 102,26 ",0.102877," 2,26 "," 4.501,10 "," 2.251,16 ",2810233121,CFD," 0,00 "
18/09/2024 06:38:51,Open Position,NSDQ100/USD," 300,00 ",0.308192," 0,00 "," 4.501,10 "," 1.951,16 ",2810253849,CFD," 0,00 "
18/09/2024 06:59:19,Open Position,NSDQ100/USD," 249,99 ",0.256771," 0,00 "," 4.501,10 "," 1.701,17 ",2810255134,CFD," 0,00 "
18/09/2024 07:27:09,Open Position,NSDQ100/USD," 399,99 ",0.410992," 0,00 "," 4.501,10 "," 1.301,18 ",2810285978,CFD," 0,00 "
18/09/2024 07:54:56,Open Position,NSDQ100/USD," 199,99 ",0.205623," 0,00 "," 4.501,10 "," 1.101,19 ",2810292169,CFD," 0,00 "
18/09/2024 08:05:18,Open Position,NSDQ100/USD," 100,00 ",0.102878," 0,00 "," 4.501,10 "," 1.001,19 ",2810293739,CFD," 0,00 "
18/09/2024 09:48:45,Position closed,NSDQ100/USD," 200,11 ",0.205623," 0,12 "," 4.501,22 "," 1.201,30 ",2810292169,CFD," 0,00 "
18/09/2024 09:49:17,Position closed,NSDQ100/USD," 101,47 ",0.102878," 1,47 "," 4.502,69 "," 1.302,77 ",2810293739,CFD," 0,00 "
18/09/2024 11:04:44,Position closed,NSDQ100/USD," 400,39 ",0.410992," 0,40 "," 4.503,09 "," 1.703,16 ",2810285978,CFD," 0,00 "
18/09/2024 11:28:59,Position closed,NSDQ100/USD," 300,46 ",0.308192," 0,46 "," 4.503,55 "," 2.003,62 ",2810253849,CFD," 0,00 "
18/09/2024 11:29:40,Open Position,NSDQ100/USD," 199,99 ",0.205380," 0,00 "," 4.503,55 "," 1.803,63 ",2810332910,CFD," 0,00 "
18/09/2024 11:36:06,Open Position,NSDQ100/USD," 300,00 ",0.308087," 0,00 "," 4.503,55 "," 1.503,63 ",2810334056,CFD," 0,00 "
18/09/2024 11:44:20,Open Position,NSDQ100/USD," 300,00 ",0.308293," 0,00 "," 4.503,55 "," 1.203,63 ",2810335922,CFD," 0,00 "
18/09/2024 12:48:33,Position closed,NSDQ100/USD," 303,66 ",0.308293," 3,66 "," 4.507,21 "," 1.507,29 ",2810335922,CFD," 0,00 "
18/09/2024 13:15:12,Open Position,NSDQ100/USD," 379,99 ",0.389946," 0,00 "," 4.507,21 "," 1.127,30 ",2810354970,CFD," 0,00 "
18/09/2024 13:16:11,Position closed,NSDQ100/USD," 302,89 ",0.308087," 2,89 "," 4.510,10 "," 1.430,19 ",2810334056,CFD," 0,00 "
18/09/2024 13:16:16,Position closed,NSDQ100/USD," 252,58 ",0.256771," 2,59 "," 4.512,69 "," 1.682,77 ",2810255134,CFD," 0,00 "
18/09/2024 13:16:22,Position closed,NSDQ100/USD," 201,30 ",0.205380," 1,31 "," 4.514,00 "," 1.884,07 ",2810332910,CFD," 0,00 "
18/09/2024 13:22:31,Open Position,NSDQ100/USD," 199,99 ",0.205238," 0,00 "," 4.514,00 "," 1.684,08 ",2810357697,CFD," 0,00 "
18/09/2024 13:23:18,Open Position,NSDQ100/USD," 249,99 ",0.256560," 0,00 "," 4.514,00 "," 1.434,09 ",2810357771,CFD," 0,00 "
18/09/2024 13:35:41,Open Position,NSDQ100/USD," 249,99 ",0.257088," 0,00 "," 4.514,00 "," 1.184,10 ",2810405133,CFD," 0,00 "
18/09/2024 13:36:49,Position closed,NSDQ100/USD," 248,21 ",0.257088,"(1,78)"," 4.512,22 "," 1.432,31 ",2810405133,CFD," 0,00 "
18/09/2024 13:37:10,Open Position,NSDQ100/USD," 200,00 ",0.205568," 0,00 "," 4.512,22 "," 1.232,31 ",2810406877,CFD," 0,00 "
18/09/2024 13:38:28,Open Position,NSDQ100/USD," 199,99 ",0.205838," 0,00 "," 4.512,22 "," 1.032,32 ",2810408265,CFD," 0,00 "
18/09/2024 13:41:02,Position closed,NSDQ100/USD," 203,53 ",0.205838," 3,54 "," 4.515,76 "," 1.235,85 ",2810408265,CFD," 0,00 "
18/09/2024 13:42:33,Position closed,NSDQ100/USD," 200,30 ",0.205568," 0,30 "," 4.516,06 "," 1.436,15 ",2810406877,CFD," 0,00 "
18/09/2024 13:48:28,Open Position,NSDQ100/USD," 299,98 ",0.308616," 0,00 "," 4.516,06 "," 1.136,17 ",2810431155,CFD," 0,00 "
18/09/2024 13:51:05,Position closed,NSDQ100/USD," 304,70 ",0.308616," 4,72 "," 4.520,78 "," 1.440,87 ",2810431155,CFD," 0,00 "
18/09/2024 14:00:17,Open Position,NSDQ100/USD," 149,99 ",0.154152," 0,00 "," 4.520,78 "," 1.290,88 ",2810484470,CFD," 0,00 "
18/09/2024 14:11:27,Open Position,NSDQ100/USD," 149,98 ",0.154345," 0,00 "," 4.520,78 "," 1.140,90 ",2810500458,CFD," 0,00 "
18/09/2024 14:14:26,Open Position,NSDQ100/USD," 99,99 ",0.102930," 0,00 "," 4.520,78 "," 1.040,91 ",2810503646,CFD," 0,00 "
18/09/2024 14:14:48,Position closed,NSDQ100/USD," 149,78 ",0.154345,"(0,20)"," 4.520,58 "," 1.190,69 ",2810500458,CFD," 0,00 "
18/09/2024 14:14:54,Position closed,NSDQ100/USD," 100,53 ",0.102930," 0,54 "," 4.521,12 "," 1.291,22 ",2810503646,CFD," 0,00 "
18/09/2024 14:19:08,Open Position,NSDQ100/USD," 250,00 ",0.257326," 0,00 "," 4.521,12 "," 1.041,22 ",2810508241,CFD," 0,00 "
18/09/2024 14:29:14,Position closed,NSDQ100/USD," 253,37 ",0.257326," 3,37 "," 4.524,49 "," 1.294,59 ",2810508241,CFD," 0,00 "
18/09/2024 14:31:54,Open Position,NSDQ100/USD," 329,99 ",0.339436," 0,00 "," 4.524,49 "," 964,60 ",2810517230,CFD," 0,00 "
18/09/2024 14:32:57,Position closed,NSDQ100/USD," 327,88 ",0.339436,"(2,11)"," 4.522,38 "," 1.292,48 ",2810517230,CFD," 0,00 "
18/09/2024 14:37:26,Open Position,NSDQ100/USD," 329,98 ",0.339600," 0,00 "," 4.522,38 "," 962,50 ",2810520495,CFD," 0,00 "
18/09/2024 14:40:54,Position closed,NSDQ100/USD," 338,57 ",0.339600," 8,59 "," 4.530,97 "," 1.301,07 ",2810520495,CFD," 0,00 "
18/09/2024 14:41:11,Position closed,NSDQ100/USD," 150,00 ",0.154152," 0,01 "," 4.530,98 "," 1.451,07 ",2810484470,CFD," 0,00 "
18/09/2024 15:10:45,Open Position,NSDQ100/USD," 369,98 ",0.380887," 0,00 "," 4.530,98 "," 1.081,09 ",2810562551,CFD," 0,00 "
18/09/2024 15:32:07,Open Position,NSDQ100/USD," 279,98 ",0.288632," 0,00 "," 4.530,98 "," 801,11 ",2810587547,CFD," 0,00 "
18/09/2024 15:36:10,Position closed,NSDQ100/USD," 277,58 ",0.288632,"(2,40)"," 4.528,58 "," 1.078,69 ",2810587547,CFD," 0,00 "
18/09/2024 15:45:48,Open Position,NSDQ100/USD," 200,00 ",0.206405," 0,00 "," 4.528,58 "," 878,69 ",2810595328,CFD," 0,00 "
18/09/2024 16:14:06,Position closed,NSDQ100/USD," 201,77 ",0.206405," 1,77 "," 4.530,35 "," 1.080,46 ",2810595328,CFD," 0,00 "
18/09/2024 16:14:29,Open Position,NSDQ100/USD," 80,00 ",0.082527," 0,00 "," 4.530,35 "," 1.000,46 ",2810612227,CFD," 0,00 "
18/09/2024 16:14:34,Position closed,NSDQ100/USD," 79,91 ",0.082527,"(0,09)"," 4.530,26 "," 1.080,37 ",2810612227,CFD," 0,00 "
18/09/2024 16:15:07,Open Position,NSDQ100/USD," 180,00 ",0.185607," 0,00 "," 4.530,26 "," 900,37 ",2810612454,CFD," 0,00 "
18/09/2024 17:16:52,Position closed,NSDQ100/USD," 188,53 ",0.185607," 8,53 "," 4.538,79 "," 1.088,90 ",2810612454,CFD," 0,00 "
18/09/2024 17:17:01,Position closed,NSDQ100/USD," 375,65 ",0.380887," 5,67 "," 4.544,46 "," 1.464,55 ",2810562551,CFD," 0,00 "
18/09/2024 17:54:44,Open Position,NSDQ100/USD," 200,00 ",0.205697," 0,00 "," 4.544,46 "," 1.264,55 ",2810651582,CFD," 0,00 "
18/09/2024 18:01:47,Position closed,NSDQ100/USD," 318,11 ",0.306707," 18,12 "," 4.562,58 "," 1.582,66 ",2810040726,CFD," 0,00 "
18/09/2024 18:01:47,Position closed,NSDQ100/USD," 204,65 ",0.204092," 4,65 "," 4.567,23 "," 1.787,31 ",2809990289,CFD," 0,00 "
18/09/2024 18:01:47,Position closed,NSDQ100/USD," 156,90 ",0.153244," 6,91 "," 4.574,14 "," 1.944,21 ",2809998639,CFD," 0,00 "
18/09/2024 18:01:47,Position closed,NSDQ100/USD," 312,02 ",0.306397," 12,03 "," 4.586,17 "," 2.256,23 ",2809993389,CFD," 0,00 "
18/09/2024 18:01:47,Position closed,NSDQ100/USD," 213,21 ",0.204529," 13,21 "," 4.599,38 "," 2.469,44 ",2810040889,CFD," 0,00 "
18/09/2024 18:01:47,Position closed,NSDQ100/USD," 324,54 ",0.307035," 24,55 "," 4.623,93 "," 2.793,98 ",2810050148,CFD," 0,00 "
18/09/2024 18:01:47,Position closed,NSDQ100/USD," 159,16 ",0.153359," 9,17 "," 4.633,10 "," 2.953,14 ",2810041257,CFD," 0,00 "
18/09/2024 18:01:47,Position closed,NSDQ100/USD," 387,03 ",0.358635," 37,03 "," 4.670,13 "," 3.340,17 ",2810104656,CFD," 0,00 "
18/09/2024 18:01:47,Position closed,NSDQ100/USD," 227,11 ",0.205238," 27,12 "," 4.697,25 "," 3.567,28 ",2810357697,CFD," 0,00 "
18/09/2024 18:01:47,Position closed,NSDQ100/USD," 333,52 ",0.307491," 33,53 "," 4.730,78 "," 3.900,80 ",2810105331,CFD," 0,00 "
18/09/2024 18:01:47,Position closed,NSDQ100/USD," 283,76 ",0.256560," 33,77 "," 4.764,55 "," 4.184,56 ",2810357771,CFD," 0,00 "
18/09/2024 18:01:47,Position closed,NSDQ100/USD," 430,81 ",0.389946," 50,82 "," 4.815,37 "," 4.615,37 ",2810354970,CFD," 0,00 "
18/09/2024 18:01:47,Position closed,NSDQ100/USD," 236,13 ",0.205697," 36,13 "," 4.851,50 "," 4.851,50 ",2810651582,CFD," 0,00 "
18/09/2024 18:02:55,Open Position,NSDQ100/USD," 149,99 ",0.153125," 0,00 "," 4.851,50 "," 4.701,51 ",2810665519,CFD," 0,00 "
18/09/2024 18:03:31,Position closed,NSDQ100/USD," 150,18 ",0.153125," 0,19 "," 4.851,69 "," 4.851,69 ",2810665519,CFD," 0,00 "
18/09/2024 18:04:54,Open Position,NSDQ100/USD," 49,99 ",0.051101," 0,00 "," 4.851,69 "," 4.801,70 ",2810670089,CFD," 0,00 "
18/09/2024 18:06:32,Open Position,NSDQ100/USD," 299,99 ",0.306462," 0,00 "," 4.851,69 "," 4.501,71 ",2810673806,CFD," 0,00 "
18/09/2024 18:07:15,Position closed,NSDQ100/USD," 50,96 ",0.051101," 0,97 "," 4.852,66 "," 4.552,67 ",2810670089,CFD," 0,00 "
18/09/2024 18:07:15,Position closed,NSDQ100/USD," 302,74 ",0.306462," 2,75 "," 4.855,41 "," 4.855,41 ",2810673806,CFD," 0,00 "
18/09/2024 18:07:49,Open Position,NSDQ100/USD," 299,99 ",0.306441," 0,00 "," 4.855,41 "," 4.555,42 ",2810675914,CFD," 0,00 "
18/09/2024 18:09:47,Open Position,NSDQ100/USD," 299,99 ",0.307046," 0,00 "," 4.855,41 "," 4.255,43 ",2810679882,CFD," 0,00 "
18/09/2024 18:10:12,Open Position,NSDQ100/USD," 250,00 ",0.255792," 0,00 "," 4.855,41 "," 4.005,43 ",2810680726,CFD," 0,00 "
18/09/2024 18:14:56,Open Position,NSDQ100/USD," 299,99 ",0.307791," 0,00 "," 4.855,41 "," 3.705,44 ",2810689935,CFD," 0,00 "
18/09/2024 18:15:17,Open Position,NSDQ100/USD," 200,00 ",0.205054," 0,00 "," 4.855,41 "," 3.505,44 ",2810690385,CFD," 0,00 "
18/09/2024 18:15:30,Open Position,NSDQ100/USD," 149,99 ",0.153825," 0,00 "," 4.855,41 "," 3.355,45 ",2810690620,CFD," 0,00 "
18/09/2024 18:15:53,Open Position,NSDQ100/USD," 299,95 ",0.307545," 0,00 "," 4.855,41 "," 3.055,50 ",2810691045,CFD," 0,00 "
18/09/2024 18:17:30,Open Position,NSDQ100/USD," 250,00 ",0.256131," 0,00 "," 4.855,41 "," 2.805,50 ",2810692968,CFD," 0,00 "
18/09/2024 18:18:22,Position closed,NSDQ100/USD," 290,85 ",0.306441,"(9,14)"," 4.846,27 "," 3.096,35 ",2810675914,CFD," 0,00 "
18/09/2024 18:18:22,Position closed,NSDQ100/USD," 317,25 ",0.307791," 17,26 "," 4.863,53 "," 3.413,60 ",2810689935,CFD," 0,00 "
18/09/2024 18:18:22,Position closed,NSDQ100/USD," 250,68 ",0.255792," 0,68 "," 4.864,21 "," 3.664,28 ",2810680726,CFD," 0,00 "
18/09/2024 18:18:22,Position closed,NSDQ100/USD," 302,68 ",0.307046," 2,69 "," 4.866,90 "," 3.966,96 ",2810679882,CFD," 0,00 "
18/09/2024 18:18:22,Position closed,NSDQ100/USD," 208,77 ",0.205054," 8,77 "," 4.875,67 "," 4.175,73 ",2810690385,CFD," 0,00 "
18/09/2024 18:18:22,Position closed,NSDQ100/USD," 257,32 ",0.256131," 7,32 "," 4.882,99 "," 4.433,05 ",2810692968,CFD," 0,00 "
18/09/2024 18:18:22,Position closed,NSDQ100/USD," 313,19 ",0.307545," 13,24 "," 4.896,23 "," 4.746,24 ",2810691045,CFD," 0,00 "
18/09/2024 18:18:22,Position closed,NSDQ100/USD," 157,24 ",0.153825," 7,25 "," 4.903,48 "," 4.903,48 ",2810690620,CFD," 0,00 "
18/09/2024 18:18:54,Open Position,NSDQ100/USD," 499,99 ",0.511035," 0,00 "," 4.903,48 "," 4.403,49 ",2810702585,CFD," 0,00 "
18/09/2024 18:19:09,Open Position,NSDQ100/USD," 200,00 ",0.204341," 0,00 "," 4.903,48 "," 4.203,49 ",2810711389,CFD," 0,00 "
18/09/2024 18:21:15,Position closed,NSDQ100/USD," 502,99 ",0.511035," 3,00 "," 4.906,48 "," 4.706,48 ",2810702585,CFD," 0,00 "
18/09/2024 18:21:28,Open Position,NSDQ100/USD," 299,99 ",0.306486," 0,00 "," 4.906,48 "," 4.406,49 ",2810715502,CFD," 0,00 "
18/09/2024 18:22:06,Open Position,NSDQ100/USD," 299,98 ",0.306937," 0,00 "," 4.906,48 "," 4.106,51 ",2810731686,CFD," 0,00 "
18/09/2024 18:22:25,Open Position,NSDQ100/USD," 299,98 ",0.307080," 0,00 "," 4.906,48 "," 3.806,53 ",2810731945,CFD," 0,00 "
18/09/2024 18:22:55,Open Position,NSDQ100/USD," 299,99 ",0.307088," 0,00 "," 4.906,48 "," 3.506,54 ",2810732390,CFD," 0,00 "
18/09/2024 18:28:22,Position closed,NSDQ100/USD," 302,81 ",0.307088," 2,82 "," 4.909,30 "," 3.809,35 ",2810732390,CFD," 0,00 "
18/09/2024 18:28:31,Position closed,NSDQ100/USD," 304,98 ",0.307080," 5,00 "," 4.914,30 "," 4.114,33 ",2810731945,CFD," 0,00 "
18/09/2024 18:28:38,Position closed,NSDQ100/USD," 303,22 ",0.306937," 3,24 "," 4.917,54 "," 4.417,55 ",2810731686,CFD," 0,00 "
18/09/2024 18:33:38,Position closed,NSDQ100/USD," 311,16 ",0.306486," 11,17 "," 4.928,71 "," 4.728,71 ",2810715502,CFD," 0,00 "
18/09/2024 18:33:44,Position closed,NSDQ100/USD," 207,27 ",0.204341," 7,27 "," 4.935,98 "," 4.935,98 ",2810711389,CFD," 0,00 "
18/09/2024 18:34:05,Open Position,NSDQ100/USD," 200,00 ",0.203971," 0,00 "," 4.935,98 "," 4.735,98 ",2810749086,CFD," 0,00 "
18/09/2024 18:35:01,Open Position,NSDQ100/USD," 200,00 ",0.203850," 0,00 "," 4.935,98 "," 4.535,98 ",2810751166,CFD," 0,00 "
18/09/2024 18:35:16,Position closed,NSDQ100/USD," 197,34 ",0.203850,"(2,66)"," 4.933,32 "," 4.733,32 ",2810751166,CFD," 0,00 "
18/09/2024 18:38:09,Open Position,NSDQ100/USD," 299,99 ",0.306549," 0,00 "," 4.933,32 "," 4.433,33 ",2810756053,CFD," 0,00 "
18/09/2024 18:38:26,Open Position,NSDQ100/USD," 200,00 ",0.204517," 0,00 "," 4.933,32 "," 4.233,33 ",2810756314,CFD," 0,00 "
18/09/2024 18:39:28,Open Position,NSDQ100/USD," 99,99 ",0.102208," 0,00 "," 4.933,32 "," 4.133,34 ",2810757518,CFD," 0,00 "
18/09/2024 18:41:34,Open Position,NSDQ100/USD," 299,99 ",0.307084," 0,00 "," 4.933,32 "," 3.833,35 ",2810761334,CFD," 0,00 "
18/09/2024 18:41:49,Open Position,NSDQ100/USD," 250,00 ",0.255935," 0,00 "," 4.933,32 "," 3.583,35 ",2810761572,CFD," 0,00 "
18/09/2024 18:42:19,Open Position,NSDQ100/USD," 350,00 ",0.358479," 0,00 "," 4.933,32 "," 3.233,35 ",2810763105,CFD," 0,00 "
18/09/2024 18:43:15,Open Position,SPX500/USD," 199,98 ",0.708178," 0,00 "," 4.933,32 "," 3.033,37 ",2810763974,CFD," 0,00 "
18/09/2024 18:43:42,Open Position,NSDQ100/USD," 350,00 ",0.358848," 0,00 "," 4.933,32 "," 2.683,37 ",2810765185,CFD," 0,00 "
18/09/2024 18:46:05,Open Position,NSDQ100/USD," 119,99 ",0.122897," 0,00 "," 4.933,32 "," 2.563,38 ",2810768869,CFD," 0,00 "
18/09/2024 18:46:22,Position closed,NSDQ100/USD," 357,53 ",0.358848," 7,53 "," 4.940,85 "," 2.920,91 ",2810765185,CFD," 0,00 "
18/09/2024 18:48:29,Position closed,NSDQ100/USD," 354,57 ",0.358479," 4,57 "," 4.945,42 "," 3.275,48 ",2810763105,CFD," 0,00 "
18/09/2024 18:50:05,Open Position,NSDQ100/USD," 299,99 ",0.307310," 0,00 "," 4.945,42 "," 2.975,49 ",2810774466,CFD," 0,00 "
18/09/2024 18:51:24,Open Position,NSDQ100/USD," 249,99 ",0.255959," 0,00 "," 4.945,42 "," 2.725,50 ",2810776592,CFD," 0,00 "
18/09/2024 18:51:50,Position closed,NSDQ100/USD," 308,64 ",0.307310," 8,65 "," 4.954,07 "," 3.034,14 ",2810774466,CFD," 0,00 "
18/09/2024 18:51:58,Position closed,NSDQ100/USD," 122,21 ",0.122897," 2,22 "," 4.956,29 "," 3.156,35 ",2810768869,CFD," 0,00 "
18/09/2024 18:52:05,Position closed,NSDQ100/USD," 304,00 ",0.307084," 4,01 "," 4.960,30 "," 3.460,35 ",2810761334,CFD," 0,00 "
18/09/2024 18:52:14,Position closed,NSDQ100/USD," 98,56 ",0.102208,"(1,43)"," 4.958,87 "," 3.558,91 ",2810757518,CFD," 0,00 "
18/09/2024 18:52:28,Position closed,NSDQ100/USD," 199,83 ",0.204517,"(0,17)"," 4.958,70 "," 3.758,74 ",2810756314,CFD," 0,00 "
18/09/2024 18:52:42,Position closed,NSDQ100/USD," 259,33 ",0.255935," 9,33 "," 4.968,03 "," 4.018,07 ",2810761572,CFD," 0,00 "
18/09/2024 18:52:49,Position closed,NSDQ100/USD," 298,02 ",0.306549,"(1,97)"," 4.966,06 "," 4.316,09 ",2810756053,CFD," 0,00 "
18/09/2024 18:52:58,Position closed,NSDQ100/USD," 258,73 ",0.255959," 8,74 "," 4.974,80 "," 4.574,82 ",2810776592,CFD," 0,00 "
18/09/2024 18:53:14,Open Position,NSDQ100/USD," 250,00 ",0.255547," 0,00 "," 4.974,80 "," 4.324,82 ",2810778749,CFD," 0,00 "
18/09/2024 18:53:37,Open Position,NSDQ100/USD," 119,99 ",0.122651," 0,00 "," 4.974,80 "," 4.204,83 ",2810779049,CFD," 0,00 "
18/09/2024 18:54:25,Position closed,NSDQ100/USD," 249,97 ",0.255547,"(0,03)"," 4.974,77 "," 4.454,80 ",2810778749,CFD," 0,00 "
18/09/2024 18:54:51,Open Position,NSDQ100/USD," 200,00 ",0.204529," 0,00 "," 4.974,77 "," 4.254,80 ",2810780653,CFD," 0,00 "
18/09/2024 18:55:06,Open Position,NSDQ100/USD," 250,00 ",0.255869," 0,00 "," 4.974,77 "," 4.004,80 ",2810780852,CFD," 0,00 "
18/09/2024 18:55:20,Open Position,NSDQ100/USD," 299,99 ",0.306840," 0,00 "," 4.974,77 "," 3.704,81 ",2810781027,CFD," 0,00 "
18/09/2024 18:55:37,Open Position,NSDQ100/USD," 349,98 ",0.357829," 0,00 "," 4.974,77 "," 3.354,83 ",2810781302,CFD," 0,00 "
18/09/2024 18:58:09,Open Position,NSDQ100/USD," 499,99 ",0.511432," 0,00 "," 4.974,77 "," 2.854,84 ",2810783998,CFD," 0,00 "
18/09/2024 18:59:49,Open Position,NSDQ100/USD," 499,99 ",0.512630," 0,00 "," 4.974,77 "," 2.354,85 ",2810786247,CFD," 0,00 "
18/09/2024 19:02:11,Open Position,NSDQ100/USD," 349,99 ",0.360531," 0,00 "," 4.974,77 "," 2.004,86 ",2810789975,CFD," 0,00 "
18/09/2024 19:03:16,Open Position,NSDQ100/USD," 250,00 ",0.257233," 0,00 "," 4.974,77 "," 1.754,86 ",2810793499,CFD," 0,00 "
18/09/2024 19:05:39,Open Position,NSDQ100/USD," 349,99 ",0.361417," 0,00 "," 4.974,77 "," 1.404,87 ",2810798882,CFD," 0,00 "
18/09/2024 19:06:04,Open Position,NSDQ100/USD," 360,00 ",0.371848," 0,00 "," 4.974,77 "," 1.044,87 ",2810799491,CFD," 0,00 "
18/09/2024 19:07:01,Open Position,NSDQ100/USD," 269,99 ",0.279089," 0,00 "," 4.974,77 "," 774,88 ",2810800825,CFD," 0,00 "
18/09/2024 19:08:15,Position closed,NSDQ100/USD," 279,14 ",0.279089," 9,15 "," 4.983,92 "," 1.054,02 ",2810800825,CFD," 0,00 "
18/09/2024 19:10:44,Position closed,NSDQ100/USD," 354,00 ",0.361417," 4,01 "," 4.987,93 "," 1.408,02 ",2810798882,CFD," 0,00 "
18/09/2024 19:11:22,Position closed,NSDQ100/USD," 371,45 ",0.371848," 11,45 "," 4.999,38 "," 1.779,47 ",2810799491,CFD," 0,00 "
18/09/2024 19:11:47,Position closed,NSDQ100/USD," 346,09 ",0.360531,"(3,90)"," 4.995,48 "," 2.125,56 ",2810789975,CFD," 0,00 "
18/09/2024 19:18:39,Open Position,NSDQ100/USD," 299,99 ",0.308540," 0,00 "," 4.995,48 "," 1.825,57 ",2810813978,CFD," 0,00 "
18/09/2024 19:28:28,Position closed,NSDQ100/USD," 319,85 ",0.308540," 19,86 "," 5.015,34 "," 2.145,42 ",2810813978,CFD," 0,00 "
18/09/2024 19:28:35,Position closed,NSDQ100/USD," 265,07 ",0.257233," 15,07 "," 5.030,41 "," 2.410,49 ",2810793499,CFD," 0,00 "
18/09/2024 19:29:21,Open Position,NSDQ100/USD," 400,00 ",0.410738," 0,00 "," 5.030,41 "," 2.010,49 ",2810824009,CFD," 0,00 "
18/09/2024 19:30:48,Position closed,NSDQ100/USD," 499,62 ",0.512630,"(0,37)"," 5.030,04 "," 2.510,11 ",2810786247,CFD," 0,00 "
18/09/2024 19:30:58,Position closed,NSDQ100/USD," 417,57 ",0.410738," 17,57 "," 5.047,61 "," 2.927,68 ",2810824009,CFD," 0,00 "
18/09/2024 19:32:17,Position closed,SPX500/USD," 201,00 ",0.708178," 1,02 "," 5.048,63 "," 3.128,68 ",2810763974,CFD," 0,00 "
18/09/2024 19:32:32,Open Position,NSDQ100/USD," 299,99 ",0.307857," 0,00 "," 5.048,63 "," 2.828,69 ",2810826912,CFD," 0,00 "
18/09/2024 19:32:47,Open Position,NSDQ100/USD," 200,00 ",0.205175," 0,00 "," 5.048,63 "," 2.628,69 ",2810827051,CFD," 0,00 "
18/09/2024 19:33:44,Open Position,NSDQ100/USD," 299,99 ",0.308063," 0,00 "," 5.048,63 "," 2.328,70 ",2810828582,CFD," 0,00 "
18/09/2024 19:34:31,Open Position,NSDQ100/USD," 249,99 ",0.256997," 0,00 "," 5.048,63 "," 2.078,71 ",2810829106,CFD," 0,00 "
18/09/2024 19:37:50,Open Position,NSDQ100/USD," 519,99 ",0.535538," 0,00 "," 5.048,63 "," 1.558,72 ",2810832428,CFD," 0,00 "
18/09/2024 19:38:14,Position closed,NSDQ100/USD," 536,43 ",0.535538," 16,44 "," 5.065,07 "," 2.095,15 ",2810832428,CFD," 0,00 "
18/09/2024 19:38:30,Open Position,NSDQ100/USD," 299,98 ",0.308477," 0,00 "," 5.065,07 "," 1.795,17 ",2810832976,CFD," 0,00 "
18/09/2024 19:38:54,Position closed,NSDQ100/USD," 302,63 ",0.308477," 2,65 "," 5.067,72 "," 2.097,80 ",2810832976,CFD," 0,00 "
18/09/2024 19:39:26,Open Position,NSDQ100/USD," 299,99 ",0.308970," 0,00 "," 5.067,72 "," 1.797,81 ",2810833664,CFD," 0,00 "
18/09/2024 19:39:31,Open Position,NSDQ100/USD," 449,99 ",0.463587," 0,00 "," 5.067,72 "," 1.347,82 ",2810833733,CFD," 0,00 "
18/09/2024 19:39:53,Position closed,NSDQ100/USD," 461,71 ",0.463587," 11,72 "," 5.079,44 "," 1.809,53 ",2810833733,CFD," 0,00 "
18/09/2024 19:40:02,Position closed,NSDQ100/USD," 304,53 ",0.308970," 4,54 "," 5.083,98 "," 2.114,06 ",2810833664,CFD," 0,00 "
18/09/2024 19:40:16,Open Position,NSDQ100/USD," 299,99 ",0.308665," 0,00 "," 5.083,98 "," 1.814,07 ",2810834417,CFD," 0,00 "
18/09/2024 19:40:25,Open Position,NSDQ100/USD," 200,00 ",0.205730," 0,00 "," 5.083,98 "," 1.614,07 ",2810834479,CFD," 0,00 "
18/09/2024 19:41:18,Open Position,NSDQ100/USD," 299,99 ",0.308668," 0,00 "," 5.083,98 "," 1.314,08 ",2810835243,CFD," 0,00 "
18/09/2024 19:42:38,Position closed,NSDQ100/USD," 298,69 ",0.308668,"(1,30)"," 5.082,68 "," 1.612,77 ",2810835243,CFD," 0,00 "
18/09/2024 19:42:52,Position closed,NSDQ100/USD," 298,01 ",0.308665,"(1,98)"," 5.080,70 "," 1.910,78 ",2810834417,CFD," 0,00 "
18/09/2024 19:43:19,Open Position,NSDQ100/USD," 299,99 ",0.308838," 0,00 "," 5.080,70 "," 1.610,79 ",2810836636,CFD," 0,00 "
18/09/2024 19:43:35,Position closed,NSDQ100/USD," 302,15 ",0.308838," 2,16 "," 5.082,86 "," 1.912,94 ",2810836636,CFD," 0,00 "
18/09/2024 19:44:42,Open Position,NSDQ100/USD," 299,99 ",0.309107," 0,00 "," 5.082,86 "," 1.612,95 ",2810837309,CFD," 0,00 "
18/09/2024 19:45:05,Open Position,NSDQ100/USD," 410,00 ",0.423312," 0,00 "," 5.082,86 "," 1.202,95 ",2810837669,CFD," 0,00 "
18/09/2024 19:48:32,Open Position,NSDQ100/USD," 309,99 ",0.320150," 0,00 "," 5.082,86 "," 892,96 ",2810841044,CFD," 0,00 "
18/09/2024 19:49:45,Open Position,NSDQ100/USD," 299,99 ",0.310051," 0,00 "," 5.082,86 "," 592,97 ",2810842284,CFD," 0,00 "
18/09/2024 19:53:05,Position closed,NSDQ100/USD," 302,13 ",0.310051," 2,14 "," 5.085,00 "," 895,10 ",2810842284,CFD," 0,00 "
18/09/2024 20:04:21,Position closed,NSDQ100/USD," 306,68 ",0.320150,"(3,31)"," 5.081,69 "," 1.201,78 ",2810841044,CFD," 0,00 "
18/09/2024 20:12:30,Position closed,NSDQ100/USD," 420,39 ",0.423312," 10,39 "," 5.092,08 "," 1.622,17 ",2810837669,CFD," 0,00 "
18/09/2024 20:37:46,Position closed,NSDQ100/USD," 300,25 ",0.309107," 0,26 "," 5.092,34 "," 1.922,42 ",2810837309,CFD," 0,00 "
18/09/2024 23:59:12,Position closed,NSDQ100/USD," 307,67 ",0.308063," 7,68 "," 5.100,02 "," 2.230,09 ",2810828582,CFD," 0,00 "
18/09/2024 23:59:12,Position closed,NSDQ100/USD," 201,22 ",0.205175," 1,22 "," 5.101,24 "," 2.431,31 ",2810827051,CFD," 0,00 "
18/09/2024 23:59:12,Position closed,NSDQ100/USD," 261,82 ",0.256997," 11,83 "," 5.113,07 "," 2.693,13 ",2810829106,CFD," 0,00 "
18/09/2024 23:59:12,Position closed,NSDQ100/USD," 211,69 ",0.205730," 11,69 "," 5.124,76 "," 2.904,82 ",2810834479,CFD," 0,00 "
18/09/2024 23:59:12,Position closed,NSDQ100/USD," 303,14 ",0.307857," 3,15 "," 5.127,91 "," 3.207,96 ",2810826912,CFD," 0,00 "
19/09/2024 00:28:28,Index price adjustment,NSDQ100/USD," 0,66 ",-," 0,66 "," 5.128,57 "," 3.208,62 ",2810749086,CFD," 0,00 "
19/09/2024 00:28:28,Index price adjustment,NSDQ100/USD," 0,40 ",-," 0,40 "," 5.128,97 "," 3.209,02 ",2810779049,CFD," 0,00 "
19/09/2024 00:28:28,Index price adjustment,NSDQ100/USD," 0,66 ",-," 0,66 "," 5.129,63 "," 3.209,68 ",2810780653,CFD," 0,00 "
19/09/2024 00:28:28,Index price adjustment,NSDQ100/USD," 0,83 ",-," 0,83 "," 5.130,46 "," 3.210,51 ",2810780852,CFD," 0,00 "
19/09/2024 00:28:28,Index price adjustment,NSDQ100/USD," 0,99 ",-," 0,99 "," 5.131,45 "," 3.211,50 ",2810781027,CFD," 0,00 "
19/09/2024 00:28:28,Index price adjustment,NSDQ100/USD," 1,16 ",-," 1,16 "," 5.132,61 "," 3.212,66 ",2810781302,CFD," 0,00 "
19/09/2024 00:28:28,Index price adjustment,NSDQ100/USD," 1,66 ",-," 1,66 "," 5.134,27 "," 3.214,32 ",2810783998,CFD," 0,00 "
19/09/2024 00:28:28,Index price adjustment,NSDQ100/USD," 1,00 ",-," 1,00 "," 5.135,27 "," 3.215,32 ",2810826912,CFD," 0,00 "
19/09/2024 00:28:28,Index price adjustment,NSDQ100/USD," 0,66 ",-," 0,66 "," 5.135,93 "," 3.215,98 ",2810827051,CFD," 0,00 "
19/09/2024 00:28:28,Index price adjustment,NSDQ100/USD," 1,00 ",-," 1,00 "," 5.136,93 "," 3.216,98 ",2810828582,CFD," 0,00 "
19/09/2024 00:28:28,Index price adjustment,NSDQ100/USD," 0,83 ",-," 0,83 "," 5.137,76 "," 3.217,81 ",2810829106,CFD," 0,00 "
19/09/2024 00:28:28,Index price adjustment,NSDQ100/USD," 0,67 ",-," 0,67 "," 5.138,43 "," 3.218,48 ",2810834479,CFD," 0,00 "
19/09/2024 00:28:28,Index price adjustment,NSDQ100/USD," 1,00 ",-," 1,00 "," 5.139,43 "," 3.219,48 ",2810837309,CFD," 0,00 "
19/09/2024 00:28:28,Index price adjustment,NSDQ100/USD," 1,37 ",-," 1,37 "," 5.140,80 "," 3.220,85 ",2810837669,CFD," 0,00 "
19/09/2024 00:28:28,Index price adjustment,NSDQ100/USD," 1,04 ",-," 1,04 "," 5.141,84 "," 3.221,89 ",2810841044,CFD," 0,00 "
19/09/2024 00:48:19,Overnight fee,Daily,"(0,63)",-,"(0,63)"," 5.141,21 "," 3.221,26 ",2810779049,CFD," 0,00 "
19/09/2024 00:48:19,Overnight fee,Daily,"(1,04)",-,"(1,04)"," 5.140,17 "," 3.220,22 ",2810749086,CFD," 0,00 "
19/09/2024 00:48:19,Overnight fee,Daily,"(1,05)",-,"(1,05)"," 5.139,12 "," 3.219,17 ",2810780653,CFD," 0,00 "
19/09/2024 00:48:19,Overnight fee,Daily,"(1,05)",-,"(1,05)"," 5.138,07 "," 3.218,12 ",2810834479,CFD," 0,00 "
19/09/2024 00:48:19,Overnight fee,Daily,"(1,05)",-,"(1,05)"," 5.137,02 "," 3.217,07 ",2810827051,CFD," 0,00 "
19/09/2024 00:48:19,Overnight fee,Daily,"(1,31)",-,"(1,31)"," 5.135,71 "," 3.215,76 ",2810780852,CFD," 0,00 "
19/09/2024 00:48:19,Overnight fee,Daily,"(1,32)",-,"(1,32)"," 5.134,39 "," 3.214,44 ",2810829106,CFD," 0,00 "
19/09/2024 00:48:19,Overnight fee,Daily,"(1,57)",-,"(1,57)"," 5.132,82 "," 3.212,87 ",2810781027,CFD," 0,00 "
19/09/2024 00:48:19,Overnight fee,Daily,"(1,58)",-,"(1,58)"," 5.131,24 "," 3.211,29 ",2810826912,CFD," 0,00 "
19/09/2024 00:48:19,Overnight fee,Daily,"(1,58)",-,"(1,58)"," 5.129,66 "," 3.209,71 ",2810828582,CFD," 0,00 "
19/09/2024 00:48:19,Overnight fee,Daily,"(1,83)",-,"(1,83)"," 5.127,83 "," 3.207,88 ",2810781302,CFD," 0,00 "
19/09/2024 00:48:19,Overnight fee,Daily,"(2,62)",-,"(2,62)"," 5.125,21 "," 3.205,26 ",2810783998,CFD," 0,00 "
19/09/2024 06:18:03,Position closed,NSDQ100/USD," 127,78 ",0.122651," 7,79 "," 5.133,00 "," 3.333,04 ",2810779049,CFD," 0,00 "
19/09/2024 06:18:03,Position closed,NSDQ100/USD," 215,16 ",0.204529," 15,16 "," 5.148,16 "," 3.548,20 ",2810780653,CFD," 0,00 "
19/09/2024 06:18:03,Position closed,NSDQ100/USD," 204,20 ",0.203971," 4,20 "," 5.152,36 "," 3.752,40 ",2810749086,CFD," 0,00 "
19/09/2024 06:18:03,Position closed,NSDQ100/USD," 273,03 ",0.255869," 23,03 "," 5.175,39 "," 4.025,43 ",2810780852,CFD," 0,00 "
19/09/2024 06:18:03,Position closed,NSDQ100/USD," 374,82 ",0.357829," 24,84 "," 5.200,23 "," 4.400,25 ",2810781302,CFD," 0,00 "
19/09/2024 06:18:03,Position closed,NSDQ100/USD," 540,05 ",0.511432," 40,06 "," 5.240,29 "," 4.940,30 ",2810783998,CFD," 0,00 "
19/09/2024 06:18:03,Position closed,NSDQ100/USD," 323,65 ",0.306840," 23,66 "," 5.263,95 "," 5.263,95 ",2810781027,CFD," 0,00 "
19/09/2024 06:19:14,Open Position,NSDQ100/USD," 249,99 ",0.254661," 0,00 "," 5.263,95 "," 5.013,96 ",2810902345,CFD," 0,00 "
19/09/2024 06:24:55,Position closed,NSDQ100/USD," 254,26 ",0.254661," 4,27 "," 5.268,22 "," 5.268,22 ",2810902345,CFD," 0,00 "
19/09/2024 06:25:11,Open Position,NSDQ100/USD," 100,00 ",0.101669," 0,00 "," 5.268,22 "," 5.168,22 ",2810903242,CFD," 0,00 "
19/09/2024 06:25:25,Position closed,NSDQ100/USD," 99,08 ",0.101669,"(0,92)"," 5.267,30 "," 5.267,30 ",2810903242,CFD," 0,00 "
19/09/2024 06:43:12,Open Position,NSDQ100/USD," 300,00 ",0.304954," 0,00 "," 5.267,30 "," 4.967,30 ",2810909011,CFD," 0,00 "
19/09/2024 06:44:08,Position closed,NSDQ100/USD," 298,16 ",0.304954,"(1,84)"," 5.265,46 "," 5.265,46 ",2810909011,CFD," 0,00 "
19/09/2024 06:48:07,Open Position,NSDQ100/USD," 199,99 ",0.203296," 0,00 "," 5.265,46 "," 5.065,47 ",2810909732,CFD," 0,00 "
19/09/2024 06:48:29,Position closed,NSDQ100/USD," 200,06 ",0.203296," 0,07 "," 5.265,53 "," 5.265,53 ",2810909732,CFD," 0,00 "
19/09/2024 07:07:59,Open Position,NSDQ100/USD," 249,99 ",0.254038," 0,00 "," 5.265,53 "," 5.015,54 ",2810929461,CFD," 0,00 "
19/09/2024 07:11:27,Open Position,NSDQ100/USD," 100,00 ",0.101705," 0,00 "," 5.265,53 "," 4.915,54 ",2810930596,CFD," 0,00 "
19/09/2024 07:15:36,Position closed,NSDQ100/USD," 98,68 ",0.101705,"(1,32)"," 5.264,21 "," 5.014,22 ",2810930596,CFD," 0,00 "
19/09/2024 07:16:33,Open Position,NSDQ100/USD," 149,99 ",0.152629," 0,00 "," 5.264,21 "," 4.864,23 ",2810932074,CFD," 0,00 "
19/09/2024 07:20:14,Position closed,NSDQ100/USD," 151,17 ",0.152629," 1,18 "," 5.265,39 "," 5.015,40 ",2810932074,CFD," 0,00 "
19/09/2024 07:20:52,Position closed,NSDQ100/USD," 245,79 ",0.254038,"(4,20)"," 5.261,19 "," 5.261,19 ",2810929461,CFD," 0,00 "
19/09/2024 07:24:36,Open Position,NSDQ100/USD," 300,00 ",0.305087," 0,00 "," 5.261,19 "," 4.961,19 ",2810944402,CFD," 0,00 "
19/09/2024 07:27:42,Open Position,NSDQ100/USD," 249,99 ",0.254233," 0,00 "," 5.261,19 "," 4.711,20 ",2810945813,CFD," 0,00 "
19/09/2024 07:31:12,Open Position,NSDQ100/USD," 199,99 ",0.203624," 0,00 "," 5.261,19 "," 4.511,21 ",2810947437,CFD," 0,00 "
19/09/2024 07:35:47,Position closed,NSDQ100/USD," 203,56 ",0.203624," 3,57 "," 5.264,76 "," 4.714,77 ",2810947437,CFD," 0,00 "
19/09/2024 07:36:07,Position closed,NSDQ100/USD," 249,21 ",0.254233,"(0,78)"," 5.263,98 "," 4.963,98 ",2810945813,CFD," 0,00 "
19/09/2024 07:36:33,Position closed,NSDQ100/USD," 299,56 ",0.305087,"(0,44)"," 5.263,54 "," 5.263,54 ",2810944402,CFD," 0,00 "
19/09/2024 07:38:39,Open Position,NSDQ100/USD," 199,99 ",0.203382," 0,00 "," 5.263,54 "," 5.063,55 ",2810953204,CFD," 0,00 "
19/09/2024 07:41:19,Position closed,NSDQ100/USD," 201,38 ",0.203382," 1,39 "," 5.264,93 "," 5.264,93 ",2810953204,CFD," 0,00 "
19/09/2024 07:53:47,Open Position,NSDQ100/USD," 50,00 ",0.050815," 0,00 "," 5.264,93 "," 5.214,93 ",2810960189,CFD," 0,00 "
19/09/2024 07:55:07,Position closed,NSDQ100/USD," 50,58 ",0.050815," 0,58 "," 5.265,51 "," 5.265,51 ",2810960189,CFD," 0,00 "
19/09/2024 08:03:29,Open Position,NSDQ100/USD," 300,00 ",0.304763," 0,00 "," 5.265,51 "," 4.965,51 ",2810963405,CFD," 0,00 "
19/09/2024 08:07:06,Position closed,NSDQ100/USD," 302,03 ",0.304763," 2,03 "," 5.267,54 "," 5.267,54 ",2810963405,CFD," 0,00 "
19/09/2024 08:08:45,Open Position,NSDQ100/USD," 300,00 ",0.304807," 0,00 "," 5.267,54 "," 4.967,54 ",2810964919,CFD," 0,00 "
19/09/2024 08:11:49,Position closed,NSDQ100/USD," 301,87 ",0.304807," 1,87 "," 5.269,41 "," 5.269,41 ",2810964919,CFD," 0,00 "
19/09/2024 08:20:43,Open Position,NSDQ100/USD," 300,00 ",0.304883," 0,00 "," 5.269,41 "," 4.969,41 ",2810968457,CFD," 0,00 "
19/09/2024 08:21:23,Open Position,NSDQ100/USD," 300,00 ",0.304815," 0,00 "," 5.269,41 "," 4.669,41 ",2810968672,CFD," 0,00 "
19/09/2024 08:30:39,Position closed,NSDQ100/USD," 299,01 ",0.304883,"(0,99)"," 5.268,42 "," 4.968,42 ",2810968457,CFD," 0,00 "
19/09/2024 08:31:03,Position closed,NSDQ100/USD," 299,19 ",0.304815,"(0,81)"," 5.267,61 "," 5.267,61 ",2810968672,CFD," 0,00 "
19/09/2024 09:04:10,Open Position,NSDQ100/USD," 199,99 ",0.202976," 0,00 "," 5.267,61 "," 5.067,62 ",2810979117,CFD," 0,00 "
19/09/2024 09:05:36,Position closed,NSDQ100/USD," 201,22 ",0.202976," 1,23 "," 5.268,84 "," 5.268,84 ",2810979117,CFD," 0,00 "
19/09/2024 09:10:37,Open Position,NSDQ100/USD," 249,99 ",0.253625," 0,00 "," 5.268,84 "," 5.018,85 ",2810985391,CFD," 0,00 "
19/09/2024 09:14:43,Position closed,NSDQ100/USD," 253,80 ",0.253625," 3,81 "," 5.272,65 "," 5.272,65 ",2810985391,CFD," 0,00 "
19/09/2024 09:15:36,Open Position,NSDQ100/USD," 249,99 ",0.253354," 0,00 "," 5.272,65 "," 5.022,66 ",2810986932,CFD," 0,00 "
19/09/2024 09:17:36,Open Position,XAU/USD," 199,99 ",1.545553," 0,00 "," 5.272,65 "," 4.822,67 ",2810987365,CFD," 0,00 "
19/09/2024 09:20:32,Position closed,NSDQ100/USD," 250,38 ",0.253354," 0,39 "," 5.273,04 "," 5.073,05 ",2810986932,CFD," 0,00 "
19/09/2024 09:20:47,Position closed,XAU/USD," 200,31 ",1.545553," 0,32 "," 5.273,36 "," 5.273,36 ",2810987365,CFD," 0,00 "
19/09/2024 09:22:58,Open Position,NSDQ100/USD," 149,99 ",0.151974," 0,00 "," 5.273,36 "," 5.123,37 ",2810989081,CFD," 0,00 "
19/09/2024 09:33:31,Open Position,NSDQ100/USD," 149,99 ",0.152040," 0,00 "," 5.273,36 "," 4.973,38 ",2810992229,CFD," 0,00 "
19/09/2024 10:01:05,Open Position,NSDQ100/USD," 100,00 ",0.101296," 0,00 "," 5.273,36 "," 4.873,38 ",2811004973,CFD," 0,00 "
19/09/2024 10:03:13,Position closed,NSDQ100/USD," 150,92 ",0.152040," 0,93 "," 5.274,29 "," 5.024,30 ",2810992229,CFD," 0,00 "
19/09/2024 10:03:23,Position closed,NSDQ100/USD," 149,62 ",0.151974,"(0,37)"," 5.273,92 "," 5.173,92 ",2810989081,CFD," 0,00 "
19/09/2024 10:04:58,Open Position,NSDQ100/USD," 100,00 ",0.101349," 0,00 "," 5.273,92 "," 5.073,92 ",2811005909,CFD," 0,00 "
19/09/2024 10:05:30,Open Position,NSDQ100/USD," 100,00 ",0.101357," 0,00 "," 5.273,92 "," 4.973,92 ",2811005987,CFD," 0,00 "
19/09/2024 10:10:22,Position closed,NSDQ100/USD," 99,46 ",0.101296,"(0,54)"," 5.273,38 "," 5.073,38 ",2811004973,CFD," 0,00 "
19/09/2024 10:10:23,Position closed,NSDQ100/USD," 100,65 ",0.101357," 0,65 "," 5.274,03 "," 5.174,03 ",2811005987,CFD," 0,00 "
19/09/2024 10:10:23,Position closed,NSDQ100/USD," 100,50 ",0.101349," 0,50 "," 5.274,53 "," 5.274,53 ",2811005909,CFD," 0,00 "
19/09/2024 10:13:06,Open Position,NSDQ100/USD," 300,00 ",0.303887," 0,00 "," 5.274,53 "," 4.974,53 ",2811008072,CFD," 0,00 "
19/09/2024 10:17:49,Position closed,NSDQ100/USD," 300,32 ",0.303887," 0,32 "," 5.274,85 "," 5.274,85 ",2811008072,CFD," 0,00 "
19/09/2024 10:19:43,Open Position,NSDQ100/USD," 199,99 ",0.202536," 0,00 "," 5.274,85 "," 5.074,86 ",2811010123,CFD," 0,00 "
19/09/2024 10:24:12,Position closed,NSDQ100/USD," 200,00 ",0.202536," 0,01 "," 5.274,86 "," 5.274,86 ",2811010123,CFD," 0,00 "
19/09/2024 10:24:31,Open Position,NSDQ100/USD," 149,99 ",0.151879," 0,00 "," 5.274,86 "," 5.124,87 ",2811011457,CFD," 0,00 "
19/09/2024 10:25:15,Open Position,NSDQ100/USD," 149,99 ",0.151898," 0,00 "," 5.274,86 "," 4.974,88 ",2811012272,CFD," 0,00 "
19/09/2024 10:27:14,Open Position,NSDQ100/USD," 100,00 ",0.101253," 0,00 "," 5.274,86 "," 4.874,88 ",2811013463,CFD," 0,00 "
19/09/2024 10:27:58,Position closed,NSDQ100/USD," 99,89 ",0.101253,"(0,11)"," 5.274,75 "," 4.974,77 ",2811013463,CFD," 0,00 "
19/09/2024 10:35:31,Open Position,NSDQ100/USD," 199,99 ",0.202403," 0,00 "," 5.274,75 "," 4.774,78 ",2811016270,CFD," 0,00 "
19/09/2024 10:40:43,Open Position,NSDQ100/USD," 100,00 ",0.101200," 0,00 "," 5.274,75 "," 4.674,78 ",2811017968,CFD," 0,00 "
19/09/2024 10:43:13,Position closed,NSDQ100/USD," 150,71 ",0.151898," 0,72 "," 5.275,47 "," 4.825,49 ",2811012272,CFD," 0,00 "
19/09/2024 10:43:19,Position closed,NSDQ100/USD," 150,09 ",0.151879," 0,10 "," 5.275,57 "," 4.975,58 ",2811011457,CFD," 0,00 "
19/09/2024 10:43:26,Position closed,NSDQ100/USD," 99,14 ",0.101200,"(0,86)"," 5.274,71 "," 5.074,72 ",2811017968,CFD," 0,00 "
19/09/2024 10:51:58,Open Position,NSDQ100/USD," 149,99 ",0.151866," 0,00 "," 5.274,71 "," 4.924,73 ",2811022852,CFD," 0,00 "
19/09/2024 11:01:01,Position closed,NSDQ100/USD," 150,12 ",0.151866," 0,13 "," 5.274,84 "," 5.074,85 ",2811022852,CFD," 0,00 "
19/09/2024 11:17:13,Open Position,NSDQ100/USD," 149,99 ",0.151898," 0,00 "," 5.274,84 "," 4.924,86 ",2811034021,CFD," 0,00 "
19/09/2024 11:52:59,Position closed,NSDQ100/USD," 151,73 ",0.151898," 1,74 "," 5.276,58 "," 5.076,59 ",2811034021,CFD," 0,00 "
19/09/2024 11:55:08,Open Position,NSDQ100/USD," 300,00 ",0.303625," 0,00 "," 5.276,58 "," 4.776,59 ",2811050899,CFD," 0,00 "
19/09/2024 12:00:44,Position closed,NSDQ100/USD," 302,71 ",0.303625," 2,71 "," 5.279,29 "," 5.079,30 ",2811050899,CFD," 0,00 "
19/09/2024 12:00:48,Position closed,NSDQ100/USD," 201,46 ",0.202403," 1,47 "," 5.280,76 "," 5.280,76 ",2811016270,CFD," 0,00 "
19/09/2024 12:01:55,Open Position,NSDQ100/USD," 249,99 ",0.252935," 0,00 "," 5.280,76 "," 5.030,77 ",2811054039,CFD," 0,00 "
19/09/2024 12:02:51,Open Position,NSDQ100/USD," 100,00 ",0.101187," 0,00 "," 5.280,76 "," 4.930,77 ",2811055961,CFD," 0,00 "
19/09/2024 12:03:57,Open Position,NSDQ100/USD," 199,99 ",0.202315," 0,00 "," 5.280,76 "," 4.730,78 ",2811056308,CFD," 0,00 "
19/09/2024 12:14:59,Position closed,NSDQ100/USD," 199,79 ",0.202315,"(0,20)"," 5.280,56 "," 4.930,57 ",2811056308,CFD," 0,00 "
19/09/2024 12:14:59,Position closed,NSDQ100/USD," 250,56 ",0.252935," 0,57 "," 5.281,13 "," 5.181,13 ",2811054039,CFD," 0,00 "
19/09/2024 12:14:59,Position closed,NSDQ100/USD," 100,48 ",0.101187," 0,48 "," 5.281,61 "," 5.281,61 ",2811055961,CFD," 0,00 "
19/09/2024 12:16:07,Open Position,NSDQ100/USD," 129,99 ",0.131455," 0,00 "," 5.281,61 "," 5.151,62 ",2811059372,CFD," 0,00 "
19/09/2024 12:16:55,Position closed,NSDQ100/USD," 129,38 ",0.131455,"(0,61)"," 5.281,00 "," 5.281,00 ",2811059372,CFD," 0,00 "
19/09/2024 12:19:47,Open Position,NSDQ100/USD," 149,99 ",0.151679," 0,00 "," 5.281,00 "," 5.131,01 ",2811060495,CFD," 0,00 "
19/09/2024 12:28:58,Open Position,NSDQ100/USD," 199,99 ",0.202381," 0,00 "," 5.281,00 "," 4.931,02 ",2811062390,CFD," 0,00 "
19/09/2024 12:33:12,Position closed,NSDQ100/USD," 202,83 ",0.202381," 2,84 "," 5.283,84 "," 5.133,85 ",2811062390,CFD," 0,00 "
19/09/2024 12:33:21,Position closed,NSDQ100/USD," 149,87 ",0.151679,"(0,12)"," 5.283,72 "," 5.283,72 ",2811060495,CFD," 0,00 "
19/09/2024 12:34:46,Open Position,NSDQ100/USD," 199,99 ",0.202301," 0,00 "," 5.283,72 "," 5.083,73 ",2811064209,CFD," 0,00 "
19/09/2024 12:38:19,Open Position,NSDQ100/USD," 149,99 ",0.151768," 0,00 "," 5.283,72 "," 4.933,74 ",2811065331,CFD," 0,00 "
19/09/2024 12:40:40,Position closed,NSDQ100/USD," 150,91 ",0.151768," 0,92 "," 5.284,64 "," 5.084,65 ",2811065331,CFD," 0,00 "
19/09/2024 12:44:26,Open Position,NSDQ100/USD," 350,00 ",0.354194," 0,00 "," 5.284,64 "," 4.734,65 ",2811067168,CFD," 0,00 "
19/09/2024 12:45:10,Position closed,NSDQ100/USD," 350,51 ",0.354194," 0,51 "," 5.285,15 "," 5.085,16 ",2811067168,CFD," 0,00 "
19/09/2024 12:47:52,Open Position,NSDQ100/USD," 100,00 ",0.101231," 0,00 "," 5.285,15 "," 4.985,16 ",2811068543,CFD," 0,00 "
19/09/2024 12:48:27,Position closed,NSDQ100/USD," 99,59 ",0.101231,"(0,41)"," 5.284,74 "," 5.084,75 ",2811068543,CFD," 0,00 "
19/09/2024 13:06:02,Open Position,NSDQ100/USD," 100,00 ",0.101223," 0,00 "," 5.284,74 "," 4.984,75 ",2811075669,CFD," 0,00 "
19/09/2024 13:10:29,Position closed,NSDQ100/USD," 200,54 ",0.202301," 0,55 "," 5.285,29 "," 5.185,29 ",2811064209,CFD," 0,00 "
19/09/2024 13:11:15,Position closed,NSDQ100/USD," 101,82 ",0.101223," 1,82 "," 5.287,11 "," 5.287,11 ",2811075669,CFD," 0,00 "
19/09/2024 13:13:05,Open Position,NSDQ100/USD," 149,99 ",0.151561," 0,00 "," 5.287,11 "," 5.137,12 ",2811077832,CFD," 0,00 "
19/09/2024 13:13:24,Position closed,NSDQ100/USD," 149,10 ",0.151561,"(0,89)"," 5.286,22 "," 5.286,22 ",2811077832,CFD," 0,00 "
19/09/2024 13:14:39,Open Position,NSDQ100/USD," 149,99 ",0.151530," 0,00 "," 5.286,22 "," 5.136,23 ",2811078290,CFD," 0,00 "
19/09/2024 13:16:48,Open Position,NSDQ100/USD," 100,00 ",0.101032," 0,00 "," 5.286,22 "," 5.036,23 ",2811078874,CFD," 0,00 "
19/09/2024 13:19:17,Position closed,NSDQ100/USD," 100,12 ",0.101032," 0,12 "," 5.286,34 "," 5.136,35 ",2811078874,CFD," 0,00 "
19/09/2024 13:26:38,Open Position,NSDQ100/USD," 149,99 ",0.151475," 0,00 "," 5.286,34 "," 4.986,36 ",2811081888,CFD," 0,00 "
19/09/2024 13:27:48,Position closed,NSDQ100/USD," 150,56 ",0.151475," 0,57 "," 5.286,91 "," 5.136,92 ",2811081888,CFD," 0,00 "
19/09/2024 13:27:54,Position closed,NSDQ100/USD," 151,39 ",0.151530," 1,40 "," 5.288,31 "," 5.288,31 ",2811078290,CFD," 0,00 "
19/09/2024 13:28:16,Open Position,NSDQ100/USD," 199,99 ",0.201873," 0,00 "," 5.288,31 "," 5.088,32 ",2811082822,CFD," 0,00 "
19/09/2024 13:29:19,Open Position,NSDQ100/USD," 149,99 ",0.151360," 0,00 "," 5.288,31 "," 4.938,33 ",2811083256,CFD," 0,00 "
19/09/2024 13:30:12,Position closed,NSDQ100/USD," 199,36 ",0.201873,"(0,63)"," 5.287,68 "," 5.137,69 ",2811082822,CFD," 0,00 "
19/09/2024 13:30:37,Open Position,NSDQ100/USD," 149,98 ",0.151400," 0,00 "," 5.287,68 "," 4.987,71 ",2811092286,CFD," 0,00 "
19/09/2024 13:31:28,Position closed,NSDQ100/USD," 147,73 ",0.151400,"(2,25)"," 5.285,43 "," 5.135,44 ",2811092286,CFD," 0,00 "
19/09/2024 13:31:35,Position closed,NSDQ100/USD," 146,07 ",0.151360,"(3,92)"," 5.281,51 "," 5.281,51 ",2811083256,CFD," 0,00 "
19/09/2024 13:32:38,Open Position,NSDQ100/USD," 50,00 ",0.050474," 0,00 "," 5.281,51 "," 5.231,51 ",2811162059,CFD," 0,00 "
19/09/2024 13:33:18,Open Position,NSDQ100/USD," 99,99 ",0.100999," 0,00 "," 5.281,51 "," 5.131,52 ",2811163923,CFD," 0,00 "
19/09/2024 13:34:35,Position closed,NSDQ100/USD," 98,46 ",0.100999,"(1,53)"," 5.279,98 "," 5.229,98 ",2811163923,CFD," 0,00 "
19/09/2024 13:36:08,Open Position,NSDQ100/USD," 50,00 ",0.050547," 0,00 "," 5.279,98 "," 5.179,98 ",2811198083,CFD," 0,00 "
19/09/2024 13:37:45,Open Position,NSDQ100/USD," 99,99 ",0.101125," 0,00 "," 5.279,98 "," 5.079,99 ",2811227037,CFD," 0,00 "
19/09/2024 13:39:10,Open Position,NSDQ100/USD," 50,00 ",0.050492," 0,00 "," 5.279,98 "," 5.029,99 ",2811253726,CFD," 0,00 "
19/09/2024 13:39:33,Position closed,NSDQ100/USD," 49,69 ",0.050474,"(0,31)"," 5.279,67 "," 5.079,68 ",2811162059,CFD," 0,00 "
19/09/2024 13:39:41,Position closed,NSDQ100/USD," 50,19 ",0.050492," 0,19 "," 5.279,86 "," 5.129,87 ",2811253726,CFD," 0,00 "
19/09/2024 13:39:48,Position closed,NSDQ100/USD," 103,14 ",0.101125," 3,15 "," 5.283,01 "," 5.233,01 ",2811227037,CFD," 0,00 "
19/09/2024 13:39:54,Position closed,NSDQ100/USD," 51,24 ",0.050547," 1,24 "," 5.284,25 "," 5.284,25 ",2811198083,CFD," 0,00 "
19/09/2024 13:40:28,Open Position,NSDQ100/USD," 250,00 ",0.252261," 0,00 "," 5.284,25 "," 5.034,25 ",2811259284,CFD," 0,00 "
19/09/2024 13:41:12,Open Position,NSDQ100/USD," 149,99 ",0.151288," 0,00 "," 5.284,25 "," 4.884,26 ",2811261419,CFD," 0,00 "
19/09/2024 13:41:45,Position closed,NSDQ100/USD," 149,34 ",0.151288,"(0,65)"," 5.283,60 "," 5.033,60 ",2811261419,CFD," 0,00 "
19/09/2024 13:41:52,Position closed,NSDQ100/USD," 252,15 ",0.252261," 2,15 "," 5.285,75 "," 5.285,75 ",2811259284,CFD," 0,00 "
19/09/2024 13:42:12,Open Position,NSDQ100/USD," 299,99 ",0.302545," 0,00 "," 5.285,75 "," 4.985,76 ",2811263181,CFD," 0,00 "
19/09/2024 13:42:46,Open Position,NSDQ100/USD," 149,99 ",0.151307," 0,00 "," 5.285,75 "," 4.835,77 ",2811264874,CFD," 0,00 "
19/09/2024 13:46:30,Open Position,NSDQ100/USD," 99,99 ",0.101022," 0,00 "," 5.285,75 "," 4.735,78 ",2811297252,CFD," 0,00 "
19/09/2024 13:48:52,Open Position,NSDQ100/USD," 99,99 ",0.101084," 0,00 "," 5.285,75 "," 4.635,79 ",2811305705,CFD," 0,00 "
19/09/2024 13:50:14,Position closed,NSDQ100/USD," 96,32 ",0.101084,"(3,67)"," 5.282,08 "," 4.732,11 ",2811305705,CFD," 0,00 "
19/09/2024 13:50:27,Position closed,NSDQ100/USD," 94,74 ",0.101022,"(5,25)"," 5.276,83 "," 4.826,85 ",2811297252,CFD," 0,00 "
19/09/2024 13:50:42,Position closed,NSDQ100/USD," 136,36 ",0.151307,"(13,63)"," 5.263,20 "," 4.963,21 ",2811264874,CFD," 0,00 "
19/09/2024 13:51:04,Open Position,NSDQ100/USD," 149,99 ",0.151968," 0,00 "," 5.263,20 "," 4.813,22 ",2811322905,CFD," 0,00 "
19/09/2024 13:52:10,Open Position,NSDQ100/USD," 200,00 ",0.202717," 0,00 "," 5.263,20 "," 4.613,22 ",2811358474,CFD," 0,00 "
19/09/2024 13:53:08,Position closed,NSDQ100/USD," 200,43 ",0.202717," 0,43 "," 5.263,63 "," 4.813,65 ",2811358474,CFD," 0,00 "
19/09/2024 13:54:32,Open Position,NSDQ100/USD," 200,00 ",0.202687," 0,00 "," 5.263,63 "," 4.613,65 ",2811362858,CFD," 0,00 "
19/09/2024 13:54:46,Position closed,NSDQ100/USD," 150,53 ",0.151968," 0,54 "," 5.264,17 "," 4.764,18 ",2811322905,CFD," 0,00 "
19/09/2024 13:55:08,Open Position,NSDQ100/USD," 149,99 ",0.151787," 0,00 "," 5.264,17 "," 4.614,19 ",2811363844,CFD," 0,00 "
19/09/2024 13:56:06,Position closed,NSDQ100/USD," 206,78 ",0.202687," 6,78 "," 5.270,95 "," 4.820,97 ",2811362858,CFD," 0,00 "
19/09/2024 13:56:10,Position closed,NSDQ100/USD," 149,95 ",0.151787,"(0,04)"," 5.270,91 "," 4.970,92 ",2811363844,CFD," 0,00 "
19/09/2024 13:56:44,Open Position,NSDQ100/USD," 99,99 ",0.101172," 0,00 "," 5.270,91 "," 4.870,93 ",2811367168,CFD," 0,00 "
19/09/2024 13:58:45,Open Position,NSDQ100/USD," 99,99 ",0.101196," 0,00 "," 5.270,91 "," 4.770,94 ",2811370244,CFD," 0,00 "
19/09/2024 13:59:14,Position closed,NSDQ100/USD," 98,70 ",0.101196,"(1,29)"," 5.269,62 "," 4.869,64 ",2811370244,CFD," 0,00 "
19/09/2024 14:00:29,Position closed,NSDQ100/USD," 100,15 ",0.101172," 0,16 "," 5.269,78 "," 4.969,79 ",2811367168,CFD," 0,00 "
19/09/2024 14:00:55,Open Position,NSDQ100/USD," 149,99 ",0.151790," 0,00 "," 5.269,78 "," 4.819,80 ",2811373432,CFD," 0,00 "
19/09/2024 14:02:03,Position closed,NSDQ100/USD," 149,92 ",0.151790,"(0,07)"," 5.269,71 "," 4.969,72 ",2811373432,CFD," 0,00 "
19/09/2024 14:02:34,Open Position,NSDQ100/USD," 99,99 ",0.101144," 0,00 "," 5.269,71 "," 4.869,73 ",2811376347,CFD," 0,00 "
19/09/2024 14:03:20,Open Position,NSDQ100/USD," 299,99 ",0.303303," 0,00 "," 5.269,71 "," 4.569,74 ",2811382681,CFD," 0,00 "
19/09/2024 14:03:29,Position closed,NSDQ100/USD," 300,73 ",0.303303," 0,74 "," 5.270,45 "," 4.870,47 ",2811382681,CFD," 0,00 "
19/09/2024 14:03:34,Position closed,NSDQ100/USD," 101,06 ",0.101144," 1,07 "," 5.271,52 "," 4.971,53 ",2811376347,CFD," 0,00 "
19/09/2024 14:03:57,Open Position,NSDQ100/USD," 200,00 ",0.202103," 0,00 "," 5.271,52 "," 4.771,53 ",2811383880,CFD," 0,00 "
19/09/2024 14:04:14,Position closed,NSDQ100/USD," 198,85 ",0.202103,"(1,15)"," 5.270,37 "," 4.970,38 ",2811383880,CFD," 0,00 "
19/09/2024 14:04:36,Open Position,NSDQ100/USD," 99,99 ",0.101065," 0,00 "," 5.270,37 "," 4.870,39 ",2811391129,CFD," 0,00 "
19/09/2024 14:05:38,Open Position,NSDQ100/USD," 50,00 ",0.050522," 0,00 "," 5.270,37 "," 4.820,39 ",2811398149,CFD," 0,00 "
19/09/2024 14:11:55,Position closed,NSDQ100/USD," 50,27 ",0.050522," 0,27 "," 5.270,64 "," 4.870,66 ",2811398149,CFD," 0,00 "
19/09/2024 14:12:21,Open Position,NSDQ100/USD," 149,99 ",0.151433," 0,00 "," 5.270,64 "," 4.720,67 ",2811445593,CFD," 0,00 "
19/09/2024 14:12:53,Position closed,NSDQ100/USD," 149,01 ",0.151433,"(0,98)"," 5.269,66 "," 4.869,68 ",2811445593,CFD," 0,00 "
19/09/2024 14:12:58,Position closed,NSDQ100/USD," 101,37 ",0.101065," 1,38 "," 5.271,04 "," 4.971,05 ",2811391129,CFD," 0,00 "
19/09/2024 14:13:44,Open Position,NSDQ100/USD," 200,00 ",0.201957," 0,00 "," 5.271,04 "," 4.771,05 ",2811463764,CFD," 0,00 "
19/09/2024 14:15:20,Open Position,NSDQ100/USD," 149,99 ",0.151407," 0,00 "," 5.271,04 "," 4.621,06 ",2811494685,CFD," 0,00 "
19/09/2024 14:15:39,Position closed,NSDQ100/USD," 201,40 ",0.201957," 1,40 "," 5.272,44 "," 4.822,46 ",2811463764,CFD," 0,00 "
19/09/2024 14:16:28,Open Position,NSDQ100/USD," 249,99 ",0.252391," 0,00 "," 5.272,44 "," 4.572,47 ",2811518865,CFD," 0,00 "
19/09/2024 14:18:04,Position closed,NSDQ100/USD," 255,30 ",0.252391," 5,31 "," 5.277,75 "," 4.827,77 ",2811518865,CFD," 0,00 "
19/09/2024 14:18:09,Position closed,NSDQ100/USD," 298,97 ",0.302545,"(1,02)"," 5.276,73 "," 5.126,74 ",2811263181,CFD," 0,00 "
19/09/2024 14:19:34,Open Position,NSDQ100/USD," 149,99 ",0.151220," 0,00 "," 5.276,73 "," 4.976,75 ",2811552855,CFD," 0,00 "
19/09/2024 14:20:31,Open Position,NSDQ100/USD," 200,00 ",0.201638," 0,00 "," 5.276,73 "," 4.776,75 ",2811555263,CFD," 0,00 "
19/09/2024 14:21:18,Open Position,NSDQ100/USD," 200,00 ",0.201570," 0,00 "," 5.276,73 "," 4.576,75 ",2811567284,CFD," 0,00 "
19/09/2024 14:21:31,Open Position,NSDQ100/USD," 149,99 ",0.151178," 0,00 "," 5.276,73 "," 4.426,76 ",2811567779,CFD," 0,00 "
19/09/2024 14:22:33,Open Position,NSDQ100/USD," 149,99 ",0.151266," 0,00 "," 5.276,73 "," 4.276,77 ",2811591024,CFD," 0,00 "
19/09/2024 14:31:44,Open Position,NSDQ100/USD," 149,99 ",0.150722," 0,00 "," 5.276,73 "," 4.126,78 ",2811618409,CFD," 0,00 "
19/09/2024 14:32:24,Position closed,NSDQ100/USD," 150,34 ",0.150722," 0,35 "," 5.277,08 "," 4.277,12 ",2811618409,CFD," 0,00 "
19/09/2024 14:33:09,Position closed,NSDQ100/USD," 211,60 ",0.201638," 11,60 "," 5.288,68 "," 4.488,72 ",2811555263,CFD," 0,00 "
19/09/2024 14:33:09,Position closed,NSDQ100/USD," 157,67 ",0.151178," 7,68 "," 5.296,36 "," 4.646,39 ",2811567779,CFD," 0,00 "
19/09/2024 14:33:09,Position closed,NSDQ100/USD," 158,51 ",0.151220," 8,52 "," 5.304,88 "," 4.804,90 ",2811552855,CFD," 0,00 "
19/09/2024 14:33:09,Position closed,NSDQ100/USD," 210,24 ",0.201570," 10,24 "," 5.315,12 "," 5.015,14 ",2811567284,CFD," 0,00 "
19/09/2024 14:33:09,Position closed,NSDQ100/USD," 159,45 ",0.151266," 9,46 "," 5.324,58 "," 5.174,59 ",2811591024,CFD," 0,00 "
19/09/2024 14:33:53,Open Position,NSDQ100/USD," 249,99 ",0.251149," 0,00 "," 5.324,58 "," 4.924,60 ",2811633487,CFD," 0,00 "
19/09/2024 14:34:34,Open Position,NSDQ100/USD," 400,00 ",0.402071," 0,00 "," 5.324,58 "," 4.524,60 ",2811634752,CFD," 0,00 "
19/09/2024 14:36:34,Position closed,NSDQ100/USD," 397,27 ",0.402071,"(2,73)"," 5.321,85 "," 4.921,87 ",2811634752,CFD," 0,00 "
19/09/2024 14:37:08,Open Position,NSDQ100/USD," 200,00 ",0.201109," 0,00 "," 5.321,85 "," 4.721,87 ",2811653852,CFD," 0,00 "
19/09/2024 14:38:12,Open Position,NSDQ100/USD," 149,99 ",0.150877," 0,00 "," 5.321,85 "," 4.571,88 ",2811661236,CFD," 0,00 "
19/09/2024 14:39:21,Position closed,NSDQ100/USD," 150,04 ",0.150877," 0,05 "," 5.321,90 "," 4.721,92 ",2811661236,CFD," 0,00 "
19/09/2024 14:40:09,Position closed,NSDQ100/USD," 200,65 ",0.201109," 0,65 "," 5.322,55 "," 4.922,57 ",2811653852,CFD," 0,00 "
19/09/2024 14:40:48,Open Position,NSDQ100/USD," 299,99 ",0.301912," 0,00 "," 5.322,55 "," 4.622,58 ",2811686407,CFD," 0,00 "
19/09/2024 14:41:03,Open Position,NSDQ100/USD," 200,00 ",0.201251," 0,00 "," 5.322,55 "," 4.422,58 ",2811686694,CFD," 0,00 "
19/09/2024 14:41:42,Open Position,NSDQ100/USD," 149,99 ",0.151031," 0,00 "," 5.322,55 "," 4.272,59 ",2811692616,CFD," 0,00 "
19/09/2024 14:43:21,Open Position,NSDQ100/USD," 299,99 ",0.302016," 0,00 "," 5.322,55 "," 3.972,60 ",2811702826,CFD," 0,00 "
19/09/2024 14:44:07,Position closed,NSDQ100/USD," 300,57 ",0.302016," 0,58 "," 5.323,13 "," 4.273,17 ",2811702826,CFD," 0,00 "
19/09/2024 14:45:02,Position closed,NSDQ100/USD," 150,75 ",0.151031," 0,76 "," 5.323,89 "," 4.423,92 ",2811692616,CFD," 0,00 "
19/09/2024 14:45:25,Open Position,NSDQ100/USD," 299,99 ",0.302132," 0,00 "," 5.323,89 "," 4.123,93 ",2811714219,CFD," 0,00 "
19/09/2024 14:45:33,Open Position,NSDQ100/USD," 299,98 ",0.302171," 0,00 "," 5.323,89 "," 3.823,95 ",2811714339,CFD," 0,00 "
19/09/2024 14:46:03,Open Position,NSDQ100/USD," 200,00 ",0.201433," 0,00 "," 5.323,89 "," 3.623,95 ",2811715000,CFD," 0,00 "
19/09/2024 14:47:30,Open Position,NSDQ100/USD," 299,99 ",0.302290," 0,00 "," 5.323,89 "," 3.323,96 ",2811716311,CFD," 0,00 "
19/09/2024 14:48:56,Position closed,NSDQ100/USD," 300,75 ",0.302290," 0,76 "," 5.324,65 "," 3.624,71 ",2811716311,CFD," 0,00 "
19/09/2024 14:50:16,Position closed,NSDQ100/USD," 301,19 ",0.302171," 1,21 "," 5.325,86 "," 3.925,90 ",2811714339,CFD," 0,00 "
19/09/2024 14:50:22,Position closed,NSDQ100/USD," 156,57 ",0.151407," 6,58 "," 5.332,44 "," 4.082,47 ",2811494685,CFD," 0,00 "
19/09/2024 14:52:46,Open Position,NSDQ100/USD," 200,00 ",0.201576," 0,00 "," 5.332,44 "," 3.882,47 ",2811723576,CFD," 0,00 "
19/09/2024 14:53:21,Open Position,NSDQ100/USD," 200,00 ",0.201638," 0,00 "," 5.332,44 "," 3.682,47 ",2811724582,CFD," 0,00 "
19/09/2024 14:54:26,Position closed,NSDQ100/USD," 201,31 ",0.201638," 1,31 "," 5.333,75 "," 3.883,78 ",2811724582,CFD," 0,00 "
19/09/2024 14:55:05,Open Position,NSDQ100/USD," 299,99 ",0.302588," 0,00 "," 5.333,75 "," 3.583,79 ",2811726033,CFD," 0,00 "
19/09/2024 14:55:42,Position closed,NSDQ100/USD," 301,88 ",0.302588," 1,89 "," 5.335,64 "," 3.885,67 ",2811726033,CFD," 0,00 "
19/09/2024 14:56:41,Open Position,NSDQ100/USD," 200,00 ",0.201761," 0,00 "," 5.335,64 "," 3.685,67 ",2811727644,CFD," 0,00 "
19/09/2024 14:57:19,Position closed,NSDQ100/USD," 199,32 ",0.201761,"(0,68)"," 5.334,96 "," 3.884,99 ",2811727644,CFD," 0,00 "
19/09/2024 14:59:28,Open Position,NSDQ100/USD," 99,99 ",0.100921," 0,00 "," 5.334,96 "," 3.785,00 ",2811730127,CFD," 0,00 "
19/09/2024 15:00:57,Position closed,NSDQ100/USD," 98,88 ",0.100921,"(1,11)"," 5.333,85 "," 3.883,88 ",2811730127,CFD," 0,00 "
19/09/2024 15:05:19,Position closed,NSDQ100/USD," 201,78 ",0.201576," 1,78 "," 5.335,63 "," 4.085,66 ",2811723576,CFD," 0,00 "
19/09/2024 15:08:35,Open Position,NSDQ100/USD," 299,99 ",0.302673," 0,00 "," 5.335,63 "," 3.785,67 ",2811760997,CFD," 0,00 "
19/09/2024 15:10:22,Position closed,NSDQ100/USD," 305,90 ",0.302673," 5,91 "," 5.341,54 "," 4.091,57 ",2811760997,CFD," 0,00 "
19/09/2024 15:12:13,Position closed,NSDQ100/USD," 300,09 ",0.302132," 0,10 "," 5.341,64 "," 4.391,66 ",2811714219,CFD," 0,00 "
19/09/2024 15:19:48,Position closed,NSDQ100/USD," 200,04 ",0.201251," 0,04 "," 5.341,68 "," 4.591,70 ",2811686694,CFD," 0,00 "
19/09/2024 15:20:02,Position closed,NSDQ100/USD," 203,63 ",0.201433," 3,63 "," 5.345,31 "," 4.795,33 ",2811715000,CFD," 0,00 "
19/09/2024 15:30:49,Position closed,NSDQ100/USD," 306,37 ",0.301912," 6,38 "," 5.351,69 "," 5.101,70 ",2811686407,CFD," 0,00 "
19/09/2024 15:39:52,Open Position,NSDQ100/USD," 200,00 ",0.201091," 0,00 "," 5.351,69 "," 4.901,70 ",2811976149,CFD," 0,00 "
19/09/2024 15:40:17,Position closed,NSDQ100/USD," 199,88 ",0.201091,"(0,12)"," 5.351,57 "," 5.101,58 ",2811976149,CFD," 0,00 "
19/09/2024 15:42:22,Position closed,NSDQ100/USD," 247,68 ",0.251149,"(2,31)"," 5.349,26 "," 5.349,26 ",2811633487,CFD," 0,00 "
19/09/2024 15:45:16,Open Position,NSDQ100/USD," 299,99 ",0.301740," 0,00 "," 5.349,26 "," 5.049,27 ",2811982088,CFD," 0,00 "
19/09/2024 15:46:43,Position closed,NSDQ100/USD," 302,62 ",0.301740," 2,63 "," 5.351,89 "," 5.351,89 ",2811982088,CFD," 0,00 "
19/09/2024 15:48:50,Open Position,NSDQ100/USD," 99,99 ",0.100462," 0,00 "," 5.351,89 "," 5.251,90 ",2811985630,CFD," 0,00 "
19/09/2024 15:51:42,Open Position,NSDQ100/USD," 299,99 ",0.301991," 0,00 "," 5.351,89 "," 4.951,91 ",2811987666,CFD," 0,00 "
19/09/2024 15:52:20,Open Position,NSDQ100/USD," 200,00 ",0.201418," 0,00 "," 5.351,89 "," 4.751,91 ",2811988506,CFD," 0,00 "
19/09/2024 15:52:46,Open Position,NSDQ100/USD," 149,99 ",0.151054," 0,00 "," 5.351,89 "," 4.601,92 ",2811988798,CFD," 0,00 "
19/09/2024 15:53:15,Open Position,NSDQ100/USD," 149,99 ",0.151101," 0,00 "," 5.351,89 "," 4.451,93 ",2811989146,CFD," 0,00 "
19/09/2024 15:53:32,Open Position,NSDQ100/USD," 200,00 ",0.201499," 0,00 "," 5.351,89 "," 4.251,93 ",2811989663,CFD," 0,00 "
19/09/2024 15:54:59,Open Position,NSDQ100/USD," 200,00 ",0.201391," 0,00 "," 5.351,89 "," 4.051,93 ",2811990843,CFD," 0,00 "
19/09/2024 15:55:53,Open Position,NSDQ100/USD," 149,99 ",0.151043," 0,00 "," 5.351,89 "," 3.901,94 ",2811991431,CFD," 0,00 "
19/09/2024 16:06:50,Position closed,NSDQ100/USD," 97,81 ",0.100462,"(2,18)"," 5.349,71 "," 3.999,75 ",2811985630,CFD," 0,00 "
19/09/2024 16:06:50,Position closed,NSDQ100/USD," 153,92 ",0.151054," 3,93 "," 5.353,64 "," 4.153,67 ",2811988798,CFD," 0,00 "
19/09/2024 16:06:50,Position closed,NSDQ100/USD," 205,44 ",0.201418," 5,44 "," 5.359,08 "," 4.359,11 ",2811988506,CFD," 0,00 "
19/09/2024 16:06:50,Position closed,NSDQ100/USD," 305,43 ",0.301991," 5,44 "," 5.364,52 "," 4.664,54 ",2811987666,CFD," 0,00 "
19/09/2024 16:06:50,Position closed,NSDQ100/USD," 153,66 ",0.151043," 3,67 "," 5.368,19 "," 4.818,20 ",2811991431,CFD," 0,00 "
19/09/2024 16:06:50,Position closed,NSDQ100/USD," 204,90 ",0.201391," 4,90 "," 5.373,09 "," 5.023,10 ",2811990843,CFD," 0,00 "
19/09/2024 16:06:50,Position closed,NSDQ100/USD," 154,81 ",0.151101," 4,82 "," 5.377,91 "," 5.177,91 ",2811989146,CFD," 0,00 "
19/09/2024 16:06:50,Position closed,NSDQ100/USD," 207,06 ",0.201499," 7,06 "," 5.384,97 "," 5.384,97 ",2811989663,CFD," 0,00 "
19/09/2024 16:08:13,Open Position,NSDQ100/USD," 149,99 ",0.150842," 0,00 "," 5.384,97 "," 5.234,98 ",2812000183,CFD," 0,00 "
19/09/2024 16:12:52,Open Position,NSDQ100/USD," 149,99 ",0.150887," 0,00 "," 5.384,97 "," 5.084,99 ",2812006331,CFD," 0,00 "
19/09/2024 16:13:26,Open Position,NSDQ100/USD," 299,99 ",0.301810," 0,00 "," 5.384,97 "," 4.785,00 ",2812006713,CFD," 0,00 "
19/09/2024 16:21:35,Position closed,NSDQ100/USD," 152,86 ",0.150887," 2,87 "," 5.387,84 "," 4.937,86 ",2812006331,CFD," 0,00 "
19/09/2024 16:21:35,Position closed,NSDQ100/USD," 306,42 ",0.301810," 6,43 "," 5.394,27 "," 5.244,28 ",2812006713,CFD," 0,00 "
19/09/2024 16:21:35,Position closed,NSDQ100/USD," 151,95 ",0.150842," 1,96 "," 5.396,23 "," 5.396,23 ",2812000183,CFD," 0,00 "
19/09/2024 16:22:55,Open Position,NSDQ100/USD," 540,00 ",0.542545," 0,00 "," 5.396,23 "," 4.856,23 ",2812014133,CFD," 0,00 "
19/09/2024 16:23:17,Position closed,NSDQ100/USD," 538,49 ",0.542545,"(1,51)"," 5.394,72 "," 5.394,72 ",2812014133,CFD," 0,00 "
19/09/2024 16:23:42,Open Position,NSDQ100/USD," 99,99 ",0.100457," 0,00 "," 5.394,72 "," 5.294,73 ",2812014919,CFD," 0,00 "
19/09/2024 16:25:05,Open Position,NSDQ100/USD," 99,99 ",0.100510," 0,00 "," 5.394,72 "," 5.194,74 ",2812016019,CFD," 0,00 "
19/09/2024 16:26:39,Position closed,NSDQ100/USD," 101,64 ",0.100510," 1,65 "," 5.396,37 "," 5.296,38 ",2812016019,CFD," 0,00 "
19/09/2024 16:26:39,Position closed,NSDQ100/USD," 100,58 ",0.100457," 0,59 "," 5.396,96 "," 5.396,96 ",2812014919,CFD," 0,00 "
19/09/2024 16:28:17,Open Position,NSDQ100/USD," 249,99 ",0.251014," 0,00 "," 5.396,96 "," 5.146,97 ",2812018186,CFD," 0,00 "
19/09/2024 16:29:28,Open Position,NSDQ100/USD," 99,99 ",0.100430," 0,00 "," 5.396,96 "," 5.046,98 ",2812019124,CFD," 0,00 "
19/09/2024 16:33:09,Position closed,NSDQ100/USD," 99,89 ",0.100430,"(0,10)"," 5.396,86 "," 5.146,87 ",2812019124,CFD," 0,00 "
19/09/2024 16:53:27,Position closed,NSDQ100/USD," 250,59 ",0.251014," 0,60 "," 5.397,46 "," 5.397,46 ",2812018186,CFD," 0,00 "
19/09/2024 17:02:01,Open Position,NSDQ100/USD," 249,99 ",0.251145," 0,00 "," 5.397,46 "," 5.147,47 ",2812066506,CFD," 0,00 "
19/09/2024 17:38:53,Position closed,NSDQ100/USD," 253,63 ",0.251145," 3,64 "," 5.401,10 "," 5.401,10 ",2812066506,CFD," 0,00 "
19/09/2024 17:44:02,Open Position,NSDQ100/USD," 149,99 ",0.150552," 0,00 "," 5.401,10 "," 5.251,11 ",2812092107,CFD," 0,00 "
19/09/2024 17:45:34,Position closed,NSDQ100/USD," 151,21 ",0.150552," 1,22 "," 5.402,32 "," 5.402,32 ",2812092107,CFD," 0,00 "
19/09/2024 17:46:49,Open Position,NSDQ100/USD," 250,00 ",0.250653," 0,00 "," 5.402,32 "," 5.152,32 ",2812093831,CFD," 0,00 "
19/09/2024 17:49:52,Position closed,NSDQ100/USD," 249,10 ",0.250653,"(0,90)"," 5.401,42 "," 5.401,42 ",2812093831,CFD," 0,00 "
19/09/2024 18:15:44,Open Position,NSDQ100/USD," 200,00 ",0.200997," 0,00 "," 5.401,42 "," 5.201,42 ",2812117807,CFD," 0,00 "
19/09/2024 18:16:12,Open Position,NSDQ100/USD," 250,00 ",0.251393," 0,00 "," 5.401,42 "," 4.951,42 ",2812118090,CFD," 0,00 "
19/09/2024 18:16:51,Open Position,NSDQ100/USD," 149,99 ",0.150826," 0,00 "," 5.401,42 "," 4.801,43 ",2812118531,CFD," 0,00 "
19/09/2024 18:19:33,Open Position,NSDQ100/USD," 99,99 ",0.100584," 0,00 "," 5.401,42 "," 4.701,44 ",2812119972,CFD," 0,00 "
19/09/2024 18:22:34,Position closed,NSDQ100/USD," 251,49 ",0.251393," 1,49 "," 5.402,91 "," 4.952,93 ",2812118090,CFD," 0,00 "
19/09/2024 18:22:34,Position closed,NSDQ100/USD," 198,86 ",0.200997,"(1,14)"," 5.401,77 "," 5.151,79 ",2812117807,CFD," 0,00 "
19/09/2024 18:22:34,Position closed,NSDQ100/USD," 150,70 ",0.150826," 0,71 "," 5.402,48 "," 5.302,49 ",2812118531,CFD," 0,00 "
19/09/2024 18:22:34,Position closed,NSDQ100/USD," 101,13 ",0.100584," 1,14 "," 5.403,62 "," 5.403,62 ",2812119972,CFD," 0,00 "
19/09/2024 18:23:09,Open Position,NSDQ100/USD," 200,00 ",0.200970," 0,00 "," 5.403,62 "," 5.203,62 ",2812121608,CFD," 0,00 "
19/09/2024 18:25:50,Open Position,NSDQ100/USD," 149,99 ",0.150798," 0,00 "," 5.403,62 "," 5.053,63 ",2812123169,CFD," 0,00 "
19/09/2024 18:32:01,Position closed,NSDQ100/USD," 199,70 ",0.200970,"(0,30)"," 5.403,32 "," 5.253,33 ",2812121608,CFD," 0,00 "
19/09/2024 18:32:01,Position closed,NSDQ100/USD," 151,18 ",0.150798," 1,19 "," 5.404,51 "," 5.404,51 ",2812123169,CFD," 0,00 "
19/09/2024 18:37:22,Open Position,NSDQ100/USD," 249,99 ",0.251193," 0,00 "," 5.404,51 "," 5.154,52 ",2812131299,CFD," 0,00 "
19/09/2024 18:49:38,Open Position,NSDQ100/USD," 350,00 ",0.351995," 0,00 "," 5.404,51 "," 4.804,52 ",2812138240,CFD," 0,00 "
19/09/2024 18:49:58,Open Position,NSDQ100/USD," 200,00 ",0.201207," 0,00 "," 5.404,51 "," 4.604,52 ",2812138349,CFD," 0,00 "
19/09/2024 18:50:13,Open Position,NSDQ100/USD," 149,99 ",0.150898," 0,00 "," 5.404,51 "," 4.454,53 ",2812138529,CFD," 0,00 "
19/09/2024 18:50:37,Open Position,NSDQ100/USD," 149,99 ",0.150867," 0,00 "," 5.404,51 "," 4.304,54 ",2812139019,CFD," 0,00 "
19/09/2024 18:51:18,Open Position,NSDQ100/USD," 299,99 ",0.301959," 0,00 "," 5.404,51 "," 4.004,55 ",2812139599,CFD," 0,00 "
19/09/2024 18:52:25,Open Position,NSDQ100/USD," 200,00 ",0.201159," 0,00 "," 5.404,51 "," 3.804,55 ",2812140350,CFD," 0,00 "
19/09/2024 18:56:08,Open Position,NSDQ100/USD," 299,99 ",0.301778," 0,00 "," 5.404,51 "," 3.504,56 ",2812142333,CFD," 0,00 "
19/09/2024 18:57:55,Position closed,NSDQ100/USD," 201,61 ",0.201207," 1,61 "," 5.406,12 "," 3.706,17 ",2812138349,CFD," 0,00 "
19/09/2024 18:57:55,Position closed,NSDQ100/USD," 151,05 ",0.150898," 1,06 "," 5.407,18 "," 3.857,22 ",2812138529,CFD," 0,00 "
19/09/2024 18:57:55,Position closed,NSDQ100/USD," 350,50 ",0.351995," 0,50 "," 5.407,68 "," 4.207,72 ",2812138240,CFD," 0,00 "
19/09/2024 18:57:55,Position closed,NSDQ100/USD," 245,72 ",0.251193,"(4,27)"," 5.403,41 "," 4.453,44 ",2812131299,CFD," 0,00 "
19/09/2024 18:57:55,Position closed,NSDQ100/USD," 301,75 ",0.301778," 1,76 "," 5.405,17 "," 4.755,19 ",2812142333,CFD," 0,00 "
19/09/2024 18:57:55,Position closed,NSDQ100/USD," 305,34 ",0.301959," 5,35 "," 5.410,52 "," 5.060,53 ",2812139599,CFD," 0,00 "
19/09/2024 18:57:55,Position closed,NSDQ100/USD," 200,65 ",0.201159," 0,65 "," 5.411,17 "," 5.261,18 ",2812140350,CFD," 0,00 "
19/09/2024 18:57:55,Position closed,NSDQ100/USD," 150,43 ",0.150867," 0,44 "," 5.411,61 "," 5.411,61 ",2812139019,CFD," 0,00 "
19/09/2024 18:58:17,Open Position,NSDQ100/USD," 200,00 ",0.201106," 0,00 "," 5.411,61 "," 5.211,61 ",2812143640,CFD," 0,00 "
19/09/2024 18:58:58,Position closed,NSDQ100/USD," 201,15 ",0.201106," 1,15 "," 5.412,76 "," 5.412,76 ",2812143640,CFD," 0,00 "
19/09/2024 18:59:55,Open Position,NSDQ100/USD," 50,00 ",0.050241," 0,00 "," 5.412,76 "," 5.362,76 ",2812144458,CFD," 0,00 "
19/09/2024 19:05:57,Open Position,NSDQ100/USD," 350,00 ",0.352037," 0,00 "," 5.412,76 "," 5.012,76 ",2812150681,CFD," 0,00 "
19/09/2024 19:06:15,Open Position,NSDQ100/USD," 499,99 ",0.502865," 0,00 "," 5.412,76 "," 4.512,77 ",2812150909,CFD," 0,00 "
19/09/2024 19:06:31,Open Position,NSDQ100/USD," 149,99 ",0.150873," 0,00 "," 5.412,76 "," 4.362,78 ",2812151139,CFD," 0,00 "
19/09/2024 19:07:08,Open Position,NSDQ100/USD," 99,99 ",0.100583," 0,00 "," 5.412,76 "," 4.262,79 ",2812151654,CFD," 0,00 "
19/09/2024 19:14:50,Open Position,NSDQ100/USD," 249,99 ",0.251792," 0,00 "," 5.412,76 "," 4.012,80 ",2812162173,CFD," 0,00 "
19/09/2024 19:15:31,Open Position,NSDQ100/USD," 99,98 ",0.100674," 0,00 "," 5.412,76 "," 3.912,82 ",2812162438,CFD," 0,00 "
19/09/2024 19:19:30,Open Position,NSDQ100/USD," 299,99 ",0.302153," 0,00 "," 5.412,76 "," 3.612,83 ",2812170715,CFD," 0,00 "
19/09/2024 19:19:41,Open Position,NSDQ100/USD," 99,99 ",0.100749," 0,00 "," 5.412,76 "," 3.512,84 ",2812170848,CFD," 0,00 "
19/09/2024 19:20:18,Open Position,NSDQ100/USD," 200,00 ",0.201490," 0,00 "," 5.412,76 "," 3.312,84 ",2812171021,CFD," 0,00 "
19/09/2024 19:20:38,Open Position,NSDQ100/USD," 250,00 ",0.252057," 0,00 "," 5.412,76 "," 3.062,84 ",2812171637,CFD," 0,00 "
19/09/2024 19:21:04,Open Position,NSDQ100/USD," 249,99 ",0.252044," 0,00 "," 5.412,76 "," 2.812,85 ",2812172328,CFD," 0,00 "
19/09/2024 19:24:16,Position closed,NSDQ100/USD," 255,92 ",0.252044," 5,93 "," 5.418,69 "," 3.068,77 ",2812172328,CFD," 0,00 "
19/09/2024 19:24:25,Position closed,NSDQ100/USD," 99,74 ",0.100674,"(0,24)"," 5.418,45 "," 3.168,51 ",2812162438,CFD," 0,00 "
19/09/2024 19:24:37,Position closed,NSDQ100/USD," 257,11 ",0.252057," 7,11 "," 5.425,56 "," 3.425,62 ",2812171637,CFD," 0,00 "
19/09/2024 19:25:12,Position closed,NSDQ100/USD," 202,66 ",0.201490," 2,66 "," 5.428,22 "," 3.628,28 ",2812171021,CFD," 0,00 "
19/09/2024 19:25:28,Position closed,NSDQ100/USD," 301,90 ",0.302153," 1,91 "," 5.430,13 "," 3.930,18 ",2812170715,CFD," 0,00 "
19/09/2024 19:25:36,Position closed,NSDQ100/USD," 251,48 ",0.251792," 1,49 "," 5.431,62 "," 4.181,66 ",2812162173,CFD," 0,00 "
19/09/2024 19:25:42,Position closed,NSDQ100/USD," 101,15 ",0.100749," 1,16 "," 5.432,78 "," 4.282,81 ",2812170848,CFD," 0,00 "
19/09/2024 19:30:06,Open Position,NSDQ100/USD," 249,99 ",0.251780," 0,00 "," 5.432,78 "," 4.032,82 ",2812180606,CFD," 0,00 "
19/09/2024 19:30:39,Open Position,NSDQ100/USD," 149,99 ",0.151097," 0,00 "," 5.432,78 "," 3.882,83 ",2812180889,CFD," 0,00 "
19/09/2024 19:30:53,Open Position,NSDQ100/USD," 299,99 ",0.302214," 0,00 "," 5.432,78 "," 3.582,84 ",2812180972,CFD," 0,00 "
19/09/2024 19:31:38,Open Position,NSDQ100/USD," 149,99 ",0.151159," 0,00 "," 5.432,78 "," 3.432,85 ",2812181670,CFD," 0,00 "
19/09/2024 19:32:21,Open Position,NSDQ100/USD," 299,99 ",0.302389," 0,00 "," 5.432,78 "," 3.132,86 ",2812181949,CFD," 0,00 "
19/09/2024 19:33:50,Position closed,NSDQ100/USD," 304,89 ",0.302389," 4,90 "," 5.437,68 "," 3.437,75 ",2812181949,CFD," 0,00 "
19/09/2024 19:34:00,Position closed,NSDQ100/USD," 250,27 ",0.251780," 0,28 "," 5.437,96 "," 3.688,02 ",2812180606,CFD," 0,00 "
19/09/2024 19:34:23,Position closed,NSDQ100/USD," 151,67 ",0.151159," 1,68 "," 5.439,64 "," 3.839,69 ",2812181670,CFD," 0,00 "
19/09/2024 19:34:52,Position closed,NSDQ100/USD," 97,85 ",0.100583,"(2,14)"," 5.437,50 "," 3.937,54 ",2812151654,CFD," 0,00 "
19/09/2024 19:35:02,Position closed,NSDQ100/USD," 303,05 ",0.302214," 3,06 "," 5.440,56 "," 4.240,59 ",2812180972,CFD," 0,00 "
19/09/2024 19:35:43,Position closed,NSDQ100/USD," 152,30 ",0.151097," 2,31 "," 5.442,87 "," 4.392,89 ",2812180889,CFD," 0,00 "
19/09/2024 19:35:50,Position closed,NSDQ100/USD," 147,58 ",0.150873,"(2,41)"," 5.440,46 "," 4.540,47 ",2812151139,CFD," 0,00 "
19/09/2024 19:39:32,Position closed,NSDQ100/USD," 48,54 ",0.050241,"(1,46)"," 5.439,00 "," 4.589,01 ",2812144458,CFD," 0,00 "
19/09/2024 19:40:02,Position closed,NSDQ100/USD," 495,32 ",0.502865,"(4,67)"," 5.434,33 "," 5.084,33 ",2812150909,CFD," 0,00 "
19/09/2024 19:40:02,Position closed,NSDQ100/USD," 347,37 ",0.352037,"(2,63)"," 5.431,70 "," 5.431,70 ",2812150681,CFD," 0,00 "
19/09/2024 20:18:57,Open Position,NSDQ100/USD," 199,99 ",0.201839," 0,00 "," 5.431,70 "," 5.231,71 ",2812200304,CFD," 0,00 "
19/09/2024 20:22:30,Open Position,NSDQ100/USD," 149,99 ",0.151395," 0,00 "," 5.431,70 "," 5.081,72 ",2812200488,CFD," 0,00 "
19/09/2024 20:26:02,Open Position,NSDQ100/USD," 199,99 ",0.201789," 0,00 "," 5.431,70 "," 4.881,73 ",2812200694,CFD," 0,00 "
19/09/2024 20:26:12,Open Position,NSDQ100/USD," 149,99 ",0.151349," 0,00 "," 5.431,70 "," 4.731,74 ",2812200708,CFD," 0,00 "
19/09/2024 23:20:00,Open Position,NSDQ100/USD," 399,99 ",0.403781," 0,00 "," 5.431,70 "," 4.331,75 ",2812207062,CFD," 0,00 "
20/09/2024 00:48:27,Overnight fee,Daily,"(0,77)",-,"(0,77)"," 5.430,93 "," 4.330,98 ",2812200488,CFD," 0,00 "
20/09/2024 00:48:27,Overnight fee,Daily,"(0,77)",-,"(0,77)"," 5.430,16 "," 4.330,21 ",2812200708,CFD," 0,00 "
20/09/2024 00:48:27,Overnight fee,Daily,"(1,03)",-,"(1,03)"," 5.429,13 "," 4.329,18 ",2812200304,CFD," 0,00 "
20/09/2024 00:48:27,Overnight fee,Daily,"(1,03)",-,"(1,03)"," 5.428,10 "," 4.328,15 ",2812200694,CFD," 0,00 "
20/09/2024 06:59:40,Open Position,NSDQ100/USD," 499,99 ",0.505249," 0,00 "," 5.428,10 "," 3.828,16 ",2812239345,CFD," 0,00 "
20/09/2024 07:01:17,Open Position,NSDQ100/USD," 149,98 ",0.151567," 0,00 "," 5.428,10 "," 3.678,18 ",2812255922,CFD," 0,00 "
20/09/2024 07:03:02,Position closed,NSDQ100/USD," 504,19 ",0.505249," 4,20 "," 5.432,30 "," 4.182,37 ",2812239345,CFD," 0,00 "
20/09/2024 07:03:07,Position closed,NSDQ100/USD," 151,01 ",0.151567," 1,03 "," 5.433,33 "," 4.333,38 ",2812255922,CFD," 0,00 "
20/09/2024 07:05:08,Open Position,NSDQ100/USD," 300,00 ",0.303012," 0,00 "," 5.433,33 "," 4.033,38 ",2812260326,CFD," 0,00 "
20/09/2024 07:08:09,Open Position,NSDQ100/USD," 300,00 ",0.302998," 0,00 "," 5.433,33 "," 3.733,38 ",2812261477,CFD," 0,00 "
20/09/2024 07:10:37,Open Position,NSDQ100/USD," 499,99 ",0.505239," 0,00 "," 5.433,33 "," 3.233,39 ",2812262394,CFD," 0,00 "
20/09/2024 07:12:54,Position closed,NSDQ100/USD," 503,79 ",0.505239," 3,80 "," 5.437,13 "," 3.737,18 ",2812262394,CFD," 0,00 "
20/09/2024 07:13:04,Position closed,NSDQ100/USD," 300,13 ",0.303012," 0,13 "," 5.437,26 "," 4.037,31 ",2812260326,CFD," 0,00 "
20/09/2024 07:13:22,Position closed,NSDQ100/USD," 299,89 ",0.302998,"(0,11)"," 5.437,15 "," 4.337,20 ",2812261477,CFD," 0,00 "
20/09/2024 07:14:29,Open Position,NSDQ100/USD," 249,99 ",0.252371," 0,00 "," 5.437,15 "," 4.087,21 ",2812263543,CFD," 0,00 "
20/09/2024 07:14:57,Position closed,NSDQ100/USD," 249,64 ",0.252371,"(0,35)"," 5.436,80 "," 4.336,85 ",2812263543,CFD," 0,00 "
20/09/2024 07:17:05,Position closed,NSDQ100/USD," 400,28 ",0.403781," 0,29 "," 5.437,09 "," 4.737,13 ",2812207062,CFD," 0,00 "
20/09/2024 07:20:52,Open Position,NSDQ100/USD," 399,99 ",0.403722," 0,00 "," 5.437,09 "," 4.337,14 ",2812266438,CFD," 0,00 "
20/09/2024 07:22:48,Open Position,NSDQ100/USD," 300,00 ",0.302833," 0,00 "," 5.437,09 "," 4.037,14 ",2812291426,CFD," 0,00 "
20/09/2024 07:34:51,Open Position,NSDQ100/USD," 199,99 ",0.201810," 0,00 "," 5.437,09 "," 3.837,15 ",2812296733,CFD," 0,00 "
20/09/2024 07:45:05,Position closed,NSDQ100/USD," 149,77 ",0.151349,"(0,22)"," 5.436,87 "," 3.986,92 ",2812200708,CFD," 0,00 "
20/09/2024 07:45:05,Position closed,NSDQ100/USD," 200,50 ",0.201839," 0,51 "," 5.437,38 "," 4.187,42 ",2812200304,CFD," 0,00 "
20/09/2024 07:45:05,Position closed,NSDQ100/USD," 199,49 ",0.201789,"(0,50)"," 5.436,88 "," 4.386,91 ",2812200694,CFD," 0,00 "
20/09/2024 07:45:05,Position closed,NSDQ100/USD," 150,68 ",0.151395," 0,69 "," 5.437,57 "," 4.537,59 ",2812200488,CFD," 0,00 "
20/09/2024 07:45:05,Position closed,NSDQ100/USD," 401,86 ",0.403722," 1,87 "," 5.439,44 "," 4.939,45 ",2812266438,CFD," 0,00 "
20/09/2024 07:45:05,Position closed,NSDQ100/USD," 302,22 ",0.302833," 2,22 "," 5.441,66 "," 5.241,67 ",2812291426,CFD," 0,00 "
20/09/2024 07:45:05,Position closed,NSDQ100/USD," 199,92 ",0.201810,"(0,07)"," 5.441,59 "," 5.441,59 ",2812296733,CFD," 0,00 "
20/09/2024 07:46:00,Open Position,NSDQ100/USD," 300,00 ",0.302755," 0,00 "," 5.441,59 "," 5.141,59 ",2812304390,CFD," 0,00 "
20/09/2024 07:46:11,Open Position,NSDQ100/USD," 1.300,00 ",1.311913," 0,00 "," 5.441,59 "," 3.841,59 ",2812304419,CFD," 0,00 "
20/09/2024 07:50:57,Position closed,NSDQ100/USD," 1.307,65 ",1.311913," 7,65 "," 5.449,24 "," 5.149,24 ",2812304419,CFD," 0,00 "
20/09/2024 07:51:05,Position closed,NSDQ100/USD," 301,86 ",0.302755," 1,86 "," 5.451,10 "," 5.451,10 ",2812304390,CFD," 0,00 "
20/09/2024 07:51:44,Open Position,NSDQ100/USD," 300,00 ",0.302558," 0,00 "," 5.451,10 "," 5.151,10 ",2812308325,CFD," 0,00 "
20/09/2024 08:03:20,Open Position,NSDQ100/USD," 350,00 ",0.353293," 0,00 "," 5.451,10 "," 4.801,10 ",2812320715,CFD," 0,00 "
20/09/2024 08:08:51,Open Position,NSDQ100/USD," 399,99 ",0.403702," 0,00 "," 5.451,10 "," 4.401,11 ",2812323758,CFD," 0,00 "
20/09/2024 08:13:10,Open Position,NSDQ100/USD," 350,00 ",0.353433," 0,00 "," 5.451,10 "," 4.051,11 ",2812325441,CFD," 0,00 "
20/09/2024 08:18:20,Open Position,NSDQ100/USD," 199,99 ",0.201931," 0,00 "," 5.451,10 "," 3.851,12 ",2812337275,CFD," 0,00 "
20/09/2024 08:24:58,Open Position,NSDQ100/USD," 969,99 ",0.980362," 0,00 "," 5.451,10 "," 2.881,13 ",2812354700,CFD," 0,00 "
20/09/2024 08:25:29,Open Position,NSDQ100/USD," 350,00 ",0.353667," 0,00 "," 5.451,10 "," 2.531,13 ",2812354817,CFD," 0,00 "
20/09/2024 08:52:35,Position closed,NSDQ100/USD," 969,43 ",0.980362,"(0,56)"," 5.450,54 "," 3.500,56 ",2812354700,CFD," 0,00 "
20/09/2024 08:54:00,Open Position,NSDQ100/USD," 350,00 ",0.353801," 0,00 "," 5.450,54 "," 3.150,56 ",2812365558,CFD," 0,00 "
20/09/2024 08:54:48,Open Position,NSDQ100/USD," 249,99 ",0.252750," 0,00 "," 5.450,54 "," 2.900,57 ",2812365695,CFD," 0,00 "
20/09/2024 09:20:48,Position closed,NSDQ100/USD," 253,41 ",0.252750," 3,42 "," 5.453,96 "," 3.153,98 ",2812365695,CFD," 0,00 "
20/09/2024 09:20:55,Position closed,NSDQ100/USD," 353,83 ",0.353801," 3,83 "," 5.457,79 "," 3.507,81 ",2812365558,CFD," 0,00 "
20/09/2024 09:21:04,Position closed,NSDQ100/USD," 350,29 ",0.353667," 0,29 "," 5.458,08 "," 3.858,10 ",2812354817,CFD," 0,00 "
20/09/2024 10:21:43,Open Position,NSDQ100/USD," 399,99 ",0.404471," 0,00 "," 5.458,08 "," 3.458,11 ",2812392531,CFD," 0,00 "
20/09/2024 11:16:15,Withdraw Fee,-," 0,00 ",-," 0,00 "," 5.458,08 "," 3.458,11 ",-,-," 0,00 "
20/09/2024 11:16:15,Withdraw Request,-,"(300,00)",-,"(300,00)"," 5.158,08 "," 3.158,11 ",-,-," 0,00 "
20/09/2024 11:16:15,Withdrawal Conversion Fee,-,"(1,79)",-," 0,00 "," 5.158,08 "," 3.158,11 ",-,-," 0,00 "
20/09/2024 11:17:54,Deposit Conversion Fee,-,"(1,80)",-," 0,00 "," 5.455,24 "," 3.455,27 ",-,-," 0,00 "
20/09/2024 11:17:54,Deposit,268.00 EUR eToroMoney," 297,16 ",-," 297,16 "," 5.455,24 "," 3.455,27 ",-,-," 0,00 "
20/09/2024 11:18:40,Withdraw Fee,-,"(5,00)",-,"(5,00)"," 5.450,24 "," 3.450,27 ",-,-," 0,00 "
20/09/2024 11:18:40,Withdrawal Conversion Fee,-," 0,00 ",-," 0,00 "," 5.155,24 "," 3.155,27 ",-,-," 0,00 "
20/09/2024 11:18:40,Withdraw Request,-,"(295,00)",-,"(295,00)"," 5.155,24 "," 3.155,27 ",-,-," 0,00 "
20/09/2024 11:19:15,Open Position,NSDQ100/USD," 249,99 ",0.253014," 0,00 "," 5.155,24 "," 2.905,28 ",2812406851,CFD," 0,00 "
20/09/2024 11:48:31,Open Position,NSDQ100/USD," 300,00 ",0.303499," 0,00 "," 5.155,24 "," 2.605,28 ",2812412611,CFD," 0,00 "
20/09/2024 12:00:46,Position closed,NSDQ100/USD," 400,45 ",0.404471," 0,46 "," 5.155,70 "," 3.005,73 ",2812392531,CFD," 0,00 "
20/09/2024 12:01:12,Position closed,NSDQ100/USD," 254,68 ",0.253014," 4,69 "," 5.160,39 "," 3.260,41 ",2812406851,CFD," 0,00 "
20/09/2024 12:02:24,Position closed,NSDQ100/USD," 304,80 ",0.303499," 4,80 "," 5.165,19 "," 3.565,21 ",2812412611,CFD," 0,00 "
20/09/2024 12:07:40,Position closed,NSDQ100/USD," 197,31 ",0.201931,"(2,68)"," 5.162,51 "," 3.762,52 ",2812337275,CFD," 0,00 "
20/09/2024 12:43:53,Position closed,NSDQ100/USD," 300,67 ",0.302558," 0,67 "," 5.163,18 "," 4.063,19 ",2812308325,CFD," 0,00 "
20/09/2024 12:43:53,Position closed,NSDQ100/USD," 406,70 ",0.403702," 6,71 "," 5.169,89 "," 4.469,89 ",2812323758,CFD," 0,00 "
20/09/2024 12:43:53,Position closed,NSDQ100/USD," 359,69 ",0.353433," 9,69 "," 5.179,58 "," 4.829,58 ",2812325441,CFD," 0,00 "
20/09/2024 12:43:53,Position closed,NSDQ100/USD," 356,90 ",0.353293," 6,90 "," 5.186,48 "," 5.186,48 ",2812320715,CFD," 0,00 "
20/09/2024 13:22:01,Open Position,NSDQ100/USD," 300,00 ",0.303192," 0,00 "," 5.186,48 "," 4.886,48 ",2812437474,CFD," 0,00 "
20/09/2024 13:26:35,Open Position,NSDQ100/USD," 199,99 ",0.202070," 0,00 "," 5.186,48 "," 4.686,49 ",2812438935,CFD," 0,00 "
20/09/2024 13:32:35,Position closed,NSDQ100/USD," 307,39 ",0.303192," 7,39 "," 5.193,87 "," 4.993,88 ",2812437474,CFD," 0,00 "
20/09/2024 13:32:35,Position closed,NSDQ100/USD," 203,76 ",0.202070," 3,77 "," 5.197,64 "," 5.197,64 ",2812438935,CFD," 0,00 "
20/09/2024 13:33:35,Open Position,NSDQ100/USD," 149,99 ",0.151509," 0,00 "," 5.197,64 "," 5.047,65 ",2812500287,CFD," 0,00 "
20/09/2024 13:33:53,Open Position,NSDQ100/USD," 149,99 ",0.151448," 0,00 "," 5.197,64 "," 4.897,66 ",2812501077,CFD," 0,00 "
20/09/2024 13:36:13,Position closed,NSDQ100/USD," 153,95 ",0.151509," 3,96 "," 5.201,60 "," 5.051,61 ",2812500287,CFD," 0,00 "
20/09/2024 13:36:13,Position closed,NSDQ100/USD," 152,74 ",0.151448," 2,75 "," 5.204,35 "," 5.204,35 ",2812501077,CFD," 0,00 "
20/09/2024 13:37:07,Open Position,NSDQ100/USD," 250,00 ",0.252243," 0,00 "," 5.204,35 "," 4.954,35 ",2812506158,CFD," 0,00 "
20/09/2024 13:37:30,Open Position,NSDQ100/USD," 199,99 ",0.201659," 0,00 "," 5.204,35 "," 4.754,36 ",2812506871,CFD," 0,00 "
20/09/2024 13:38:21,Open Position,NSDQ100/USD," 149,99 ",0.151265," 0,00 "," 5.204,35 "," 4.604,37 ",2812508654,CFD," 0,00 "
20/09/2024 13:39:23,Position closed,NSDQ100/USD," 250,54 ",0.252243," 0,54 "," 5.204,89 "," 4.854,91 ",2812506158,CFD," 0,00 "
20/09/2024 13:39:41,Position closed,NSDQ100/USD," 148,72 ",0.151265,"(1,27)"," 5.203,62 "," 5.003,63 ",2812508654,CFD," 0,00 "
20/09/2024 13:40:52,Open Position,NSDQ100/USD," 249,99 ",0.252366," 0,00 "," 5.203,62 "," 4.753,64 ",2812513431,CFD," 0,00 "
20/09/2024 13:41:36,Open Position,NSDQ100/USD," 99,99 ",0.100968," 0,00 "," 5.203,62 "," 4.653,65 ",2812514563,CFD," 0,00 "
20/09/2024 13:43:56,Position closed,NSDQ100/USD," 251,13 ",0.252366," 1,14 "," 5.204,76 "," 4.904,78 ",2812513431,CFD," 0,00 "
20/09/2024 13:44:09,Position closed,NSDQ100/USD," 101,67 ",0.100968," 1,68 "," 5.206,44 "," 5.006,45 ",2812514563,CFD," 0,00 "
20/09/2024 13:45:01,Open Position,NSDQ100/USD," 299,99 ",0.302881," 0,00 "," 5.206,44 "," 4.706,46 ",2812520292,CFD," 0,00 "
20/09/2024 13:46:26,Position closed,NSDQ100/USD," 301,79 ",0.302881," 1,80 "," 5.208,24 "," 5.008,25 ",2812520292,CFD," 0,00 "
20/09/2024 13:46:40,Open Position,NSDQ100/USD," 200,00 ",0.201891," 0,00 "," 5.208,24 "," 4.808,25 ",2812522349,CFD," 0,00 "
20/09/2024 13:47:20,Open Position,NSDQ100/USD," 249,99 ",0.252487," 0,00 "," 5.208,24 "," 4.558,26 ",2812522998,CFD," 0,00 "
20/09/2024 13:47:59,Position closed,NSDQ100/USD," 253,46 ",0.252487," 3,47 "," 5.211,71 "," 4.811,72 ",2812522998,CFD," 0,00 "
20/09/2024 13:48:11,Position closed,NSDQ100/USD," 202,15 ",0.201891," 2,15 "," 5.213,86 "," 5.013,87 ",2812522349,CFD," 0,00 "
20/09/2024 13:48:35,Open Position,NSDQ100/USD," 149,99 ",0.151410," 0,00 "," 5.213,86 "," 4.863,88 ",2812526779,CFD," 0,00 "
20/09/2024 13:48:52,Open Position,NSDQ100/USD," 299,99 ",0.302912," 0,00 "," 5.213,86 "," 4.563,89 ",2812527088,CFD," 0,00 "
20/09/2024 13:49:52,Open Position,NSDQ100/USD," 149,99 ",0.151504," 0,00 "," 5.213,86 "," 4.413,90 ",2812528431,CFD," 0,00 "
20/09/2024 14:11:29,Open Position,NSDQ100/USD," 250,00 ",0.252931," 0,00 "," 5.213,86 "," 4.163,90 ",2812687059,CFD," 0,00 "
20/09/2024 14:32:48,Open Position,NSDQ100/USD," 250,00 ",0.253273," 0,00 "," 5.213,86 "," 3.913,90 ",2812718212,CFD," 0,00 "
20/09/2024 15:13:20,Open Position,NSDQ100/USD," 300,00 ",0.305253," 0,00 "," 5.213,86 "," 3.613,90 ",2812773549,CFD," 0,00 "
20/09/2024 15:13:38,Position closed,NSDQ100/USD," 228,64 ",0.253273,"(21,36)"," 5.192,50 "," 3.842,54 ",2812718212,CFD," 0,00 "
20/09/2024 15:15:32,Position closed,NSDQ100/USD," 123,67 ",0.151410,"(26,32)"," 5.166,18 "," 3.966,21 ",2812526779,CFD," 0,00 "
20/09/2024 15:16:28,Position closed,NSDQ100/USD," 307,34 ",0.305253," 7,34 "," 5.173,52 "," 4.273,55 ",2812773549,CFD," 0,00 "
20/09/2024 15:16:45,Position closed,NSDQ100/USD," 123,15 ",0.151504,"(26,84)"," 5.146,68 "," 4.396,70 ",2812528431,CFD," 0,00 "
20/09/2024 15:19:15,Open Position,NSDQ100/USD," 300,00 ",0.305292," 0,00 "," 5.146,68 "," 4.096,70 ",2812785673,CFD," 0,00 "
20/09/2024 15:19:47,Open Position,NSDQ100/USD," 299,99 ",0.305187," 0,00 "," 5.146,68 "," 3.796,71 ",2812786327,CFD," 0,00 "
20/09/2024 15:20:45,Open Position,NSDQ100/USD," 299,99 ",0.305097," 0,00 "," 5.146,68 "," 3.496,72 ",2812787604,CFD," 0,00 "
20/09/2024 15:21:13,Position closed,NSDQ100/USD," 302,87 ",0.305097," 2,88 "," 5.149,56 "," 3.799,59 ",2812787604,CFD," 0,00 "
20/09/2024 15:21:17,Position closed,NSDQ100/USD," 304,27 ",0.305187," 4,28 "," 5.153,84 "," 4.103,86 ",2812786327,CFD," 0,00 "
20/09/2024 15:21:27,Position closed,NSDQ100/USD," 293,00 ",0.305292,"(7,00)"," 5.146,84 "," 4.396,86 ",2812785673,CFD," 0,00 "
20/09/2024 15:22:05,Open Position,NSDQ100/USD," 299,99 ",0.304961," 0,00 "," 5.146,84 "," 4.096,87 ",2812788566,CFD," 0,00 "
20/09/2024 15:23:42,Position closed,NSDQ100/USD," 301,53 ",0.304961," 1,54 "," 5.148,38 "," 4.398,40 ",2812788566,CFD," 0,00 "
20/09/2024 15:25:14,Open Position,NSDQ100/USD," 400,00 ",0.406540," 0,00 "," 5.148,38 "," 3.998,40 ",2812790531,CFD," 0,00 "
20/09/2024 15:26:22,Position closed,NSDQ100/USD," 402,87 ",0.406540," 2,87 "," 5.151,25 "," 4.401,27 ",2812790531,CFD," 0,00 "
20/09/2024 15:26:44,Open Position,NSDQ100/USD," 299,98 ",0.304739," 0,00 "," 5.151,25 "," 4.101,29 ",2812791640,CFD," 0,00 "
20/09/2024 15:29:08,Open Position,NSDQ100/USD," 349,99 ",0.355681," 0,00 "," 5.151,25 "," 3.751,30 ",2812793329,CFD," 0,00 "
20/09/2024 15:32:52,Position closed,NSDQ100/USD," 351,54 ",0.355681," 1,55 "," 5.152,80 "," 4.102,84 ",2812793329,CFD," 0,00 "
20/09/2024 15:32:58,Position closed,NSDQ100/USD," 298,44 ",0.304739,"(1,54)"," 5.151,26 "," 4.401,28 ",2812791640,CFD," 0,00 "
20/09/2024 15:35:29,Open Position,NSDQ100/USD," 149,99 ",0.152139," 0,00 "," 5.151,26 "," 4.251,29 ",2812797961,CFD," 0,00 "
20/09/2024 15:37:51,Open Position,NSDQ100/USD," 299,99 ",0.304527," 0,00 "," 5.151,26 "," 3.951,30 ",2812799608,CFD," 0,00 "
20/09/2024 15:39:46,Position closed,NSDQ100/USD," 301,68 ",0.304527," 1,69 "," 5.152,95 "," 4.252,98 ",2812799608,CFD," 0,00 "
20/09/2024 15:43:39,Position closed,NSDQ100/USD," 153,59 ",0.152139," 3,60 "," 5.156,55 "," 4.406,57 ",2812797961,CFD," 0,00 "
20/09/2024 15:43:55,Open Position,NSDQ100/USD," 249,99 ",0.253257," 0,00 "," 5.156,55 "," 4.156,58 ",2812803604,CFD," 0,00 "
20/09/2024 15:48:11,Position closed,NSDQ100/USD," 249,95 ",0.253257,"(0,04)"," 5.156,51 "," 4.406,53 ",2812803604,CFD," 0,00 "
20/09/2024 15:49:20,Open Position,NSDQ100/USD," 339,99 ",0.344458," 0,00 "," 5.156,51 "," 4.066,54 ",2812808403,CFD," 0,00 "
20/09/2024 15:50:50,Open Position,NSDQ100/USD," 200,00 ",0.202639," 0,00 "," 5.156,51 "," 3.866,54 ",2812809849,CFD," 0,00 "
20/09/2024 15:53:13,Open Position,NSDQ100/USD," 200,00 ",0.202793," 0,00 "," 5.156,51 "," 3.666,54 ",2812811874,CFD," 0,00 "
20/09/2024 15:54:32,Position closed,NSDQ100/USD," 199,72 ",0.202793,"(0,28)"," 5.156,23 "," 3.866,26 ",2812811874,CFD," 0,00 "
20/09/2024 15:55:21,Position closed,NSDQ100/USD," 200,31 ",0.202639," 0,31 "," 5.156,54 "," 4.066,57 ",2812809849,CFD," 0,00 "
20/09/2024 15:55:31,Position closed,NSDQ100/USD," 339,66 ",0.344458,"(0,33)"," 5.156,21 "," 4.406,23 ",2812808403,CFD," 0,00 "
20/09/2024 16:01:01,Open Position,NSDQ100/USD," 299,99 ",0.303972," 0,00 "," 5.156,21 "," 4.106,24 ",2812816577,CFD," 0,00 "
20/09/2024 16:05:45,Position closed,NSDQ100/USD," 304,29 ",0.303972," 4,30 "," 5.160,51 "," 4.410,53 ",2812816577,CFD," 0,00 "
20/09/2024 16:08:51,Open Position,NSDQ100/USD," 200,00 ",0.202436," 0,00 "," 5.160,51 "," 4.210,53 ",2812821191,CFD," 0,00 "
20/09/2024 16:10:17,Position closed,NSDQ100/USD," 200,39 ",0.202436," 0,39 "," 5.160,90 "," 4.410,92 ",2812821191,CFD," 0,00 "
20/09/2024 16:11:10,Open Position,NSDQ100/USD," 299,99 ",0.303686," 0,00 "," 5.160,90 "," 4.110,93 ",2812822946,CFD," 0,00 "
20/09/2024 16:12:32,Open Position,NSDQ100/USD," 299,99 ",0.303772," 0,00 "," 5.160,90 "," 3.810,94 ",2812823851,CFD," 0,00 "
20/09/2024 16:13:39,Position closed,NSDQ100/USD," 300,88 ",0.303772," 0,89 "," 5.161,79 "," 4.111,82 ",2812823851,CFD," 0,00 "
20/09/2024 16:13:54,Position closed,NSDQ100/USD," 299,97 ",0.303686,"(0,02)"," 5.161,77 "," 4.411,79 ",2812822946,CFD," 0,00 "
20/09/2024 16:15:17,Open Position,NSDQ100/USD," 400,00 ",0.405052," 0,00 "," 5.161,77 "," 4.011,79 ",2812826236,CFD," 0,00 "
20/09/2024 16:16:00,Position closed,NSDQ100/USD," 403,05 ",0.405052," 3,05 "," 5.164,82 "," 4.414,84 ",2812826236,CFD," 0,00 "
20/09/2024 16:16:06,Position closed,NSDQ100/USD," 246,62 ",0.252931,"(3,38)"," 5.161,44 "," 4.661,46 ",2812687059,CFD," 0,00 "
20/09/2024 16:17:02,Open Position,NSDQ100/USD," 299,99 ",0.303761," 0,00 "," 5.161,44 "," 4.361,47 ",2812827860,CFD," 0,00 "
20/09/2024 16:18:58,Open Position,NSDQ100/USD," 249,99 ",0.253189," 0,00 "," 5.161,44 "," 4.111,48 ",2812828954,CFD," 0,00 "
20/09/2024 16:19:33,Position closed,NSDQ100/USD," 251,85 ",0.253189," 1,86 "," 5.163,30 "," 4.363,33 ",2812828954,CFD," 0,00 "
20/09/2024 16:19:38,Position closed,NSDQ100/USD," 301,43 ",0.303761," 1,44 "," 5.164,74 "," 4.664,76 ",2812827860,CFD," 0,00 "
20/09/2024 16:20:36,Open Position,NSDQ100/USD," 250,00 ",0.253078," 0,00 "," 5.164,74 "," 4.414,76 ",2812829712,CFD," 0,00 "
20/09/2024 16:22:46,Position closed,NSDQ100/USD," 251,40 ",0.253078," 1,40 "," 5.166,14 "," 4.666,16 ",2812829712,CFD," 0,00 "
20/09/2024 16:23:57,Open Position,NSDQ100/USD," 249,99 ",0.252879," 0,00 "," 5.166,14 "," 4.416,17 ",2812833029,CFD," 0,00 "
20/09/2024 16:24:41,Position closed,NSDQ100/USD," 250,66 ",0.252879," 0,67 "," 5.166,81 "," 4.666,83 ",2812833029,CFD," 0,00 "
20/09/2024 16:29:06,Open Position,NSDQ100/USD," 299,99 ",0.303300," 0,00 "," 5.166,81 "," 4.366,84 ",2812837912,CFD," 0,00 "
20/09/2024 16:31:04,Position closed,NSDQ100/USD," 300,21 ",0.303300," 0,22 "," 5.167,03 "," 4.667,05 ",2812837912,CFD," 0,00 "
20/09/2024 16:34:23,Open Position,NSDQ100/USD," 350,00 ",0.354074," 0,00 "," 5.167,03 "," 4.317,05 ",2812843499,CFD," 0,00 "
20/09/2024 17:02:05,Position closed,NSDQ100/USD," 357,20 ",0.354074," 7,20 "," 5.174,23 "," 4.674,25 ",2812843499,CFD," 0,00 "
20/09/2024 17:50:10,Open Position,NSDQ100/USD," 299,99 ",0.303458," 0,00 "," 5.174,23 "," 4.374,26 ",2812889649,CFD," 0,00 "
20/09/2024 18:19:47,Open Position,NSDQ100/USD," 449,99 ",0.456185," 0,00 "," 5.174,23 "," 3.924,27 ",2812906006,CFD," 0,00 "
20/09/2024 18:25:02,Open Position,NSDQ100/USD," 299,99 ",0.304251," 0,00 "," 5.174,23 "," 3.624,28 ",2812907653,CFD," 0,00 "
20/09/2024 18:49:58,Open Position,NSDQ100/USD," 499,99 ",0.506977," 0,00 "," 5.174,23 "," 3.124,29 ",2812918312,CFD," 0,00 "
20/09/2024 19:00:02,Position closed,NSDQ100/USD," 185,01 ",0.201659,"(14,98)"," 5.159,25 "," 3.309,30 ",2812506871,CFD," 0,00 "
20/09/2024 19:00:02,Position closed,NSDQ100/USD," 296,54 ",0.303458,"(3,45)"," 5.155,80 "," 3.605,84 ",2812889649,CFD," 0,00 "
20/09/2024 19:00:02,Position closed,NSDQ100/USD," 464,51 ",0.456185," 14,52 "," 5.170,32 "," 4.070,35 ",2812906006,CFD," 0,00 "
20/09/2024 19:00:02,Position closed,NSDQ100/USD," 285,73 ",0.302912,"(14,26)"," 5.156,06 "," 4.356,08 ",2812527088,CFD," 0,00 "
20/09/2024 19:00:03,Position closed,NSDQ100/USD," 312,20 ",0.304251," 12,21 "," 5.168,27 "," 4.668,28 ",2812907653,CFD," 0,00 "
20/09/2024 19:00:03,Position closed,NSDQ100/USD," 518,21 ",0.506977," 18,22 "," 5.186,49 "," 5.186,49 ",2812918312,CFD," 0,00 "
22/09/2024 22:00:34,Open Position,NSDQ100/USD," 999,98 ",1.010739," 0,00 "," 5.186,49 "," 4.186,51 ",2812989277,CFD," 0,00 "
22/09/2024 22:00:34,Open Position,NSDQ100/USD," 1.499,98 ",1.516114," 0,00 "," 5.186,49 "," 2.686,53 ",2812989289,CFD," 0,00 "
22/09/2024 22:41:45,Position closed,NSDQ100/USD," 1.519,42 ",1.516114," 19,44 "," 5.205,93 "," 4.205,95 ",2812989289,CFD," 0,00 "
22/09/2024 22:41:45,Position closed,NSDQ100/USD," 1.012,94 ",1.010739," 12,96 "," 5.218,89 "," 5.218,89 ",2812989277,CFD," 0,00 "
22/09/2024 22:42:19,Open Position,NSDQ100/USD," 600,00 ",0.605908," 0,00 "," 5.218,89 "," 4.618,89 ",2812997750,CFD," 0,00 "
23/09/2024 06:47:06,Position closed,NSDQ100/USD," 633,95 ",0.605908," 33,95 "," 5.252,84 "," 5.252,84 ",2812997750,CFD," 0,00 "
23/09/2024 07:17:11,Open Position,NSDQ100/USD," 530,00 ",0.536877," 0,00 "," 5.252,84 "," 4.722,84 ",2813082610,CFD," 0,00 "
23/09/2024 07:17:24,Open Position,NSDQ100/USD," 499,99 ",0.506496," 0,00 "," 5.252,84 "," 4.222,85 ",2813082677,CFD," 0,00 "
23/09/2024 07:17:47,Open Position,NSDQ100/USD," 1.100,00 ",1.114071," 0,00 "," 5.252,84 "," 3.122,85 ",2813082784,CFD," 0,00 "
23/09/2024 07:18:47,Open Position,NSDQ100/USD," 350,00 ",0.354631," 0,00 "," 5.252,84 "," 2.772,85 ",2813083153,CFD," 0,00 "
23/09/2024 07:20:41,Open Position,NSDQ100/USD," 699,89 ",0.709188," 0,00 "," 5.252,84 "," 2.072,96 ",2813083810,CFD," 0,00 "
23/09/2024 07:23:09,Position closed,NSDQ100/USD," 1.101,83 ",1.114071," 1,83 "," 5.254,67 "," 3.174,79 ",2813082784,CFD," 0,00 "
23/09/2024 07:24:20,Open Position,NSDQ100/USD," 800,00 ",0.810307," 0,00 "," 5.254,67 "," 2.374,79 ",2813104871,CFD," 0,00 "
23/09/2024 07:26:55,Position closed,NSDQ100/USD," 356,61 ",0.354631," 6,61 "," 5.261,28 "," 2.731,40 ",2813083153,CFD," 0,00 "
23/09/2024 07:26:55,Position closed,NSDQ100/USD," 537,32 ",0.536877," 7,32 "," 5.268,60 "," 3.268,72 ",2813082610,CFD," 0,00 "
23/09/2024 07:26:55,Position closed,NSDQ100/USD," 507,05 ",0.506496," 7,06 "," 5.275,66 "," 3.775,77 ",2813082677,CFD," 0,00 "
23/09/2024 07:26:55,Position closed,NSDQ100/USD," 713,61 ",0.709188," 13,72 "," 5.289,38 "," 4.489,38 ",2813083810,CFD," 0,00 "
23/09/2024 07:26:55,Position closed,NSDQ100/USD," 809,59 ",0.810307," 9,59 "," 5.298,97 "," 5.298,97 ",2813104871,CFD," 0,00 "
23/09/2024 07:27:47,Open Position,NSDQ100/USD," 530,00 ",0.536424," 0,00 "," 5.298,97 "," 4.768,97 ",2813106867,CFD," 0,00 "
23/09/2024 07:27:58,Open Position,NSDQ100/USD," 499,99 ",0.506052," 0,00 "," 5.298,97 "," 4.268,98 ",2813106912,CFD," 0,00 "
23/09/2024 07:28:41,Open Position,NSDQ100/USD," 1.100,00 ",1.113057," 0,00 "," 5.298,97 "," 3.168,98 ",2813108141,CFD," 0,00 "
23/09/2024 07:29:14,Open Position,NSDQ100/USD," 499,99 ",0.505694," 0,00 "," 5.298,97 "," 2.668,99 ",2813108310,CFD," 0,00 "
23/09/2024 07:30:42,Open Position,NSDQ100/USD," 300,00 ",0.303490," 0,00 "," 5.298,97 "," 2.368,99 ",2813109101,CFD," 0,00 "
23/09/2024 07:31:54,Position closed,NSDQ100/USD," 502,58 ",0.505694," 2,59 "," 5.301,56 "," 2.871,57 ",2813108310,CFD," 0,00 "
23/09/2024 07:31:54,Position closed,NSDQ100/USD," 509,68 ",0.506052," 9,69 "," 5.311,25 "," 3.381,25 ",2813106912,CFD," 0,00 "
23/09/2024 07:31:54,Position closed,NSDQ100/USD," 1.116,18 ",1.113057," 16,18 "," 5.327,43 "," 4.497,43 ",2813108141,CFD," 0,00 "
23/09/2024 07:31:54,Position closed,NSDQ100/USD," 540,43 ",0.536424," 10,43 "," 5.337,86 "," 5.037,86 ",2813106867,CFD," 0,00 "
23/09/2024 07:31:54,Position closed,NSDQ100/USD," 303,01 ",0.303490," 3,01 "," 5.340,87 "," 5.340,87 ",2813109101,CFD," 0,00 "
23/09/2024 07:32:16,Open Position,NSDQ100/USD," 540,00 ",0.545865," 0,00 "," 5.340,87 "," 4.800,87 ",2813109475,CFD," 0,00 "
23/09/2024 07:32:27,Open Position,NSDQ100/USD," 499,99 ",0.505464," 0,00 "," 5.340,87 "," 4.300,88 ",2813109522,CFD," 0,00 "
23/09/2024 07:32:55,Open Position,NSDQ100/USD," 499,99 ",0.505346," 0,00 "," 5.340,87 "," 3.800,89 ",2813109667,CFD," 0,00 "
23/09/2024 07:33:08,Open Position,NSDQ100/USD," 499,99 ",0.505331," 0,00 "," 5.340,87 "," 3.300,90 ",2813109723,CFD," 0,00 "
23/09/2024 07:33:32,Open Position,NSDQ100/USD," 399,99 ",0.404308," 0,00 "," 5.340,87 "," 2.900,91 ",2813109851,CFD," 0,00 "
23/09/2024 07:35:50,Open Position,NSDQ100/USD," 300,00 ",0.303398," 0,00 "," 5.340,87 "," 2.600,91 ",2813110541,CFD," 0,00 "
23/09/2024 07:40:56,Position closed,NSDQ100/USD," 506,92 ",0.505346," 6,93 "," 5.347,80 "," 3.107,83 ",2813109667,CFD," 0,00 "
23/09/2024 07:40:56,Position closed,NSDQ100/USD," 509,25 ",0.505464," 9,26 "," 5.357,06 "," 3.617,08 ",2813109522,CFD," 0,00 "
23/09/2024 07:40:56,Position closed,NSDQ100/USD," 549,29 ",0.545865," 9,29 "," 5.366,35 "," 4.166,37 ",2813109475,CFD," 0,00 "
23/09/2024 07:40:56,Position closed,NSDQ100/USD," 506,62 ",0.505331," 6,63 "," 5.372,98 "," 4.672,99 ",2813109723,CFD," 0,00 "
23/09/2024 07:40:56,Position closed,NSDQ100/USD," 307,89 ",0.303398," 7,89 "," 5.380,87 "," 4.980,88 ",2813110541,CFD," 0,00 "
23/09/2024 07:40:56,Position closed,NSDQ100/USD," 406,10 ",0.404308," 6,11 "," 5.386,98 "," 5.386,98 ",2813109851,CFD," 0,00 "
23/09/2024 07:41:58,Open Position,NSDQ100/USD," 540,00 ",0.545427," 0,00 "," 5.386,98 "," 4.846,98 ",2813115540,CFD," 0,00 "
23/09/2024 07:42:20,Open Position,NSDQ100/USD," 300,00 ",0.303030," 0,00 "," 5.386,98 "," 4.546,98 ",2813115620,CFD," 0,00 "
23/09/2024 08:24:05,Position closed,NSDQ100/USD," 546,61 ",0.545427," 6,61 "," 5.393,59 "," 5.093,59 ",2813115540,CFD," 0,00 "
23/09/2024 08:24:05,Position closed,NSDQ100/USD," 303,98 ",0.303030," 3,98 "," 5.397,57 "," 5.397,57 ",2813115620,CFD," 0,00 "
23/09/2024 08:25:24,Open Position,NSDQ100/USD," 540,00 ",0.544852," 0,00 "," 5.397,57 "," 4.857,57 ",2813141413,CFD," 0,00 "
23/09/2024 08:25:34,Open Position,NSDQ100/USD," 499,99 ",0.504442," 0,00 "," 5.397,57 "," 4.357,58 ",2813141449,CFD," 0,00 "
23/09/2024 08:34:01,Open Position,NSDQ100/USD," 350,00 ",0.353405," 0,00 "," 5.397,57 "," 4.007,58 ",2813144073,CFD," 0,00 "
23/09/2024 08:35:02,Open Position,NSDQ100/USD," 499,99 ",0.504788," 0,00 "," 5.397,57 "," 3.507,59 ",2813144254,CFD," 0,00 "
23/09/2024 08:47:34,Open Position,NSDQ100/USD," 879,99 ",0.889230," 0,00 "," 5.397,57 "," 2.627,60 ",2813146922,CFD," 0,00 "
23/09/2024 09:42:58,Position closed,NSDQ100/USD," 540,56 ",0.544852," 0,56 "," 5.398,13 "," 3.168,16 ",2813141413,CFD," 0,00 "
23/09/2024 09:43:20,Position closed,NSDQ100/USD," 505,41 ",0.504788," 5,42 "," 5.403,55 "," 3.673,57 ",2813144254,CFD," 0,00 "
23/09/2024 09:43:21,Position closed,NSDQ100/USD," 498,54 ",0.504442,"(1,45)"," 5.402,10 "," 4.172,11 ",2813141449,CFD," 0,00 "
23/09/2024 09:43:21,Position closed,NSDQ100/USD," 354,82 ",0.353405," 4,82 "," 5.406,92 "," 4.526,93 ",2813144073,CFD," 0,00 "
23/09/2024 09:43:21,Position closed,NSDQ100/USD," 905,44 ",0.889230," 25,45 "," 5.432,37 "," 5.432,37 ",2813146922,CFD," 0,00 "
23/09/2024 09:47:20,Open Position,NSDQ100/USD," 300,00 ",0.302422," 0,00 "," 5.432,37 "," 5.132,37 ",2813161770,CFD," 0,00 "
23/09/2024 09:47:30,Open Position,NSDQ100/USD," 399,99 ",0.403217," 0,00 "," 5.432,37 "," 4.732,38 ",2813161784,CFD," 0,00 "
23/09/2024 09:49:32,Open Position,NSDQ100/USD," 399,99 ",0.403114," 0,00 "," 5.432,37 "," 4.332,39 ",2813162177,CFD," 0,00 "
23/09/2024 09:49:47,Open Position,NSDQ100/USD," 300,00 ",0.302349," 0,00 "," 5.432,37 "," 4.032,39 ",2813162216,CFD," 0,00 "
23/09/2024 09:53:55,Open Position,NSDQ100/USD," 300,00 ",0.302341," 0,00 "," 5.432,37 "," 3.732,39 ",2813163092,CFD," 0,00 "
23/09/2024 10:16:46,Open Position,NSDQ100/USD," 399,99 ",0.403234," 0,00 "," 5.432,37 "," 3.332,40 ",2813167714,CFD," 0,00 "
23/09/2024 10:18:14,Open Position,NSDQ100/USD," 100,00 ",0.100799," 0,00 "," 5.432,37 "," 3.232,40 ",2813167882,CFD," 0,00 "
23/09/2024 10:30:05,Open Position,NSDQ100/USD," 249,99 ",0.251946," 0,00 "," 5.432,37 "," 2.982,41 ",2813170373,CFD," 0,00 "
23/09/2024 12:14:14,Open Position,NSDQ100/USD," 399,99 ",0.403268," 0,00 "," 5.432,37 "," 2.582,42 ",2813191926,CFD," 0,00 "
23/09/2024 13:05:00,Position closed,NSDQ100/USD," 405,68 ",0.403217," 5,69 "," 5.438,06 "," 2.988,10 ",2813161784,CFD," 0,00 "
23/09/2024 13:05:00,Position closed,NSDQ100/USD," 303,00 ",0.302349," 3,00 "," 5.441,06 "," 3.291,10 ",2813162216,CFD," 0,00 "
23/09/2024 13:05:00,Position closed,NSDQ100/USD," 304,45 ",0.302422," 4,45 "," 5.445,51 "," 3.595,55 ",2813161770,CFD," 0,00 "
23/09/2024 13:05:00,Position closed,NSDQ100/USD," 403,63 ",0.403114," 3,64 "," 5.449,15 "," 3.999,18 ",2813162177,CFD," 0,00 "
23/09/2024 13:05:00,Position closed,NSDQ100/USD," 252,26 ",0.251946," 2,27 "," 5.451,42 "," 4.251,44 ",2813170373,CFD," 0,00 "
23/09/2024 13:05:00,Position closed,NSDQ100/USD," 406,01 ",0.403234," 6,02 "," 5.457,44 "," 4.657,45 ",2813167714,CFD," 0,00 "
23/09/2024 13:05:00,Position closed,NSDQ100/USD," 302,85 ",0.302341," 2,85 "," 5.460,29 "," 4.960,30 ",2813163092,CFD," 0,00 "
23/09/2024 13:05:00,Position closed,NSDQ100/USD," 101,33 ",0.100799," 1,33 "," 5.461,62 "," 5.061,63 ",2813167882,CFD," 0,00 "
23/09/2024 13:05:00,Position closed,NSDQ100/USD," 406,69 ",0.403268," 6,70 "," 5.468,32 "," 5.468,32 ",2813191926,CFD," 0,00 "
23/09/2024 13:05:25,Open Position,NSDQ100/USD," 550,00 ",0.553910," 0,00 "," 5.468,32 "," 4.918,32 ",2813202386,CFD," 0,00 "
23/09/2024 13:05:35,Open Position,NSDQ100/USD," 300,00 ",0.302090," 0,00 "," 5.468,32 "," 4.618,32 ",2813202413,CFD," 0,00 "
23/09/2024 13:42:06,Open Position,NSDQ100/USD," 600,00 ",0.605426," 0,00 "," 5.468,32 "," 4.018,32 ",2813351568,CFD," 0,00 "
23/09/2024 13:51:41,Position closed,NSDQ100/USD," 614,43 ",0.605426," 14,43 "," 5.482,75 "," 4.632,75 ",2813351568,CFD," 0,00 "
23/09/2024 13:52:30,Open Position,NSDQ100/USD," 350,00 ",0.352629," 0,00 "," 5.482,75 "," 4.282,75 ",2813443911,CFD," 0,00 "
23/09/2024 14:01:32,Open Position,NSDQ100/USD," 299,99 ",0.302080," 0,00 "," 5.482,75 "," 3.982,76 ",2813463070,CFD," 0,00 "
23/09/2024 14:06:46,Open Position,NSDQ100/USD," 349,98 ",0.352555," 0,00 "," 5.482,75 "," 3.632,78 ",2813471784,CFD," 0,00 "
23/09/2024 14:20:55,Open Position,NSDQ100/USD," 299,99 ",0.302242," 0,00 "," 5.482,75 "," 3.332,79 ",2813493693,CFD," 0,00 "
23/09/2024 14:23:10,Position closed,NSDQ100/USD," 555,36 ",0.553910," 5,36 "," 5.488,11 "," 3.888,15 ",2813202386,CFD," 0,00 "
23/09/2024 14:23:10,Position closed,NSDQ100/USD," 301,87 ",0.302080," 1,88 "," 5.489,99 "," 4.190,02 ",2813463070,CFD," 0,00 "
23/09/2024 14:23:10,Position closed,NSDQ100/USD," 356,21 ",0.352629," 6,21 "," 5.496,20 "," 4.546,23 ",2813443911,CFD," 0,00 "
23/09/2024 14:23:10,Position closed,NSDQ100/USD," 302,08 ",0.302090," 2,08 "," 5.498,28 "," 4.848,31 ",2813202413,CFD," 0,00 "
23/09/2024 14:23:10,Position closed,NSDQ100/USD," 305,07 ",0.302242," 5,08 "," 5.503,36 "," 5.153,38 ",2813493693,CFD," 0,00 "
23/09/2024 14:23:10,Position closed,NSDQ100/USD," 355,06 ",0.352555," 5,08 "," 5.508,44 "," 5.508,44 ",2813471784,CFD," 0,00 "
23/09/2024 14:23:55,Open Position,NSDQ100/USD," 350,00 ",0.352078," 0,00 "," 5.508,44 "," 5.158,44 ",2813500519,CFD," 0,00 "
23/09/2024 14:27:04,Open Position,NSDQ100/USD," 499,99 ",0.503470," 0,00 "," 5.508,44 "," 4.658,45 ",2813505669,CFD," 0,00 "
23/09/2024 14:27:31,Open Position,NSDQ100/USD," 499,99 ",0.503470," 0,00 "," 5.508,44 "," 4.158,46 ",2813506312,CFD," 0,00 "
23/09/2024 14:28:15,Open Position,NSDQ100/USD," 249,99 ",0.251766," 0,00 "," 5.508,44 "," 3.908,47 ",2813507038,CFD," 0,00 "
23/09/2024 14:28:23,Open Position,NSDQ100/USD," 550,00 ",0.553828," 0,00 "," 5.508,44 "," 3.358,47 ",2813507265,CFD," 0,00 "
23/09/2024 14:35:05,Open Position,NSDQ100/USD," 299,99 ",0.302086," 0,00 "," 5.508,44 "," 3.058,48 ",2813516575,CFD," 0,00 "
23/09/2024 14:54:15,Position closed,NSDQ100/USD," 351,70 ",0.352078," 1,70 "," 5.510,14 "," 3.410,18 ",2813500519,CFD," 0,00 "
23/09/2024 14:54:15,Position closed,NSDQ100/USD," 512,39 ",0.503470," 12,40 "," 5.522,54 "," 3.922,57 ",2813505669,CFD," 0,00 "
23/09/2024 14:54:15,Position closed,NSDQ100/USD," 256,82 ",0.251766," 6,83 "," 5.529,37 "," 4.179,39 ",2813507038,CFD," 0,00 "
23/09/2024 14:54:15,Position closed,NSDQ100/USD," 512,39 ",0.503470," 12,40 "," 5.541,77 "," 4.691,78 ",2813506312,CFD," 0,00 "
23/09/2024 14:54:15,Position closed,NSDQ100/USD," 563,86 ",0.553828," 13,86 "," 5.555,63 "," 5.255,64 ",2813507265,CFD," 0,00 "
23/09/2024 14:54:15,Position closed,NSDQ100/USD," 307,52 ",0.302086," 7,53 "," 5.563,16 "," 5.563,16 ",2813516575,CFD," 0,00 "
23/09/2024 14:55:27,Open Position,NSDQ100/USD," 560,00 ",0.563475," 0,00 "," 5.563,16 "," 5.003,16 ",2813543528,CFD," 0,00 "
23/09/2024 14:55:46,Open Position,NSDQ100/USD," 499,99 ",0.503110," 0,00 "," 5.563,16 "," 4.503,17 ",2813543751,CFD," 0,00 "
23/09/2024 14:56:07,Open Position,NSDQ100/USD," 350,00 ",0.352239," 0,00 "," 5.563,16 "," 4.153,17 ",2813544041,CFD," 0,00 "
23/09/2024 14:56:30,Open Position,NSDQ100/USD," 600,00 ",0.604018," 0,00 "," 5.563,16 "," 3.553,17 ",2813544578,CFD," 0,00 "
23/09/2024 14:56:54,Open Position,NSDQ100/USD," 890,00 ",0.895992," 0,00 "," 5.563,16 "," 2.663,17 ",2813544842,CFD," 0,00 "
23/09/2024 14:57:13,Open Position,NSDQ100/USD," 499,99 ",0.503369," 0,00 "," 5.563,16 "," 2.163,18 ",2813545060,CFD," 0,00 "
23/09/2024 14:57:55,Open Position,NSDQ100/USD," 550,00 ",0.553522," 0,00 "," 5.563,16 "," 1.613,18 ",2813545484,CFD," 0,00 "
23/09/2024 15:00:57,Open Position,NSDQ100/USD," 410,00 ",0.412777," 0,00 "," 5.563,16 "," 1.203,18 ",2813548882,CFD," 0,00 "
23/09/2024 15:02:05,Open Position,NSDQ100/USD," 309,99 ",0.312245," 0,00 "," 5.563,16 "," 893,19 ",2813551164,CFD," 0,00 "
23/09/2024 15:04:43,Open Position,NSDQ100/USD," 399,99 ",0.403064," 0,00 "," 5.563,16 "," 493,20 ",2813555619,CFD," 0,00 "
23/09/2024 15:09:59,Open Position,NSDQ100/USD," 129,99 ",0.131006," 0,00 "," 5.563,16 "," 363,21 ",2813562559,CFD," 0,00 "
23/09/2024 15:34:08,Position closed,NSDQ100/USD," 498,24 ",0.503110,"(1,75)"," 5.561,41 "," 861,45 ",2813543751,CFD," 0,00 "
23/09/2024 15:34:08,Position closed,NSDQ100/USD," 557,87 ",0.563475,"(2,13)"," 5.559,28 "," 1.419,32 ",2813543528,CFD," 0,00 "
23/09/2024 15:34:08,Position closed,NSDQ100/USD," 350,01 ",0.352239," 0,01 "," 5.559,29 "," 1.769,33 ",2813544041,CFD," 0,00 "
23/09/2024 15:34:08,Position closed,NSDQ100/USD," 503,37 ",0.503369," 3,38 "," 5.562,67 "," 2.272,70 ",2813545060,CFD," 0,00 "
23/09/2024 15:34:08,Position closed,NSDQ100/USD," 603,58 ",0.604018," 3,58 "," 5.566,25 "," 2.876,28 ",2813544578,CFD," 0,00 "
23/09/2024 15:34:08,Position closed,NSDQ100/USD," 550,07 ",0.553522," 0,07 "," 5.566,32 "," 3.426,35 ",2813545484,CFD," 0,00 "
23/09/2024 15:34:08,Position closed,NSDQ100/USD," 895,93 ",0.895992," 5,93 "," 5.572,25 "," 4.322,28 ",2813544842,CFD," 0,00 "
23/09/2024 15:34:08,Position closed,NSDQ100/USD," 413,06 ",0.412777," 3,06 "," 5.575,31 "," 4.735,34 ",2813548882,CFD," 0,00 "
23/09/2024 15:34:08,Position closed,NSDQ100/USD," 410,07 ",0.403064," 10,08 "," 5.585,39 "," 5.145,41 ",2813555619,CFD," 0,00 "
23/09/2024 15:34:08,Position closed,NSDQ100/USD," 133,48 ",0.131006," 3,49 "," 5.588,88 "," 5.278,89 ",2813562559,CFD," 0,00 "
23/09/2024 15:34:08,Position closed,NSDQ100/USD," 315,21 ",0.312245," 5,22 "," 5.594,10 "," 5.594,10 ",2813551164,CFD," 0,00 "
23/09/2024 15:35:02,Open Position,NSDQ100/USD," 299,99 ",0.301869," 0,00 "," 5.594,10 "," 5.294,11 ",2813581604,CFD," 0,00 "
23/09/2024 15:35:14,Open Position,NSDQ100/USD," 400,00 ",0.402527," 0,00 "," 5.594,10 "," 4.894,11 ",2813581762,CFD," 0,00 "
23/09/2024 15:36:09,Open Position,NSDQ100/USD," 299,99 ",0.301819," 0,00 "," 5.594,10 "," 4.594,12 ",2813582100,CFD," 0,00 "
23/09/2024 15:36:46,Open Position,NSDQ100/USD," 350,00 ",0.352188," 0,00 "," 5.594,10 "," 4.244,12 ",2813582592,CFD," 0,00 "
23/09/2024 15:37:05,Open Position,NSDQ100/USD," 200,00 ",0.201205," 0,00 "," 5.594,10 "," 4.044,12 ",2813582852,CFD," 0,00 "
23/09/2024 15:37:22,Open Position,NSDQ100/USD," 249,99 ",0.251512," 0,00 "," 5.594,10 "," 3.794,13 ",2813582988,CFD," 0,00 "
23/09/2024 15:40:18,Open Position,BABA/USD," 99,99 ",5.520244," 0,00 "," 5.594,10 "," 3.694,14 ",2813584883,CFD," 0,00 "
23/09/2024 16:36:43,Open Position,NSDQ100/USD," 930,00 ",0.937394," 0,00 "," 5.594,10 "," 2.764,14 ",2813627647,CFD," 0,00 "
23/09/2024 16:56:04,Open Position,NSDQ100/USD," 499,99 ",0.504769," 0,00 "," 5.594,10 "," 2.264,15 ",2813637009,CFD," 0,00 "
23/09/2024 17:04:25,Open Position,NSDQ100/USD," 349,99 ",0.353206," 0,00 "," 5.594,10 "," 1.914,16 ",2813640498,CFD," 0,00 "
23/09/2024 18:02:37,Position closed,NSDQ100/USD," 514,04 ",0.504769," 14,05 "," 5.608,15 "," 2.428,20 ",2813637009,CFD," 0,00 "
23/09/2024 18:02:50,Position closed,NSDQ100/USD," 357,59 ",0.353206," 7,60 "," 5.615,75 "," 2.785,79 ",2813640498,CFD," 0,00 "
23/09/2024 18:26:47,Position closed,NSDQ100/USD," 928,33 ",0.937394,"(1,67)"," 5.614,08 "," 3.714,12 ",2813627647,CFD," 0,00 "
23/09/2024 19:21:24,Open Position,NSDQ100/USD," 299,99 ",0.302278," 0,00 "," 5.614,08 "," 3.414,13 ",2813722804,CFD," 0,00 "
23/09/2024 23:59:40,Open Position,NSDQ100/USD," 449,99 ",0.453437," 0,00 "," 5.614,08 "," 2.964,14 ",2813754765,CFD," 0,00 "
24/09/2024 00:48:09,Overnight fee,Daily,"(0,15)",-,"(0,15)"," 5.613,93 "," 2.963,99 ",2813584883,CFD," 0,00 "
24/09/2024 00:48:09,Overnight fee,Daily,"(1,02)",-,"(1,02)"," 5.612,91 "," 2.962,97 ",2813582852,CFD," 0,00 "
24/09/2024 00:48:09,Overnight fee,Daily,"(1,28)",-,"(1,28)"," 5.611,63 "," 2.961,69 ",2813582988,CFD," 0,00 "
24/09/2024 00:48:09,Overnight fee,Daily,"(1,53)",-,"(1,53)"," 5.610,10 "," 2.960,16 ",2813581604,CFD," 0,00 "
24/09/2024 00:48:09,Overnight fee,Daily,"(1,53)",-,"(1,53)"," 5.608,57 "," 2.958,63 ",2813582100,CFD," 0,00 "
24/09/2024 00:48:09,Overnight fee,Daily,"(1,53)",-,"(1,53)"," 5.607,04 "," 2.957,10 ",2813722804,CFD," 0,00 "
24/09/2024 00:48:09,Overnight fee,Daily,"(1,79)",-,"(1,79)"," 5.605,25 "," 2.955,31 ",2813582592,CFD," 0,00 "
24/09/2024 00:48:09,Overnight fee,Daily,"(2,04)",-,"(2,04)"," 5.603,21 "," 2.953,27 ",2813581762,CFD," 0,00 "
24/09/2024 05:10:31,Position closed,NSDQ100/USD," 462,42 ",0.453437," 12,43 "," 5.615,64 "," 3.415,69 ",2813754765,CFD," 0,00 "
24/09/2024 05:10:31,Position closed,NSDQ100/USD," 308,02 ",0.302278," 8,03 "," 5.623,67 "," 3.723,71 ",2813722804,CFD," 0,00 "
24/09/2024 05:53:26,Position closed,NSDQ100/USD," 301,61 ",0.301869," 1,62 "," 5.625,29 "," 4.025,32 ",2813581604,CFD," 0,00 "
24/09/2024 05:53:26,Position closed,NSDQ100/USD," 200,28 ",0.201205," 0,28 "," 5.625,57 "," 4.225,60 ",2813582852,CFD," 0,00 "
24/09/2024 05:53:26,Position closed,NSDQ100/USD," 352,03 ",0.352188," 2,03 "," 5.627,60 "," 4.577,63 ",2813582592,CFD," 0,00 "
24/09/2024 05:53:26,Position closed,NSDQ100/USD," 300,61 ",0.301819," 0,62 "," 5.628,22 "," 4.878,24 ",2813582100,CFD," 0,00 "
24/09/2024 05:53:26,Position closed,NSDQ100/USD," 250,56 ",0.251512," 0,57 "," 5.628,79 "," 5.128,80 ",2813582988,CFD," 0,00 "
24/09/2024 05:53:26,Position closed,NSDQ100/USD," 402,85 ",0.402527," 2,85 "," 5.631,64 "," 5.531,65 ",2813581762,CFD," 0,00 "
24/09/2024 06:31:32,Open Position,NSDQ100/USD," 50,00 ",0.050298," 0,00 "," 5.631,64 "," 5.481,65 ",2813782117,CFD," 0,00 "
24/09/2024 06:49:38,Open Position,NSDQ100/USD," 249,99 ",0.251272," 0,00 "," 5.631,64 "," 5.231,66 ",2813784496,CFD," 0,00 "
24/09/2024 06:54:24,Open Position,NSDQ100/USD," 149,99 ",0.150699," 0,00 "," 5.631,64 "," 5.081,67 ",2813785245,CFD," 0,00 "
24/09/2024 06:54:53,Position closed,NSDQ100/USD," 51,11 ",0.050298," 1,11 "," 5.632,75 "," 5.132,78 ",2813782117,CFD," 0,00 "
24/09/2024 06:55:00,Position closed,NSDQ100/USD," 250,92 ",0.251272," 0,93 "," 5.633,68 "," 5.383,70 ",2813784496,CFD," 0,00 "
24/09/2024 06:57:23,Position closed,NSDQ100/USD," 150,46 ",0.150699," 0,47 "," 5.634,15 "," 5.534,16 ",2813785245,CFD," 0,00 "
24/09/2024 07:04:16,Open Position,NSDQ100/USD," 250,00 ",0.251180," 0,00 "," 5.634,15 "," 5.284,16 ",2813801727,CFD," 0,00 "
24/09/2024 07:04:32,Position closed,NSDQ100/USD," 249,07 ",0.251180,"(0,93)"," 5.633,22 "," 5.533,23 ",2813801727,CFD," 0,00 "
24/09/2024 07:06:00,Open Position,NSDQ100/USD," 149,99 ",0.150644," 0,00 "," 5.633,22 "," 5.383,24 ",2813806031,CFD," 0,00 "
24/09/2024 07:13:40,Position closed,NSDQ100/USD," 148,02 ",0.150644,"(1,97)"," 5.631,25 "," 5.531,26 ",2813806031,CFD," 0,00 "
24/09/2024 07:14:00,Open Position,NSDQ100/USD," 350,00 ",0.351656," 0,00 "," 5.631,25 "," 5.181,26 ",2813808133,CFD," 0,00 "
24/09/2024 07:34:56,Open Position,NSDQ100/USD," 350,00 ",0.352151," 0,00 "," 5.631,25 "," 4.831,26 ",2813826216,CFD," 0,00 "
24/09/2024 07:35:20,Open Position,NSDQ100/USD," 350,00 ",0.352026," 0,00 "," 5.631,25 "," 4.481,26 ",2813826338,CFD," 0,00 "
24/09/2024 08:08:00,Position closed,NSDQ100/USD," 353,77 ",0.351656," 3,77 "," 5.635,02 "," 4.835,03 ",2813808133,CFD," 0,00 "
24/09/2024 08:08:00,Position closed,NSDQ100/USD," 363,64 ",0.352151," 13,64 "," 5.648,66 "," 5.198,67 ",2813826216,CFD," 0,00 "
24/09/2024 08:08:00,Position closed,NSDQ100/USD," 361,13 ",0.352026," 11,13 "," 5.659,79 "," 5.559,80 ",2813826338,CFD," 0,00 "
24/09/2024 08:10:29,Open Position,NSDQ100/USD," 149,99 ",0.150538," 0,00 "," 5.659,79 "," 5.409,81 ",2813839565,CFD," 0,00 "
24/09/2024 08:12:35,Position closed,NSDQ100/USD," 149,87 ",0.150538,"(0,12)"," 5.659,67 "," 5.559,68 ",2813839565,CFD," 0,00 "
24/09/2024 08:15:07,Open Position,NSDQ100/USD," 249,99 ",0.250759," 0,00 "," 5.659,67 "," 5.309,69 ",2813840670,CFD," 0,00 "
24/09/2024 08:37:04,Position closed,NSDQ100/USD," 250,19 ",0.250759," 0,20 "," 5.659,87 "," 5.559,88 ",2813840670,CFD," 0,00 "
24/09/2024 08:43:20,Open Position,NSDQ100/USD," 350,00 ",0.351146," 0,00 "," 5.659,87 "," 5.209,88 ",2813848678,CFD," 0,00 "
24/09/2024 08:43:32,Open Position,NSDQ100/USD," 199,99 ",0.200648," 0,00 "," 5.659,87 "," 5.009,89 ",2813848716,CFD," 0,00 "
24/09/2024 08:57:36,Open Position,NSDQ100/USD," 149,99 ",0.150440," 0,00 "," 5.659,87 "," 4.859,90 ",2813852375,CFD," 0,00 "
24/09/2024 09:13:53,Open Position,NSDQ100/USD," 350,00 ",0.351185," 0,00 "," 5.659,87 "," 4.509,90 ",2813855751,CFD," 0,00 "
24/09/2024 09:15:30,Open Position,NSDQ100/USD," 149,99 ",0.150535," 0,00 "," 5.659,87 "," 4.359,91 ",2813856161,CFD," 0,00 "
24/09/2024 09:17:02,Open Position,NSDQ100/USD," 199,99 ",0.200723," 0,00 "," 5.659,87 "," 4.159,92 ",2813856473,CFD," 0,00 "
24/09/2024 10:46:55,Open Position,NSDQ100/USD," 500,00 ",0.501972," 0,00 "," 5.659,87 "," 3.659,92 ",2813876777,CFD," 0,00 "
24/09/2024 10:49:07,Open Position,NSDQ100/USD," 350,00 ",0.351479," 0,00 "," 5.659,87 "," 3.309,92 ",2813877342,CFD," 0,00 "
24/09/2024 10:51:08,Open Position,NSDQ100/USD," 300,00 ",0.301330," 0,00 "," 5.659,87 "," 3.009,92 ",2813877970,CFD," 0,00 "
24/09/2024 10:52:24,Open Position,NSDQ100/USD," 250,00 ",0.251142," 0,00 "," 5.659,87 "," 2.759,92 ",2813878306,CFD," 0,00 "
24/09/2024 10:59:37,Open Position,NSDQ100/USD," 399,99 ",0.401804," 0,00 "," 5.659,87 "," 2.359,93 ",2813879439,CFD," 0,00 "
24/09/2024 11:17:57,Open Position,NSDQ100/USD," 499,99 ",0.503811," 0,00 "," 5.659,87 "," 1.859,94 ",2813909455,CFD," 0,00 "
24/09/2024 11:18:07,Open Position,NSDQ100/USD," 199,99 ",0.201526," 0,00 "," 5.659,87 "," 1.659,95 ",2813909478,CFD," 0,00 "
24/09/2024 11:23:20,Open Position,NSDQ100/USD," 300,00 ",0.302148," 0,00 "," 5.659,87 "," 1.359,95 ",2814028893,CFD," 0,00 "
24/09/2024 11:38:04,Position closed,NSDQ100/USD," 208,92 ",0.201526," 8,93 "," 5.668,80 "," 1.568,87 ",2813909478,CFD," 0,00 "
24/09/2024 11:39:33,Position closed,NSDQ100/USD," 311,03 ",0.302148," 11,03 "," 5.679,83 "," 1.879,90 ",2814028893,CFD," 0,00 "
24/09/2024 11:42:54,Position closed,NSDQ100/USD," 525,74 ",0.503811," 25,75 "," 5.705,58 "," 2.405,64 ",2813909455,CFD," 0,00 "
24/09/2024 11:49:47,Open Position,NSDQ100/USD," 300,00 ",0.301568," 0,00 "," 5.705,58 "," 2.105,64 ",2814035003,CFD," 0,00 "
24/09/2024 12:36:30,Open Position,NSDQ100/USD," 530,00 ",0.533459," 0,00 "," 5.705,58 "," 1.575,64 ",2814046901,CFD," 0,00 "
24/09/2024 12:37:27,Open Position,NSDQ100/USD," 399,99 ",0.402601," 0,00 "," 5.705,58 "," 1.175,65 ",2814047107,CFD," 0,00 "
24/09/2024 13:00:33,Position closed,NSDQ100/USD," 298,92 ",0.301568,"(1,08)"," 5.704,50 "," 1.474,57 ",2814035003,CFD," 0,00 "
24/09/2024 13:01:59,Position closed,NSDQ100/USD," 407,73 ",0.402601," 7,74 "," 5.712,24 "," 1.882,30 ",2814047107,CFD," 0,00 "
24/09/2024 13:02:08,Position closed,NSDQ100/USD," 541,21 ",0.533459," 11,21 "," 5.723,45 "," 2.423,51 ",2814046901,CFD," 0,00 "
24/09/2024 13:03:35,Open Position,NSDQ100/USD," 350,00 ",0.351789," 0,00 "," 5.723,45 "," 2.073,51 ",2814052858,CFD," 0,00 "
24/09/2024 13:07:14,Open Position,NSDQ100/USD," 350,00 ",0.351743," 0,00 "," 5.723,45 "," 1.723,51 ",2814056270,CFD," 0,00 "
24/09/2024 13:10:05,Position closed,NSDQ100/USD," 250,05 ",0.251142," 0,05 "," 5.723,50 "," 1.973,56 ",2813878306,CFD," 0,00 "
24/09/2024 13:13:02,Position closed,NSDQ100/USD," 399,07 ",0.401804,"(0,92)"," 5.722,58 "," 2.372,63 ",2813879439,CFD," 0,00 "
24/09/2024 13:13:45,Position closed,NSDQ100/USD," 351,91 ",0.351789," 1,91 "," 5.724,49 "," 2.724,54 ",2814052858,CFD," 0,00 "
24/09/2024 13:13:49,Position closed,NSDQ100/USD," 351,10 ",0.351743," 1,10 "," 5.725,59 "," 3.075,64 ",2814056270,CFD," 0,00 "
24/09/2024 13:14:11,Open Position,NSDQ100/USD," 350,00 ",0.351612," 0,00 "," 5.725,59 "," 2.725,64 ",2814070018,CFD," 0,00 "
24/09/2024 13:29:19,Position closed,NSDQ100/USD," 350,36 ",0.351612," 0,36 "," 5.725,95 "," 3.076,00 ",2814070018,CFD," 0,00 "
24/09/2024 13:30:45,Position closed,NSDQ100/USD," 501,13 ",0.501972," 1,13 "," 5.727,08 "," 3.577,13 ",2813876777,CFD," 0,00 "
24/09/2024 13:31:01,Position closed,NSDQ100/USD," 301,98 ",0.301330," 1,98 "," 5.729,06 "," 3.879,11 ",2813877970,CFD," 0,00 "
24/09/2024 13:32:17,Position closed,BABA/USD," 123,90 ",5.520244," 23,91 "," 5.752,97 "," 4.003,01 ",2813584883,CFD," 0,00 "
24/09/2024 13:33:03,Open Position,NSDQ100/USD," 350,00 ",0.351855," 0,00 "," 5.752,97 "," 3.653,01 ",2814165885,CFD," 0,00 "
24/09/2024 13:33:31,Open Position,NSDQ100/USD," 299,99 ",0.301538," 0,00 "," 5.752,97 "," 3.353,02 ",2814166784,CFD," 0,00 "
24/09/2024 13:34:05,Open Position,NSDQ100/USD," 230,00 ",0.231259," 0,00 "," 5.752,97 "," 3.123,02 ",2814167669,CFD," 0,00 "
24/09/2024 13:34:29,Open Position,NSDQ100/USD," 299,99 ",0.301700," 0,00 "," 5.752,97 "," 2.823,03 ",2814169373,CFD," 0,00 "
24/09/2024 13:35:09,Open Position,NSDQ100/USD," 499,99 ",0.502539," 0,00 "," 5.752,97 "," 2.323,04 ",2814171580,CFD," 0,00 "
24/09/2024 13:38:10,Position closed,NSDQ100/USD," 303,01 ",0.301700," 3,02 "," 5.755,99 "," 2.626,05 ",2814169373,CFD," 0,00 "
24/09/2024 13:38:57,Open Position,NSDQ100/USD," 350,00 ",0.351793," 0,00 "," 5.755,99 "," 2.276,05 ",2814188805,CFD," 0,00 "
24/09/2024 13:43:01,Open Position,NSDQ100/USD," 499,98 ",0.502787," 0,00 "," 5.755,99 "," 1.776,07 ",2814207586,CFD," 0,00 "
24/09/2024 13:57:35,Open Position,NSDQ100/USD," 299,99 ",0.301840," 0,00 "," 5.755,99 "," 1.476,08 ",2814336082,CFD," 0,00 "
24/09/2024 14:06:21,Open Position,NSDQ100/USD," 400,00 ",0.404562," 0,00 "," 5.755,99 "," 1.076,08 ",2814371444,CFD," 0,00 "
24/09/2024 14:06:59,Open Position,NSDQ100/USD," 350,00 ",0.353901," 0,00 "," 5.755,99 "," 726,08 ",2814383854,CFD," 0,00 "
24/09/2024 14:07:52,Open Position,NSDQ100/USD," 299,99 ",0.303129," 0,00 "," 5.755,99 "," 426,09 ",2814385150,CFD," 0,00 "
24/09/2024 14:08:14,Open Position,NSDQ100/USD," 200,00 ",0.202097," 0,00 "," 5.755,99 "," 226,09 ",2814385560,CFD," 0,00 "
24/09/2024 14:17:59,Position closed,NSDQ100/USD," 300,30 ",0.303129," 0,31 "," 5.756,30 "," 526,39 ",2814385150,CFD," 0,00 "
24/09/2024 14:18:29,Open Position,NSDQ100/USD," 299,99 ",0.303086," 0,00 "," 5.756,30 "," 226,40 ",2814401534,CFD," 0,00 "
24/09/2024 14:20:28,Position closed,NSDQ100/USD," 407,25 ",0.404562," 7,25 "," 5.763,55 "," 633,65 ",2814371444,CFD," 0,00 "
24/09/2024 14:21:19,Open Position,NSDQ100/USD," 200,00 ",0.202060," 0,00 "," 5.763,55 "," 433,65 ",2814404521,CFD," 0,00 "
24/09/2024 14:23:33,Open Position,NSDQ100/USD," 350,00 ",0.354419," 0,00 "," 5.763,55 "," 83,65 ",2814418180,CFD," 0,00 "
24/09/2024 14:25:16,Position closed,NSDQ100/USD," 350,61 ",0.353901," 0,61 "," 5.764,16 "," 434,26 ",2814383854,CFD," 0,00 "
24/09/2024 14:26:30,Open Position,NSDQ100/USD," 299,99 ",0.303382," 0,00 "," 5.764,16 "," 134,27 ",2814421617,CFD," 0,00 "
24/09/2024 14:27:31,Position closed,NSDQ100/USD," 360,12 ",0.354419," 10,12 "," 5.774,28 "," 494,39 ",2814418180,CFD," 0,00 "
24/09/2024 14:28:38,Open Position,NSDQ100/USD," 299,99 ",0.303375," 0,00 "," 5.774,28 "," 194,40 ",2814429889,CFD," 0,00 "
24/09/2024 14:36:35,Open Position,NSDQ100/USD," 50,00 ",0.050603," 0,00 "," 5.774,28 "," 144,40 ",2814450398,CFD," 0,00 "
24/09/2024 14:43:04,Deposit,400.00 USD CreditCard," 400,00 ",-," 400,00 "," 6.174,28 "," 544,40 ",-,-," 0,00 "
24/09/2024 14:43:04,Deposit Conversion Fee,-," 0,00 ",-," 0,00 "," 6.174,28 "," 544,40 ",-,-," 0,00 "
24/09/2024 14:43:15,Open Position,NSDQ100/USD," 199,98 ",0.202358," 0,00 "," 6.174,28 "," 344,42 ",2814458152,CFD," 0,00 "
24/09/2024 14:45:02,Position closed,NSDQ100/USD," 50,16 ",0.050603," 0,16 "," 6.174,44 "," 394,58 ",2814450398,CFD," 0,00 "
24/09/2024 14:45:34,Position closed,NSDQ100/USD," 300,91 ",0.303375," 0,92 "," 6.175,36 "," 695,49 ",2814429889,CFD," 0,00 "
24/09/2024 14:47:48,Position closed,NSDQ100/USD," 200,41 ",0.202097," 0,41 "," 6.175,77 "," 895,90 ",2814385560,CFD," 0,00 "
24/09/2024 14:47:59,Position closed,NSDQ100/USD," 205,45 ",0.202358," 5,47 "," 6.181,24 "," 1.101,35 ",2814458152,CFD," 0,00 "
24/09/2024 14:48:35,Open Position,NSDQ100/USD," 299,99 ",0.303081," 0,00 "," 6.181,24 "," 801,36 ",2814465976,CFD," 0,00 "
24/09/2024 14:48:59,Open Position,NSDQ100/USD," 200,00 ",0.202027," 0,00 "," 6.181,24 "," 601,36 ",2814466360,CFD," 0,00 "
24/09/2024 14:51:00,Position closed,NSDQ100/USD," 202,87 ",0.202027," 2,87 "," 6.184,11 "," 804,23 ",2814466360,CFD," 0,00 "
24/09/2024 14:51:15,Position closed,NSDQ100/USD," 202,75 ",0.202060," 2,75 "," 6.186,86 "," 1.006,98 ",2814404521,CFD," 0,00 "
24/09/2024 15:04:05,Position closed,NSDQ100/USD," 323,08 ",0.303382," 23,09 "," 6.209,95 "," 1.330,06 ",2814421617,CFD," 0,00 "
24/09/2024 15:04:31,Open Position,NSDQ100/USD," 339,99 ",0.342346," 0,00 "," 6.209,95 "," 990,07 ",2814493118,CFD," 0,00 "
24/09/2024 15:31:02,Position closed,NSDQ100/USD," 337,10 ",0.351146,"(12,90)"," 6.197,05 "," 1.327,17 ",2813848678,CFD," 0,00 "
24/09/2024 15:31:02,Position closed,NSDQ100/USD," 192,48 ",0.200648,"(7,51)"," 6.189,54 "," 1.519,65 ",2813848716,CFD," 0,00 "
24/09/2024 15:31:02,Position closed,NSDQ100/USD," 143,44 ",0.150440,"(6,55)"," 6.182,99 "," 1.663,09 ",2813852375,CFD," 0,00 "
24/09/2024 15:31:02,Position closed,NSDQ100/USD," 337,80 ",0.351185,"(12,20)"," 6.170,79 "," 2.000,89 ",2813855751,CFD," 0,00 "
24/09/2024 15:31:02,Position closed,NSDQ100/USD," 193,98 ",0.200723,"(6,01)"," 6.164,78 "," 2.194,87 ",2813856473,CFD," 0,00 "
24/09/2024 15:31:02,Position closed,NSDQ100/USD," 343,73 ",0.351479,"(6,27)"," 6.158,51 "," 2.538,60 ",2813877342,CFD," 0,00 "
24/09/2024 15:31:02,Position closed,NSDQ100/USD," 145,35 ",0.150535,"(4,64)"," 6.153,87 "," 2.683,95 ",2813856161,CFD," 0,00 "
24/09/2024 15:31:02,Position closed,NSDQ100/USD," 351,20 ",0.351855," 1,20 "," 6.155,07 "," 3.035,15 ",2814165885,CFD," 0,00 "
24/09/2024 15:31:02,Position closed,NSDQ100/USD," 231,60 ",0.231259," 1,60 "," 6.156,67 "," 3.266,75 ",2814167669,CFD," 0,00 "
24/09/2024 15:31:02,Position closed,NSDQ100/USD," 349,97 ",0.351793,"(0,03)"," 6.156,64 "," 3.616,72 ",2814188805,CFD," 0,00 "
24/09/2024 15:31:02,Position closed,NSDQ100/USD," 300,00 ",0.301538," 0,01 "," 6.156,65 "," 3.916,72 ",2814166784,CFD," 0,00 "
24/09/2024 15:31:02,Position closed,NSDQ100/USD," 499,50 ",0.502539,"(0,49)"," 6.156,16 "," 4.416,22 ",2814171580,CFD," 0,00 "
24/09/2024 15:31:02,Position closed,NSDQ100/USD," 504,46 ",0.502787," 4,48 "," 6.160,64 "," 4.920,68 ",2814207586,CFD," 0,00 "
24/09/2024 15:31:02,Position closed,NSDQ100/USD," 305,91 ",0.301840," 5,92 "," 6.166,56 "," 5.226,59 ",2814336082,CFD," 0,00 "
24/09/2024 15:31:02,Position closed,NSDQ100/USD," 330,61 ",0.303081," 30,62 "," 6.197,18 "," 5.557,20 ",2814465976,CFD," 0,00 "
24/09/2024 15:31:02,Position closed,NSDQ100/USD," 330,70 ",0.303086," 30,71 "," 6.227,89 "," 5.887,90 ",2814401534,CFD," 0,00 "
24/09/2024 15:31:02,Position closed,NSDQ100/USD," 351,88 ",0.342346," 11,89 "," 6.239,78 "," 6.239,78 ",2814493118,CFD," 0,00 "
24/09/2024 15:31:33,Open Position,NSDQ100/USD," 499,99 ",0.502471," 0,00 "," 6.239,78 "," 5.739,79 ",2814526000,CFD," 0,00 "
24/09/2024 15:31:43,Open Position,NSDQ100/USD," 299,99 ",0.301474," 0,00 "," 6.239,78 "," 5.439,80 ",2814526151,CFD," 0,00 "
24/09/2024 15:34:34,Open Position,NSDQ100/USD," 400,00 ",0.401875," 0,00 "," 6.239,78 "," 5.039,80 ",2814530424,CFD," 0,00 "
24/09/2024 15:44:45,Open Position,NSDQ100/USD," 400,00 ",0.401591," 0,00 "," 6.239,78 "," 4.639,80 ",2814540354,CFD," 0,00 "
24/09/2024 15:44:55,Open Position,NSDQ100/USD," 400,00 ",0.401542," 0,00 "," 6.239,78 "," 4.239,80 ",2814540672,CFD," 0,00 "
24/09/2024 15:45:04,Open Position,NSDQ100/USD," 299,99 ",0.301120," 0,00 "," 6.239,78 "," 3.939,81 ",2814540797,CFD," 0,00 "
24/09/2024 15:58:13,Position closed,NSDQ100/USD," 417,63 ",0.401591," 17,63 "," 6.257,41 "," 4.357,44 ",2814540354,CFD," 0,00 "
24/09/2024 15:58:13,Position closed,NSDQ100/USD," 531,65 ",0.502471," 31,66 "," 6.289,07 "," 4.889,09 ",2814526000,CFD," 0,00 "
24/09/2024 15:58:13,Position closed,NSDQ100/USD," 318,83 ",0.301474," 18,84 "," 6.307,91 "," 5.207,92 ",2814526151,CFD," 0,00 "
24/09/2024 15:58:13,Position closed,NSDQ100/USD," 423,31 ",0.401875," 23,31 "," 6.331,22 "," 5.631,23 ",2814530424,CFD," 0,00 "
24/09/2024 15:58:13,Position closed,NSDQ100/USD," 416,66 ",0.401542," 16,66 "," 6.347,88 "," 6.047,89 ",2814540672,CFD," 0,00 "
24/09/2024 15:58:13,Position closed,NSDQ100/USD," 311,76 ",0.301120," 11,77 "," 6.359,65 "," 6.359,65 ",2814540797,CFD," 0,00 "
24/09/2024 15:58:45,Open Position,NSDQ100/USD," 350,00 ",0.350481," 0,00 "," 6.359,65 "," 6.009,65 ",2814555819,CFD," 0,00 "
24/09/2024 15:59:01,Open Position,NSDQ100/USD," 350,00 ",0.350465," 0,00 "," 6.359,65 "," 5.659,65 ",2814555964,CFD," 0,00 "
24/09/2024 15:59:09,Open Position,NSDQ100/USD," 400,00 ",0.400561," 0,00 "," 6.359,65 "," 5.259,65 ",2814556299,CFD," 0,00 "
24/09/2024 16:07:07,Position closed,NSDQ100/USD," 352,17 ",0.350465," 2,17 "," 6.361,82 "," 5.611,82 ",2814555964,CFD," 0,00 "
24/09/2024 16:07:07,Position closed,NSDQ100/USD," 352,49 ",0.350481," 2,49 "," 6.364,31 "," 5.964,31 ",2814555819,CFD," 0,00 "
24/09/2024 16:07:07,Position closed,NSDQ100/USD," 403,08 ",0.400561," 3,08 "," 6.367,39 "," 6.367,39 ",2814556299,CFD," 0,00 "
24/09/2024 16:07:27,Open Position,NSDQ100/USD," 249,99 ",0.250175," 0,00 "," 6.367,39 "," 6.117,40 ",2814564439,CFD," 0,00 "
24/09/2024 16:12:18,Open Position,NSDQ100/USD," 249,99 ",0.250171," 0,00 "," 6.367,39 "," 5.867,41 ",2814568453,CFD," 0,00 "
24/09/2024 17:35:57,Position closed,NSDQ100/USD," 245,01 ",0.250175,"(4,98)"," 6.362,41 "," 6.112,42 ",2814564439,CFD," 0,00 "
24/09/2024 17:36:06,Position closed,NSDQ100/USD," 244,79 ",0.250171,"(5,20)"," 6.357,21 "," 6.357,21 ",2814568453,CFD," 0,00 "
24/09/2024 17:38:53,Open Position,NSDQ100/USD," 249,99 ",0.250568," 0,00 "," 6.357,21 "," 6.107,22 ",2814622587,CFD," 0,00 "
24/09/2024 17:41:22,Position closed,NSDQ100/USD," 249,22 ",0.250568,"(0,77)"," 6.356,44 "," 6.356,44 ",2814622587,CFD," 0,00 "
24/09/2024 17:46:10,Withdraw Fee,-,"(5,00)",-,"(5,00)"," 6.351,44 "," 6.351,44 ",-,-," 0,00 "
24/09/2024 17:46:10,Withdrawal Conversion Fee,-," 0,00 ",-," 0,00 "," 6.006,44 "," 6.006,44 ",-,-," 0,00 "
24/09/2024 17:46:10,Withdraw Request,-,"(345,00)",-,"(345,00)"," 6.006,44 "," 6.006,44 ",-,-," 0,00 "
24/09/2024 18:10:53,Open Position,NSDQ100/USD," 199,99 ",0.200643," 0,00 "," 6.006,44 "," 5.806,45 ",2814640076,CFD," 0,00 "
24/09/2024 18:31:25,Position closed,NSDQ100/USD," 205,51 ",0.200643," 5,52 "," 6.011,96 "," 6.011,96 ",2814640076,CFD," 0,00 "
24/09/2024 18:32:49,Open Position,NSDQ100/USD," 400,00 ",0.401825," 0,00 "," 6.011,96 "," 5.611,96 ",2814652147,CFD," 0,00 "
24/09/2024 18:33:00,Open Position,NSDQ100/USD," 149,99 ",0.150682," 0,00 "," 6.011,96 "," 5.461,97 ",2814652359,CFD," 0,00 "
24/09/2024 19:33:33,Position closed,NSDQ100/USD," 404,46 ",0.401825," 4,46 "," 6.016,42 "," 5.866,43 ",2814652147,CFD," 0,00 "
24/09/2024 19:33:33,Position closed,NSDQ100/USD," 151,63 ",0.150682," 1,64 "," 6.018,06 "," 6.018,06 ",2814652359,CFD," 0,00 "
24/09/2024 19:38:15,Open Position,NSDQ100/USD," 499,99 ",0.501626," 0,00 "," 6.018,06 "," 5.518,07 ",2814734042,CFD," 0,00 "
24/09/2024 20:26:10,Position closed,NSDQ100/USD," 511,66 ",0.501626," 11,67 "," 6.029,73 "," 6.029,73 ",2814734042,CFD," 0,00 "
24/09/2024 22:00:51,Open Position,NSDQ100/USD," 399,98 ",0.400673," 0,00 "," 6.029,73 "," 5.629,75 ",2814763962,CFD," 0,00 "
25/09/2024 00:11:53,Open Position,NSDQ100/USD," 350,00 ",0.350958," 0,00 "," 6.029,73 "," 5.279,75 ",2814771339,CFD," 0,00 "
25/09/2024 00:12:27,Open Position,NSDQ100/USD," 499,99 ",0.501494," 0,00 "," 6.029,73 "," 4.779,76 ",2814771388,CFD," 0,00 "
25/09/2024 01:50:13,Open Position,NSDQ100/USD," 999,99 ",1.005005," 0,00 "," 6.029,73 "," 3.779,77 ",2814778031,CFD," 0,00 "
25/09/2024 06:11:51,Open Position,NSDQ100/USD," 949,99 ",0.955734," 0,00 "," 6.029,73 "," 2.829,78 ",2814799062,CFD," 0,00 "
25/09/2024 06:12:43,Open Position,NSDQ100/USD," 709,99 ",0.714422," 0,00 "," 6.029,73 "," 2.119,79 ",2814799207,CFD," 0,00 "
25/09/2024 06:29:49,Open Position,NSDQ100/USD," 499,99 ",0.503618," 0,00 "," 6.029,73 "," 1.619,80 ",2814801486,CFD," 0,00 "
25/09/2024 06:32:14,Open Position,NSDQ100/USD," 300,00 ",0.302171," 0,00 "," 6.029,73 "," 1.319,80 ",2814801886,CFD," 0,00 "
25/09/2024 07:07:26,Open Position,NSDQ100/USD," 399,99 ",0.402609," 0,00 "," 6.029,73 "," 919,81 ",2814827968,CFD," 0,00 "
25/09/2024 07:40:27,Position closed,NSDQ100/USD," 956,41 ",0.955734," 6,42 "," 6.036,15 "," 1.876,22 ",2814799062,CFD," 0,00 "
25/09/2024 07:42:16,Open Position,NSDQ100/USD," 469,99 ",0.472542," 0,00 "," 6.036,15 "," 1.406,23 ",2814856616,CFD," 0,00 "
25/09/2024 07:43:46,Position closed,NSDQ100/USD," 720,08 ",0.714422," 10,09 "," 6.046,24 "," 2.126,31 ",2814799207,CFD," 0,00 "
25/09/2024 07:44:27,Open Position,NSDQ100/USD," 540,00 ",0.542932," 0,00 "," 6.046,24 "," 1.586,31 ",2814856960,CFD," 0,00 "
25/09/2024 07:54:44,Open Position,NSDQ100/USD," 350,00 ",0.351981," 0,00 "," 6.046,24 "," 1.236,31 ",2814867121,CFD," 0,00 "
25/09/2024 08:57:32,Open Position,NSDQ100/USD," 399,99 ",0.402621," 0,00 "," 6.046,24 "," 836,32 ",2814883557,CFD," 0,00 "
25/09/2024 10:03:07,Position closed,NSDQ100/USD," 1.000,41 ",1.005005," 0,42 "," 6.046,66 "," 1.836,73 ",2814778031,CFD," 0,00 "
25/09/2024 10:04:23,Position closed,NSDQ100/USD," 413,24 ",0.402621," 13,25 "," 6.059,91 "," 2.249,97 ",2814883557,CFD," 0,00 "
25/09/2024 10:05:15,Position closed,NSDQ100/USD," 521,66 ",0.503618," 21,67 "," 6.081,58 "," 2.771,63 ",2814801486,CFD," 0,00 "
25/09/2024 10:07:02,Position closed,NSDQ100/USD," 546,15 ",0.542932," 6,15 "," 6.087,73 "," 3.317,78 ",2814856960,CFD," 0,00 "
25/09/2024 10:11:09,Open Position,NSDQ100/USD," 500,00 ",0.502287," 0,00 "," 6.087,73 "," 2.817,78 ",2814913467,CFD," 0,00 "
25/09/2024 10:11:18,Open Position,NSDQ100/USD," 250,00 ",0.251140," 0,00 "," 6.087,73 "," 2.567,78 ",2814913483,CFD," 0,00 "
25/09/2024 10:50:22,Open Position,NSDQ100/USD," 350,00 ",0.351780," 0,00 "," 6.087,73 "," 2.217,78 ",2814925256,CFD," 0,00 "
25/09/2024 11:59:57,Position closed,NSDQ100/USD," 488,47 ",0.501494,"(11,52)"," 6.076,21 "," 2.706,25 ",2814771388,CFD," 0,00 "
25/09/2024 11:59:57,Position closed,NSDQ100/USD," 340,18 ",0.350958,"(9,82)"," 6.066,39 "," 3.046,43 ",2814771339,CFD," 0,00 "
25/09/2024 11:59:57,Position closed,NSDQ100/USD," 380,56 ",0.400673,"(19,42)"," 6.046,97 "," 3.426,99 ",2814763962,CFD," 0,00 "
25/09/2024 11:59:57,Position closed,NSDQ100/USD," 318,47 ",0.302171," 18,47 "," 6.065,44 "," 3.745,46 ",2814801886,CFD," 0,00 "
25/09/2024 11:59:57,Position closed,NSDQ100/USD," 360,64 ",0.351981," 10,64 "," 6.076,08 "," 4.106,10 ",2814867121,CFD," 0,00 "
25/09/2024 11:59:57,Position closed,NSDQ100/USD," 481,95 ",0.472542," 11,96 "," 6.088,04 "," 4.588,05 ",2814856616,CFD," 0,00 "
25/09/2024 11:59:57,Position closed,NSDQ100/USD," 504,43 ",0.502287," 4,43 "," 6.092,47 "," 5.092,48 ",2814913467,CFD," 0,00 "
25/09/2024 11:59:57,Position closed,NSDQ100/USD," 419,04 ",0.402609," 19,05 "," 6.111,52 "," 5.511,52 ",2814827968,CFD," 0,00 "
25/09/2024 11:59:57,Position closed,NSDQ100/USD," 356,66 ",0.351780," 6,66 "," 6.118,18 "," 5.868,18 ",2814925256,CFD," 0,00 "
25/09/2024 11:59:57,Position closed,NSDQ100/USD," 252,14 ",0.251140," 2,14 "," 6.120,32 "," 6.120,32 ",2814913483,CFD," 0,00 "
25/09/2024 12:00:32,Open Position,NSDQ100/USD," 399,99 ",0.401592," 0,00 "," 6.120,32 "," 5.720,33 ",2814946514,CFD," 0,00 "
25/09/2024 12:00:41,Open Position,NSDQ100/USD," 350,00 ",0.351379," 0,00 "," 6.120,32 "," 5.370,33 ",2814946627,CFD," 0,00 "
25/09/2024 12:00:51,Open Position,NSDQ100/USD," 350,00 ",0.351391," 0,00 "," 6.120,32 "," 5.020,33 ",2814952271,CFD," 0,00 "
25/09/2024 12:14:27,Open Position,NSDQ100/USD," 350,00 ",0.351546," 0,00 "," 6.120,32 "," 4.670,33 ",2814956319,CFD," 0,00 "
25/09/2024 12:22:25,Open Position,NSDQ100/USD," 250,00 ",0.250978," 0,00 "," 6.120,32 "," 4.420,33 ",2814959726,CFD," 0,00 "
25/09/2024 12:42:08,Open Position,NSDQ100/USD," 300,00 ",0.301020," 0,00 "," 6.120,32 "," 4.120,33 ",2814965609,CFD," 0,00 "
25/09/2024 12:43:39,Position closed,NSDQ100/USD," 353,65 ",0.351379," 3,65 "," 6.123,97 "," 4.473,98 ",2814946627,CFD," 0,00 "
25/09/2024 12:43:39,Position closed,NSDQ100/USD," 353,90 ",0.351391," 3,90 "," 6.127,87 "," 4.827,88 ",2814952271,CFD," 0,00 "
25/09/2024 12:43:39,Position closed,NSDQ100/USD," 404,49 ",0.401592," 4,50 "," 6.132,37 "," 5.232,37 ",2814946514,CFD," 0,00 "
25/09/2024 12:43:39,Position closed,NSDQ100/USD," 357,00 ",0.351546," 7,00 "," 6.139,37 "," 5.589,37 ",2814956319,CFD," 0,00 "
25/09/2024 12:43:39,Position closed,NSDQ100/USD," 299,91 ",0.301020,"(0,09)"," 6.139,28 "," 5.889,28 ",2814965609,CFD," 0,00 "
25/09/2024 12:43:39,Position closed,NSDQ100/USD," 252,48 ",0.250978," 2,48 "," 6.141,76 "," 6.141,76 ",2814959726,CFD," 0,00 "
25/09/2024 12:44:04,Open Position,NSDQ100/USD," 499,99 ",0.501620," 0,00 "," 6.141,76 "," 5.641,77 ",2814965891,CFD," 0,00 "
25/09/2024 13:23:11,Open Position,NSDQ100/USD," 600,00 ",0.602337," 0,00 "," 6.141,76 "," 5.041,77 ",2814974814,CFD," 0,00 "
25/09/2024 13:40:01,Position closed,NSDQ100/USD," 625,81 ",0.602337," 25,81 "," 6.167,57 "," 5.667,58 ",2814974814,CFD," 0,00 "
25/09/2024 13:40:01,Position closed,NSDQ100/USD," 514,97 ",0.501620," 14,98 "," 6.182,55 "," 6.182,55 ",2814965891,CFD," 0,00 "
25/09/2024 13:42:20,Open Position,NSDQ100/USD," 299,99 ",0.301016," 0,00 "," 6.182,55 "," 5.882,56 ",2815073023,CFD," 0,00 "
25/09/2024 13:42:34,Open Position,NSDQ100/USD," 350,00 ",0.351194," 0,00 "," 6.182,55 "," 5.532,56 ",2815073452,CFD," 0,00 "
25/09/2024 13:43:41,Open Position,NSDQ100/USD," 200,00 ",0.200689," 0,00 "," 6.182,55 "," 5.332,56 ",2815074711,CFD," 0,00 "
25/09/2024 13:44:56,Open Position,NSDQ100/USD," 299,99 ",0.300636," 0,00 "," 6.182,55 "," 5.032,57 ",2815076263,CFD," 0,00 "
25/09/2024 13:45:23,Position closed,NSDQ100/USD," 299,06 ",0.300636,"(0,93)"," 6.181,62 "," 5.331,63 ",2815076263,CFD," 0,00 "
25/09/2024 13:45:23,Position closed,NSDQ100/USD," 357,94 ",0.351194," 7,94 "," 6.189,56 "," 5.689,57 ",2815073452,CFD," 0,00 "
25/09/2024 13:45:23,Position closed,NSDQ100/USD," 306,64 ",0.301016," 6,65 "," 6.196,21 "," 5.996,21 ",2815073023,CFD," 0,00 "
25/09/2024 13:45:23,Position closed,NSDQ100/USD," 204,68 ",0.200689," 4,68 "," 6.200,89 "," 6.200,89 ",2815074711,CFD," 0,00 "
25/09/2024 13:45:57,Open Position,NSDQ100/USD," 400,00 ",0.400788," 0,00 "," 6.200,89 "," 5.800,89 ",2815078409,CFD," 0,00 "
25/09/2024 13:46:08,Open Position,NSDQ100/USD," 400,00 ",0.400670," 0,00 "," 6.200,89 "," 5.400,89 ",2815078590,CFD," 0,00 "
25/09/2024 13:47:12,Open Position,NSDQ100/USD," 400,00 ",0.400625," 0,00 "," 6.200,89 "," 5.000,89 ",2815080118,CFD," 0,00 "
25/09/2024 13:48:01,Position closed,NSDQ100/USD," 402,01 ",0.400788," 2,01 "," 6.202,90 "," 5.402,90 ",2815078409,CFD," 0,00 "
25/09/2024 13:48:33,Open Position,NSDQ100/USD," 299,99 ",0.300541," 0,00 "," 6.202,90 "," 5.102,91 ",2815081646,CFD," 0,00 "
25/09/2024 13:49:39,Position closed,NSDQ100/USD," 403,25 ",0.400670," 3,25 "," 6.206,15 "," 5.506,16 ",2815078590,CFD," 0,00 "
25/09/2024 13:49:39,Position closed,NSDQ100/USD," 402,36 ",0.400625," 2,36 "," 6.208,51 "," 5.908,52 ",2815080118,CFD," 0,00 "
25/09/2024 13:49:39,Position closed,NSDQ100/USD," 303,21 ",0.300541," 3,22 "," 6.211,73 "," 6.211,73 ",2815081646,CFD," 0,00 "
25/09/2024 13:50:17,Open Position,NSDQ100/USD," 350,00 ",0.350426," 0,00 "," 6.211,73 "," 5.861,73 ",2815084163,CFD," 0,00 "
25/09/2024 13:50:51,Open Position,NSDQ100/USD," 299,99 ",0.300458," 0,00 "," 6.211,73 "," 5.561,74 ",2815084940,CFD," 0,00 "
25/09/2024 14:09:15,Position closed,NSDQ100/USD," 366,82 ",0.350426," 16,82 "," 6.228,55 "," 5.928,56 ",2815084163,CFD," 0,00 "
25/09/2024 14:09:15,Position closed,NSDQ100/USD," 316,33 ",0.300458," 16,34 "," 6.244,89 "," 6.244,89 ",2815084940,CFD," 0,00 "
25/09/2024 14:09:36,Open Position,NSDQ100/USD," 299,99 ",0.299594," 0,00 "," 6.244,89 "," 5.944,90 ",2815196884,CFD," 0,00 "
25/09/2024 14:10:01,Position closed,NSDQ100/USD," 299,54 ",0.299594,"(0,45)"," 6.244,44 "," 6.244,44 ",2815196884,CFD," 0,00 "
25/09/2024 14:19:01,Open Position,NSDQ100/USD," 299,99 ",0.299334," 0,00 "," 6.244,44 "," 5.944,45 ",2815225147,CFD," 0,00 "
25/09/2024 14:47:16,Open Position,NSDQ100/USD," 149,99 ",0.149882," 0,00 "," 6.244,44 "," 5.794,46 ",2815263625,CFD," 0,00 "
25/09/2024 15:12:36,Open Position,NSDQ100/USD," 249,99 ",0.249966," 0,00 "," 6.244,44 "," 5.544,47 ",2815360974,CFD," 0,00 "
25/09/2024 15:13:50,Open Position,NSDQ100/USD," 149,99 ",0.149950," 0,00 "," 6.244,44 "," 5.394,48 ",2815362244,CFD," 0,00 "
25/09/2024 15:17:22,Open Position,NSDQ100/USD," 350,00 ",0.350119," 0,00 "," 6.244,44 "," 5.044,48 ",2815399266,CFD," 0,00 "
25/09/2024 15:18:34,Position closed,NSDQ100/USD," 353,08 ",0.350119," 3,08 "," 6.247,52 "," 5.397,56 ",2815399266,CFD," 0,00 "
25/09/2024 15:19:07,Position closed,NSDQ100/USD," 250,26 ",0.249966," 0,27 "," 6.247,79 "," 5.647,82 ",2815360974,CFD," 0,00 "
25/09/2024 15:19:41,Open Position,NSDQ100/USD," 299,99 ",0.299903," 0,00 "," 6.247,79 "," 5.347,83 ",2815402276,CFD," 0,00 "
25/09/2024 15:25:07,Open Position,NSDQ100/USD," 299,99 ",0.300132," 0,00 "," 6.247,79 "," 5.047,84 ",2815408354,CFD," 0,00 "
25/09/2024 15:29:31,Open Position,NSDQ100/USD," 299,99 ",0.300200," 0,00 "," 6.247,79 "," 4.747,85 ",2815415217,CFD," 0,00 "
25/09/2024 15:37:17,Position closed,NSDQ100/USD," 304,58 ",0.300200," 4,59 "," 6.252,38 "," 5.052,43 ",2815415217,CFD," 0,00 "
25/09/2024 15:37:21,Position closed,NSDQ100/USD," 302,78 ",0.300132," 2,79 "," 6.255,17 "," 5.355,21 ",2815408354,CFD," 0,00 "
25/09/2024 15:37:30,Position closed,NSDQ100/USD," 149,24 ",0.149950,"(0,75)"," 6.254,42 "," 5.504,45 ",2815362244,CFD," 0,00 "
25/09/2024 15:38:40,Position closed,NSDQ100/USD," 301,79 ",0.299903," 1,80 "," 6.256,22 "," 5.806,24 ",2815402276,CFD," 0,00 "
25/09/2024 15:38:58,Position closed,NSDQ100/USD," 149,99 ",0.149882," 0,00 "," 6.256,22 "," 5.956,23 ",2815263625,CFD," 0,00 "
25/09/2024 15:41:08,Open Position,NSDQ100/USD," 350,00 ",0.349708," 0,00 "," 6.256,22 "," 5.606,23 ",2815426235,CFD," 0,00 "
25/09/2024 15:43:48,Open Position,NSDQ100/USD," 299,99 ",0.300005," 0,00 "," 6.256,22 "," 5.306,24 ",2815427999,CFD," 0,00 "
25/09/2024 15:48:36,Open Position,NSDQ100/USD," 299,99 ",0.300260," 0,00 "," 6.256,22 "," 5.006,25 ",2815431663,CFD," 0,00 "
25/09/2024 15:52:30,Open Position,NSDQ100/USD," 249,99 ",0.250379," 0,00 "," 6.256,22 "," 4.756,26 ",2815434866,CFD," 0,00 "
25/09/2024 15:52:43,Open Position,NSDQ100/USD," 250,00 ",0.250420," 0,00 "," 6.256,22 "," 4.506,26 ",2815435114,CFD," 0,00 "
25/09/2024 15:58:32,Position closed,NSDQ100/USD," 251,93 ",0.250420," 1,93 "," 6.258,15 "," 4.758,19 ",2815435114,CFD," 0,00 "
25/09/2024 15:58:54,Position closed,NSDQ100/USD," 251,37 ",0.250379," 1,38 "," 6.259,53 "," 5.009,56 ",2815434866,CFD," 0,00 "
25/09/2024 16:00:22,Position closed,NSDQ100/USD," 298,46 ",0.300260,"(1,53)"," 6.258,00 "," 5.308,02 ",2815431663,CFD," 0,00 "
25/09/2024 16:04:25,Open Position,BABA/USD," 99,99 ",5.227211," 0,00 "," 6.258,00 "," 5.208,03 ",2815443404,CFD," 0,00 "
25/09/2024 16:43:45,Open Position,NSDQ100/USD," 250,00 ",0.250272," 0,00 "," 6.258,00 "," 4.958,03 ",2815477570,CFD," 0,00 "
25/09/2024 17:13:20,Open Position,NSDQ100/USD," 200,00 ",0.200513," 0,00 "," 6.258,00 "," 4.758,03 ",2815497337,CFD," 0,00 "
25/09/2024 17:13:33,Open Position,NSDQ100/USD," 299,99 ",0.300770," 0,00 "," 6.258,00 "," 4.458,04 ",2815497419,CFD," 0,00 "
25/09/2024 17:28:20,Position closed,NSDQ100/USD," 302,25 ",0.300770," 2,26 "," 6.260,26 "," 4.760,29 ",2815497419,CFD," 0,00 "
25/09/2024 17:28:28,Position closed,NSDQ100/USD," 201,45 ",0.200513," 1,45 "," 6.261,71 "," 4.961,74 ",2815497337,CFD," 0,00 "
25/09/2024 17:44:24,Open Position,NSDQ100/USD," 499,99 ",0.501327," 0,00 "," 6.261,71 "," 4.461,75 ",2815514957,CFD," 0,00 "
25/09/2024 17:44:40,Open Position,NSDQ100/USD," 299,99 ",0.300790," 0,00 "," 6.261,71 "," 4.161,76 ",2815515095,CFD," 0,00 "
25/09/2024 17:50:19,Open Position,NSDQ100/USD," 349,98 ",0.351191," 0,00 "," 6.261,71 "," 3.811,78 ",2815518339,CFD," 0,00 "
25/09/2024 17:50:47,Open Position,NSDQ100/USD," 200,00 ",0.200647," 0,00 "," 6.261,71 "," 3.611,78 ",2815518602,CFD," 0,00 "
25/09/2024 17:55:20,Position closed,NSDQ100/USD," 205,82 ",0.200647," 5,82 "," 6.267,53 "," 3.817,60 ",2815518602,CFD," 0,00 "
25/09/2024 17:55:29,Position closed,NSDQ100/USD," 506,96 ",0.501327," 6,97 "," 6.274,50 "," 4.324,56 ",2815514957,CFD," 0,00 "
25/09/2024 17:55:37,Position closed,NSDQ100/USD," 359,99 ",0.351191," 10,01 "," 6.284,51 "," 4.684,55 ",2815518339,CFD," 0,00 "
25/09/2024 17:55:54,Position closed,NSDQ100/USD," 305,14 ",0.300790," 5,15 "," 6.289,66 "," 4.989,69 ",2815515095,CFD," 0,00 "
25/09/2024 18:01:52,Open Position,NSDQ100/USD," 350,00 ",0.350421," 0,00 "," 6.289,66 "," 4.639,69 ",2815579176,CFD," 0,00 "
25/09/2024 18:17:14,Open Position,NSDQ100/USD," 400,00 ",0.400999," 0,00 "," 6.289,66 "," 4.239,69 ",2815588913,CFD," 0,00 "
25/09/2024 18:22:25,Open Position,NSDQ100/USD," 200,00 ",0.200434," 0,00 "," 6.289,66 "," 4.039,69 ",2815590859,CFD," 0,00 "
25/09/2024 18:30:54,Position closed,NSDQ100/USD," 408,42 ",0.400999," 8,42 "," 6.298,08 "," 4.448,11 ",2815588913,CFD," 0,00 "
25/09/2024 18:31:04,Position closed,NSDQ100/USD," 348,56 ",0.350421,"(1,44)"," 6.296,64 "," 4.796,67 ",2815579176,CFD," 0,00 "
25/09/2024 18:31:12,Position closed,NSDQ100/USD," 247,80 ",0.250272,"(2,20)"," 6.294,44 "," 5.044,47 ",2815477570,CFD," 0,00 "
25/09/2024 18:31:19,Position closed,NSDQ100/USD," 202,05 ",0.200434," 2,05 "," 6.296,49 "," 5.246,52 ",2815590859,CFD," 0,00 "
25/09/2024 19:03:29,Open Position,NSDQ100/USD," 149,99 ",0.150199," 0,00 "," 6.296,49 "," 5.096,53 ",2815609082,CFD," 0,00 "
25/09/2024 20:06:49,Position closed,NSDQ100/USD," 154,31 ",0.150199," 4,32 "," 6.300,81 "," 5.250,84 ",2815609082,CFD," 0,00 "
25/09/2024 20:06:58,Position closed,NSDQ100/USD," 300,61 ",0.300005," 0,62 "," 6.301,43 "," 5.551,45 ",2815427999,CFD," 0,00 "
25/09/2024 20:09:31,Position closed,NSDQ100/USD," 346,38 ",0.349708,"(3,62)"," 6.297,81 "," 5.897,83 ",2815426235,CFD," 0,00 "
25/09/2024 20:13:51,Open Position,NSDQ100/USD," 400,00 ",0.399802," 0,00 "," 6.297,81 "," 5.497,83 ",2815683748,CFD," 0,00 "
25/09/2024 20:15:32,Open Position,NSDQ100/USD," 400,00 ",0.399766," 0,00 "," 6.297,81 "," 5.097,83 ",2815683888,CFD," 0,00 "
25/09/2024 20:17:23,Open Position,NSDQ100/USD," 500,00 ",0.499667," 0,00 "," 6.297,81 "," 4.597,83 ",2815684108,CFD," 0,00 "
25/09/2024 20:17:49,Position closed,NSDQ100/USD," 290,63 ",0.299334,"(9,36)"," 6.288,45 "," 4.888,46 ",2815225147,CFD," 0,00 "
25/09/2024 20:19:16,Open Position,NSDQ100/USD," 349,99 ",0.349749," 0,00 "," 6.288,45 "," 4.538,47 ",2815684234,CFD," 0,00 "
25/09/2024 20:39:47,Open Position,NSDQ100/USD," 349,99 ",0.349769," 0,00 "," 6.288,45 "," 4.188,48 ",2815685513,CFD," 0,00 "
25/09/2024 20:57:22,Open Position,NSDQ100/USD," 700,00 ",0.699328," 0,00 "," 6.288,45 "," 3.488,48 ",2815686610,CFD," 0,00 "
26/09/2024 00:48:24,Overnight fee,Daily,"(0,01)",-,"(0,01)"," 6.288,44 "," 3.488,47 ",2815684234,CFD," 0,00 "
26/09/2024 00:48:24,Overnight fee,Daily,"(0,01)",-,"(0,01)"," 6.288,43 "," 3.488,46 ",2815684108,CFD," 0,00 "
26/09/2024 00:48:24,Overnight fee,Daily,"(0,01)",-,"(0,01)"," 6.288,42 "," 3.488,45 ",2815683748,CFD," 0,00 "
26/09/2024 00:48:24,Overnight fee,Daily,"(0,01)",-,"(0,01)"," 6.288,41 "," 3.488,44 ",2815685513,CFD," 0,00 "
26/09/2024 00:48:24,Overnight fee,Daily,"(0,01)",-,"(0,01)"," 6.288,40 "," 3.488,43 ",2815683888,CFD," 0,00 "
26/09/2024 00:48:24,Overnight fee,Daily,"(0,02)",-,"(0,02)"," 6.288,38 "," 3.488,41 ",2815686610,CFD," 0,00 "
26/09/2024 00:48:24,Overnight fee,Daily,"(0,15)",-,"(0,15)"," 6.288,23 "," 3.488,26 ",2815443404,CFD," 0,00 "
26/09/2024 06:43:36,Open Position,NSDQ100/USD," 349,99 ",0.346186," 0,00 "," 6.288,23 "," 3.138,27 ",2815730678,CFD," 0,00 "
26/09/2024 06:47:51,Position closed,NSDQ100/USD," 551,11 ",0.699328,"(148,89)"," 6.139,34 "," 3.689,38 ",2815686610,CFD," 0,00 "
26/09/2024 06:48:06,Open Position,NSDQ100/USD," 699,99 ",0.691996," 0,00 "," 6.139,34 "," 2.989,39 ",2815731486,CFD," 0,00 "
26/09/2024 06:53:22,Position closed,NSDQ100/USD," 388,76 ",0.499667,"(111,24)"," 6.028,10 "," 3.378,15 ",2815684108,CFD," 0,00 "
26/09/2024 06:53:30,Position closed,NSDQ100/USD," 309,08 ",0.399802,"(90,92)"," 5.937,18 "," 3.687,23 ",2815683748,CFD," 0,00 "
26/09/2024 06:53:40,Position closed,NSDQ100/USD," 309,92 ",0.399766,"(90,08)"," 5.847,10 "," 3.997,15 ",2815683888,CFD," 0,00 "
26/09/2024 06:55:36,Position closed,NSDQ100/USD," 270,83 ",0.349749,"(79,16)"," 5.767,94 "," 4.267,98 ",2815684234,CFD," 0,00 "
26/09/2024 06:55:42,Position closed,NSDQ100/USD," 270,83 ",0.349769,"(79,16)"," 5.688,78 "," 4.538,81 ",2815685513,CFD," 0,00 "
26/09/2024 06:56:12,Open Position,NSDQ100/USD," 350,00 ",0.345784," 0,00 "," 5.688,78 "," 4.188,81 ",2815732722,CFD," 0,00 "
26/09/2024 06:56:28,Position closed,NSDQ100/USD," 705,85 ",0.691996," 5,86 "," 5.694,64 "," 4.894,66 ",2815731486,CFD," 0,00 "
26/09/2024 06:56:35,Position closed,NSDQ100/USD," 356,56 ",0.346186," 6,57 "," 5.701,21 "," 5.251,22 ",2815730678,CFD," 0,00 "
26/09/2024 07:00:16,Open Position,NSDQ100/USD," 349,99 ",0.345746," 0,00 "," 5.701,21 "," 4.901,23 ",2815743788,CFD," 0,00 "
26/09/2024 07:10:48,Open Position,NSDQ100/USD," 399,99 ",0.395268," 0,00 "," 5.701,21 "," 4.501,24 ",2815761519,CFD," 0,00 "
26/09/2024 07:11:58,Open Position,NSDQ100/USD," 350,00 ",0.345964," 0,00 "," 5.701,21 "," 4.151,24 ",2815761961,CFD," 0,00 "
26/09/2024 07:16:34,Position closed,NSDQ100/USD," 401,16 ",0.395268," 1,17 "," 5.702,38 "," 4.552,40 ",2815761519,CFD," 0,00 "
26/09/2024 07:16:34,Position closed,NSDQ100/USD," 348,73 ",0.345746,"(1,26)"," 5.701,12 "," 4.901,13 ",2815743788,CFD," 0,00 "
26/09/2024 07:16:34,Position closed,NSDQ100/USD," 353,14 ",0.345964," 3,14 "," 5.704,26 "," 5.254,27 ",2815761961,CFD," 0,00 "
26/09/2024 07:16:34,Position closed,NSDQ100/USD," 349,50 ",0.345784,"(0,50)"," 5.703,76 "," 5.603,77 ",2815732722,CFD," 0,00 "
26/09/2024 07:17:01,Open Position,NSDQ100/USD," 350,00 ",0.345736," 0,00 "," 5.703,76 "," 5.253,77 ",2815764821,CFD," 0,00 "
26/09/2024 07:17:45,Open Position,NSDQ100/USD," 350,00 ",0.345753," 0,00 "," 5.703,76 "," 4.903,77 ",2815765003,CFD," 0,00 "
26/09/2024 07:31:25,Open Position,NSDQ100/USD," 300,00 ",0.296467," 0,00 "," 5.703,76 "," 4.603,77 ",2815788963,CFD," 0,00 "
26/09/2024 07:33:25,Position closed,NSDQ100/USD," 301,50 ",0.296467," 1,50 "," 5.705,26 "," 4.905,27 ",2815788963,CFD," 0,00 "
26/09/2024 07:33:39,Position closed,NSDQ100/USD," 350,16 ",0.345736," 0,16 "," 5.705,42 "," 5.255,43 ",2815764821,CFD," 0,00 "
26/09/2024 07:34:33,Position closed,NSDQ100/USD," 353,03 ",0.345753," 3,03 "," 5.708,45 "," 5.608,46 ",2815765003,CFD," 0,00 "
26/09/2024 07:34:59,Open Position,NSDQ100/USD," 299,97 ",0.296231," 0,00 "," 5.708,45 "," 5.308,49 ",2815790796,CFD," 0,00 "
26/09/2024 07:35:13,Open Position,NSDQ100/USD," 300,00 ",0.296306," 0,00 "," 5.708,45 "," 5.008,49 ",2815790846,CFD," 0,00 "
26/09/2024 07:36:26,Position closed,NSDQ100/USD," 301,11 ",0.296306," 1,11 "," 5.709,56 "," 5.309,60 ",2815790846,CFD," 0,00 "
26/09/2024 07:37:24,Position closed,NSDQ100/USD," 300,55 ",0.296231," 0,58 "," 5.710,14 "," 5.610,15 ",2815790796,CFD," 0,00 "
26/09/2024 07:37:39,Open Position,NSDQ100/USD," 349,99 ",0.345531," 0,00 "," 5.710,14 "," 5.260,16 ",2815791487,CFD," 0,00 "
26/09/2024 07:38:01,Open Position,NSDQ100/USD," 250,00 ",0.246765," 0,00 "," 5.710,14 "," 5.010,16 ",2815791604,CFD," 0,00 "
26/09/2024 07:39:27,Open Position,NSDQ100/USD," 300,00 ",0.296101," 0,00 "," 5.710,14 "," 4.710,16 ",2815792921,CFD," 0,00 "
26/09/2024 07:41:59,Position closed,NSDQ100/USD," 352,19 ",0.345531," 2,20 "," 5.712,34 "," 5.062,35 ",2815791487,CFD," 0,00 "
26/09/2024 07:41:59,Position closed,NSDQ100/USD," 300,49 ",0.296101," 0,49 "," 5.712,83 "," 5.362,84 ",2815792921,CFD," 0,00 "
26/09/2024 07:41:59,Position closed,NSDQ100/USD," 250,71 ",0.246765," 0,71 "," 5.713,54 "," 5.613,55 ",2815791604,CFD," 0,00 "
26/09/2024 07:42:26,Open Position,NSDQ100/USD," 300,00 ",0.296019," 0,00 "," 5.713,54 "," 5.313,55 ",2815794168,CFD," 0,00 "
26/09/2024 07:44:36,Open Position,NSDQ100/USD," 300,00 ",0.295983," 0,00 "," 5.713,54 "," 5.013,55 ",2815797264,CFD," 0,00 "
26/09/2024 07:46:21,Open Position,NSDQ100/USD," 250,00 ",0.246662," 0,00 "," 5.713,54 "," 4.763,55 ",2815797912,CFD," 0,00 "
26/09/2024 07:50:00,Open Position,NSDQ100/USD," 300,00 ",0.295991," 0,00 "," 5.713,54 "," 4.463,55 ",2815798958,CFD," 0,00 "
26/09/2024 07:55:17,Open Position,NSDQ100/USD," 300,00 ",0.295977," 0,00 "," 5.713,54 "," 4.163,55 ",2815801894,CFD," 0,00 "
26/09/2024 07:55:53,Open Position,NSDQ100/USD," 199,99 ",0.197334," 0,00 "," 5.713,54 "," 3.963,56 ",2815802207,CFD," 0,00 "
26/09/2024 08:01:02,Open Position,NSDQ100/USD," 399,99 ",0.394895," 0,00 "," 5.713,54 "," 3.563,57 ",2815803962,CFD," 0,00 "
26/09/2024 08:12:09,Open Position,NSDQ100/USD," 250,00 ",0.246821," 0,00 "," 5.713,54 "," 3.313,57 ",2815808655,CFD," 0,00 "
26/09/2024 09:00:56,Open Position,NSDQ100/USD," 500,00 ",0.493951," 0,00 "," 5.713,54 "," 2.813,57 ",2815826689,CFD," 0,00 "
26/09/2024 09:17:57,Open Position,NSDQ100/USD," 250,00 ",0.247048," 0,00 "," 5.713,54 "," 2.563,57 ",2815831726,CFD," 0,00 "
26/09/2024 09:26:51,Position closed,NSDQ100/USD," 252,49 ",0.247048," 2,49 "," 5.716,03 "," 2.816,06 ",2815831726,CFD," 0,00 "
26/09/2024 09:39:21,Position closed,NSDQ100/USD," 501,91 ",0.493951," 1,91 "," 5.717,94 "," 3.317,97 ",2815826689,CFD," 0,00 "
26/09/2024 09:44:27,Open Position,NSDQ100/USD," 300,00 ",0.296298," 0,00 "," 5.717,94 "," 3.017,97 ",2815838553,CFD," 0,00 "
26/09/2024 09:46:53,Position closed,NSDQ100/USD," 300,73 ",0.296298," 0,73 "," 5.718,67 "," 3.318,70 ",2815838553,CFD," 0,00 "
26/09/2024 09:48:53,Open Position,NSDQ100/USD," 399,99 ",0.395043," 0,00 "," 5.718,67 "," 2.918,71 ",2815839952,CFD," 0,00 "
26/09/2024 09:57:34,Open Position,NSDQ100/USD," 399,99 ",0.395055," 0,00 "," 5.718,67 "," 2.518,72 ",2815841795,CFD," 0,00 "
26/09/2024 10:08:31,Open Position,NSDQ100/USD," 250,00 ",0.246997," 0,00 "," 5.718,67 "," 2.268,72 ",2815843971,CFD," 0,00 "
26/09/2024 10:28:29,Position closed,NSDQ100/USD," 252,53 ",0.246997," 2,53 "," 5.721,20 "," 2.521,25 ",2815843971,CFD," 0,00 "
26/09/2024 10:29:02,Position closed,NSDQ100/USD," 400,80 ",0.395055," 0,81 "," 5.722,01 "," 2.922,05 ",2815841795,CFD," 0,00 "
26/09/2024 10:29:08,Position closed,NSDQ100/USD," 400,37 ",0.395043," 0,38 "," 5.722,39 "," 3.322,42 ",2815839952,CFD," 0,00 "
26/09/2024 10:32:35,Open Position,NSDQ100/USD," 400,00 ",0.394995," 0,00 "," 5.722,39 "," 2.922,42 ",2815850802,CFD," 0,00 "
26/09/2024 10:34:48,Open Position,NSDQ100/USD," 350,00 ",0.345571," 0,00 "," 5.722,39 "," 2.572,42 ",2815851355,CFD," 0,00 "
26/09/2024 10:35:12,Position closed,NSDQ100/USD," 399,75 ",0.394995,"(0,25)"," 5.722,14 "," 2.972,17 ",2815850802,CFD," 0,00 "
26/09/2024 10:43:38,Position closed,NSDQ100/USD," 351,96 ",0.345571," 1,96 "," 5.724,10 "," 3.324,13 ",2815851355,CFD," 0,00 "
26/09/2024 10:44:24,Position closed,NSDQ100/USD," 401,71 ",0.394895," 1,72 "," 5.725,82 "," 3.725,84 ",2815803962,CFD," 0,00 "
26/09/2024 10:45:14,Position closed,NSDQ100/USD," 252,16 ",0.246821," 2,16 "," 5.727,98 "," 3.978,00 ",2815808655,CFD," 0,00 "
26/09/2024 10:45:20,Position closed,NSDQ100/USD," 299,13 ",0.296019,"(0,87)"," 5.727,11 "," 4.277,13 ",2815794168,CFD," 0,00 "
26/09/2024 10:50:29,Position closed,NSDQ100/USD," 199,03 ",0.197334,"(0,96)"," 5.726,15 "," 4.476,16 ",2815802207,CFD," 0,00 "
26/09/2024 10:56:25,Open Position,NSDQ100/USD," 300,00 ",0.296070," 0,00 "," 5.726,15 "," 4.176,16 ",2815858079,CFD," 0,00 "
26/09/2024 10:59:55,Position closed,NSDQ100/USD," 300,73 ",0.295983," 0,73 "," 5.726,88 "," 4.476,89 ",2815797264,CFD," 0,00 "
26/09/2024 10:59:55,Position closed,NSDQ100/USD," 250,75 ",0.246662," 0,75 "," 5.727,63 "," 4.727,64 ",2815797912,CFD," 0,00 "
26/09/2024 10:59:55,Position closed,NSDQ100/USD," 300,61 ",0.295977," 0,61 "," 5.728,24 "," 5.028,25 ",2815801894,CFD," 0,00 "
26/09/2024 10:59:55,Position closed,NSDQ100/USD," 300,91 ",0.295991," 0,91 "," 5.729,15 "," 5.329,16 ",2815798958,CFD," 0,00 "
26/09/2024 10:59:55,Position closed,NSDQ100/USD," 302,50 ",0.296070," 2,50 "," 5.731,65 "," 5.631,66 ",2815858079,CFD," 0,00 "
26/09/2024 11:00:13,Open Position,NSDQ100/USD," 350,00 ",0.345298," 0,00 "," 5.731,65 "," 5.281,66 ",2815859071,CFD," 0,00 "
26/09/2024 11:00:42,Open Position,NSDQ100/USD," 300,00 ",0.296089," 0,00 "," 5.731,65 "," 4.981,66 ",2815859222,CFD," 0,00 "
26/09/2024 11:01:10,Open Position,NSDQ100/USD," 300,00 ",0.296135," 0,00 "," 5.731,65 "," 4.681,66 ",2815859352,CFD," 0,00 "
26/09/2024 11:02:35,Open Position,NSDQ100/USD," 300,00 ",0.296145," 0,00 "," 5.731,65 "," 4.381,66 ",2815859843,CFD," 0,00 "
26/09/2024 11:03:18,Open Position,NSDQ100/USD," 300,00 ",0.296142," 0,00 "," 5.731,65 "," 4.081,66 ",2815859992,CFD," 0,00 "
26/09/2024 11:15:01,Open Position,NSDQ100/USD," 300,00 ",0.296130," 0,00 "," 5.731,65 "," 3.781,66 ",2815864973,CFD," 0,00 "
26/09/2024 11:26:38,Position closed,NSDQ100/USD," 302,12 ",0.296145," 2,12 "," 5.733,77 "," 4.083,78 ",2815859843,CFD," 0,00 "
26/09/2024 11:26:38,Position closed,NSDQ100/USD," 300,94 ",0.296089," 0,94 "," 5.734,71 "," 4.384,72 ",2815859222,CFD," 0,00 "
26/09/2024 11:26:38,Position closed,NSDQ100/USD," 301,91 ",0.296135," 1,91 "," 5.736,62 "," 4.686,63 ",2815859352,CFD," 0,00 "
26/09/2024 11:26:38,Position closed,NSDQ100/USD," 348,33 ",0.345298,"(1,67)"," 5.734,95 "," 5.034,96 ",2815859071,CFD," 0,00 "
26/09/2024 11:26:38,Position closed,NSDQ100/USD," 301,82 ",0.296130," 1,82 "," 5.736,77 "," 5.336,78 ",2815864973,CFD," 0,00 "
26/09/2024 11:26:38,Position closed,NSDQ100/USD," 302,06 ",0.296142," 2,06 "," 5.738,83 "," 5.638,84 ",2815859992,CFD," 0,00 "
26/09/2024 11:27:21,Open Position,NSDQ100/USD," 349,99 ",0.345306," 0,00 "," 5.738,83 "," 5.288,85 ",2815869071,CFD," 0,00 "
26/09/2024 11:28:44,Open Position,NSDQ100/USD," 400,00 ",0.394670," 0,00 "," 5.738,83 "," 4.888,85 ",2815869537,CFD," 0,00 "
26/09/2024 11:31:04,Position closed,NSDQ100/USD," 352,12 ",0.345306," 2,13 "," 5.740,96 "," 5.240,97 ",2815869071,CFD," 0,00 "
26/09/2024 11:31:38,Open Position,NSDQ100/USD," 349,99 ",0.345151," 0,00 "," 5.740,96 "," 4.890,98 ",2815870143,CFD," 0,00 "
26/09/2024 11:33:03,Position closed,NSDQ100/USD," 394,70 ",0.394670,"(5,30)"," 5.735,66 "," 5.285,68 ",2815869537,CFD," 0,00 "
26/09/2024 11:34:21,Open Position,NSDQ100/USD," 250,00 ",0.246617," 0,00 "," 5.735,66 "," 5.035,68 ",2815870807,CFD," 0,00 "
26/09/2024 11:35:35,Open Position,NSDQ100/USD," 349,99 ",0.345307," 0,00 "," 5.735,66 "," 4.685,69 ",2815871009,CFD," 0,00 "
26/09/2024 11:46:59,Position closed,NSDQ100/USD," 350,80 ",0.345307," 0,81 "," 5.736,47 "," 5.036,49 ",2815871009,CFD," 0,00 "
26/09/2024 11:47:40,Open Position,NSDQ100/USD," 399,99 ",0.394708," 0,00 "," 5.736,47 "," 4.636,50 ",2815875411,CFD," 0,00 "
26/09/2024 12:06:35,Open Position,NSDQ100/USD," 350,00 ",0.345673," 0,00 "," 5.736,47 "," 4.286,50 ",2815880486,CFD," 0,00 "
26/09/2024 12:07:44,Open Position,NSDQ100/USD," 399,99 ",0.395119," 0,00 "," 5.736,47 "," 3.886,51 ",2815881131,CFD," 0,00 "
26/09/2024 12:09:13,Open Position,NSDQ100/USD," 399,99 ",0.395133," 0,00 "," 5.736,47 "," 3.486,52 ",2815881584,CFD," 0,00 "
26/09/2024 12:18:16,Position closed,NSDQ100/USD," 404,79 ",0.395133," 4,80 "," 5.741,27 "," 3.891,31 ",2815881584,CFD," 0,00 "
26/09/2024 12:18:37,Position closed,NSDQ100/USD," 405,11 ",0.395119," 5,12 "," 5.746,39 "," 4.296,42 ",2815881131,CFD," 0,00 "
26/09/2024 12:19:04,Position closed,NSDQ100/USD," 353,30 ",0.345673," 3,30 "," 5.749,69 "," 4.649,72 ",2815880486,CFD," 0,00 "
26/09/2024 12:20:01,Open Position,NSDQ100/USD," 399,99 ",0.394827," 0,00 "," 5.749,69 "," 4.249,73 ",2815885978,CFD," 0,00 "
26/09/2024 12:28:22,Position closed,NSDQ100/USD," 405,90 ",0.394827," 5,91 "," 5.755,60 "," 4.655,63 ",2815885978,CFD," 0,00 "
26/09/2024 12:28:27,Position closed,NSDQ100/USD," 403,05 ",0.394708," 3,06 "," 5.758,66 "," 5.058,68 ",2815875411,CFD," 0,00 "
26/09/2024 12:28:32,Position closed,NSDQ100/USD," 250,36 ",0.246617," 0,36 "," 5.759,02 "," 5.309,04 ",2815870807,CFD," 0,00 "
26/09/2024 12:29:48,Open Position,NSDQ100/USD," 300,00 ",0.295929," 0,00 "," 5.759,02 "," 5.009,04 ",2815893594,CFD," 0,00 "
26/09/2024 12:30:47,Open Position,NSDQ100/USD," 399,99 ",0.394652," 0,00 "," 5.759,02 "," 4.609,05 ",2815894037,CFD," 0,00 "
26/09/2024 12:32:32,Open Position,NSDQ100/USD," 399,99 ",0.394739," 0,00 "," 5.759,02 "," 4.209,06 ",2815896756,CFD," 0,00 "
26/09/2024 12:33:12,Position closed,NSDQ100/USD," 401,67 ",0.394739," 1,68 "," 5.760,70 "," 4.610,73 ",2815896756,CFD," 0,00 "
26/09/2024 12:33:34,Position closed,NSDQ100/USD," 350,18 ",0.345151," 0,19 "," 5.760,89 "," 4.960,91 ",2815870143,CFD," 0,00 "
26/09/2024 12:33:38,Position closed,NSDQ100/USD," 403,45 ",0.394652," 3,46 "," 5.764,35 "," 5.364,36 ",2815894037,CFD," 0,00 "
26/09/2024 12:33:45,Position closed,NSDQ100/USD," 301,29 ",0.295929," 1,29 "," 5.765,64 "," 5.665,65 ",2815893594,CFD," 0,00 "
26/09/2024 12:34:13,Open Position,NSDQ100/USD," 149,99 ",0.147924," 0,00 "," 5.765,64 "," 5.515,66 ",2815897411,CFD," 0,00 "
26/09/2024 12:34:27,Open Position,NSDQ100/USD," 199,99 ",0.197303," 0,00 "," 5.765,64 "," 5.315,67 ",2815897510,CFD," 0,00 "
26/09/2024 12:34:56,Open Position,NSDQ100/USD," 250,00 ",0.246595," 0,00 "," 5.765,64 "," 5.065,67 ",2815897700,CFD," 0,00 "
26/09/2024 12:36:39,Open Position,NSDQ100/USD," 300,00 ",0.295867," 0,00 "," 5.765,64 "," 4.765,67 ",2815898319,CFD," 0,00 "
26/09/2024 12:37:09,Position closed,NSDQ100/USD," 201,03 ",0.197303," 1,04 "," 5.766,68 "," 4.966,70 ",2815897510,CFD," 0,00 "
26/09/2024 12:38:25,Open Position,NSDQ100/USD," 299,99 ",0.296063," 0,00 "," 5.766,68 "," 4.666,71 ",2815898900,CFD," 0,00 "
26/09/2024 12:38:59,Open Position,NSDQ100/USD," 449,99 ",0.444104," 0,00 "," 5.766,68 "," 4.216,72 ",2815899066,CFD," 0,00 "
26/09/2024 12:39:37,Open Position,NSDQ100/USD," 300,00 ",0.296021," 0,00 "," 5.766,68 "," 3.916,72 ",2815899255,CFD," 0,00 "
26/09/2024 12:42:14,Position closed,NSDQ100/USD," 453,21 ",0.444104," 3,22 "," 5.769,90 "," 4.369,93 ",2815899066,CFD," 0,00 "
26/09/2024 12:42:32,Position closed,NSDQ100/USD," 302,76 ",0.296063," 2,77 "," 5.772,67 "," 4.672,69 ",2815898900,CFD," 0,00 "
26/09/2024 12:43:07,Position closed,NSDQ100/USD," 302,80 ",0.296021," 2,80 "," 5.775,47 "," 4.975,49 ",2815899255,CFD," 0,00 "
26/09/2024 12:43:23,Position closed,NSDQ100/USD," 300,82 ",0.295867," 0,82 "," 5.776,29 "," 5.276,31 ",2815898319,CFD," 0,00 "
26/09/2024 12:43:27,Position closed,NSDQ100/USD," 149,95 ",0.147924,"(0,04)"," 5.776,25 "," 5.426,26 ",2815897411,CFD," 0,00 "
26/09/2024 12:43:32,Position closed,NSDQ100/USD," 251,10 ",0.246595," 1,10 "," 5.777,35 "," 5.677,36 ",2815897700,CFD," 0,00 "
26/09/2024 12:44:02,Open Position,NSDQ100/USD," 199,99 ",0.197201," 0,00 "," 5.777,35 "," 5.477,37 ",2815900675,CFD," 0,00 "
26/09/2024 12:45:28,Open Position,NSDQ100/USD," 300,00 ",0.295902," 0,00 "," 5.777,35 "," 5.177,37 ",2815901076,CFD," 0,00 "
26/09/2024 12:45:43,Open Position,NSDQ100/USD," 300,00 ",0.295945," 0,00 "," 5.777,35 "," 4.877,37 ",2815901130,CFD," 0,00 "
26/09/2024 12:46:20,Open Position,NSDQ100/USD," 300,00 ",0.295895," 0,00 "," 5.777,35 "," 4.577,37 ",2815901293,CFD," 0,00 "
26/09/2024 12:47:31,Position closed,NSDQ100/USD," 301,17 ",0.295945," 1,17 "," 5.778,52 "," 4.878,54 ",2815901130,CFD," 0,00 "
26/09/2024 12:48:00,Open Position,NSDQ100/USD," 299,99 ",0.295892," 0,00 "," 5.778,52 "," 4.578,55 ",2815901859,CFD," 0,00 "
26/09/2024 12:48:35,Open Position,NSDQ100/USD," 300,00 ",0.295930," 0,00 "," 5.778,52 "," 4.278,55 ",2815902071,CFD," 0,00 "
26/09/2024 12:49:24,Position closed,NSDQ100/USD," 300,67 ",0.295930," 0,67 "," 5.779,19 "," 4.579,22 ",2815902071,CFD," 0,00 "
26/09/2024 12:51:38,Position closed,NSDQ100/USD," 200,22 ",0.197201," 0,23 "," 5.779,42 "," 4.779,44 ",2815900675,CFD," 0,00 "
26/09/2024 12:51:53,Position closed,NSDQ100/USD," 302,52 ",0.295892," 2,53 "," 5.781,95 "," 5.081,96 ",2815901859,CFD," 0,00 "
26/09/2024 12:52:08,Position closed,NSDQ100/USD," 303,21 ",0.295895," 3,21 "," 5.785,16 "," 5.385,17 ",2815901293,CFD," 0,00 "
26/09/2024 12:52:18,Position closed,NSDQ100/USD," 303,12 ",0.295902," 3,12 "," 5.788,28 "," 5.688,29 ",2815901076,CFD," 0,00 "
26/09/2024 12:52:41,Open Position,NSDQ100/USD," 300,00 ",0.295639," 0,00 "," 5.788,28 "," 5.388,29 ",2815903352,CFD," 0,00 "
26/09/2024 12:55:19,Open Position,NSDQ100/USD," 300,00 ",0.295623," 0,00 "," 5.788,28 "," 5.088,29 ",2815904385,CFD," 0,00 "
26/09/2024 13:10:58,Position closed,NSDQ100/USD," 304,30 ",0.295639," 4,30 "," 5.792,58 "," 5.392,59 ",2815903352,CFD," 0,00 "
26/09/2024 13:10:58,Position closed,NSDQ100/USD," 303,98 ",0.295623," 3,98 "," 5.796,56 "," 5.696,57 ",2815904385,CFD," 0,00 "
26/09/2024 13:11:22,Open Position,NSDQ100/USD," 300,00 ",0.295385," 0,00 "," 5.796,56 "," 5.396,57 ",2815911969,CFD," 0,00 "
26/09/2024 13:11:31,Open Position,NSDQ100/USD," 300,00 ",0.295340," 0,00 "," 5.796,56 "," 5.096,57 ",2815912022,CFD," 0,00 "
26/09/2024 13:13:04,Open Position,NSDQ100/USD," 300,00 ",0.295326," 0,00 "," 5.796,56 "," 4.796,57 ",2815912828,CFD," 0,00 "
26/09/2024 13:26:23,Open Position,NSDQ100/USD," 350,00 ",0.345024," 0,00 "," 5.796,56 "," 4.446,57 ",2815918408,CFD," 0,00 "
26/09/2024 13:27:17,Open Position,NSDQ100/USD," 229,99 ",0.226685," 0,00 "," 5.796,56 "," 4.216,58 ",2815918855,CFD," 0,00 "
26/09/2024 13:27:29,Open Position,NSDQ100/USD," 250,00 ",0.246396," 0,00 "," 5.796,56 "," 3.966,58 ",2815918943,CFD," 0,00 "
26/09/2024 13:27:50,Position closed,NSDQ100/USD," 350,47 ",0.345024," 0,47 "," 5.797,03 "," 4.317,05 ",2815918408,CFD," 0,00 "
26/09/2024 13:28:26,Open Position,NSDQ100/USD," 300,00 ",0.295755," 0,00 "," 5.797,03 "," 4.017,05 ",2815919706,CFD," 0,00 "
26/09/2024 13:29:15,Open Position,NSDQ100/USD," 250,00 ",0.246516," 0,00 "," 5.797,03 "," 3.767,05 ",2815920081,CFD," 0,00 "
26/09/2024 13:32:18,Open Position,NSDQ100/USD," 949,99 ",0.938476," 0,00 "," 5.797,03 "," 2.817,06 ",2816008530,CFD," 0,00 "
26/09/2024 13:33:04,Open Position,NSDQ100/USD," 710,00 ",0.701523," 0,00 "," 5.797,03 "," 2.107,06 ",2816012051,CFD," 0,00 "
26/09/2024 13:34:21,Position closed,BABA/USD," 139,83 ",5.227211," 39,84 "," 5.836,87 "," 2.246,89 ",2815443404,CFD," 0,00 "
26/09/2024 13:35:09,Open Position,NSDQ100/USD," 570,00 ",0.563581," 0,00 "," 5.836,87 "," 1.676,89 ",2816019269,CFD," 0,00 "
26/09/2024 13:35:53,Open Position,NSDQ100/USD," 299,99 ",0.296820," 0,00 "," 5.836,87 "," 1.376,90 ",2816021247,CFD," 0,00 "
26/09/2024 13:38:06,Position closed,NSDQ100/USD," 570,15 ",0.563581," 0,15 "," 5.837,02 "," 1.947,05 ",2816019269,CFD," 0,00 "
26/09/2024 13:38:40,Position closed,NSDQ100/USD," 303,69 ",0.296820," 3,70 "," 5.840,72 "," 2.250,74 ",2816021247,CFD," 0,00 "
26/09/2024 13:39:05,Open Position,NSDQ100/USD," 299,99 ",0.296459," 0,00 "," 5.840,72 "," 1.950,75 ",2816050000,CFD," 0,00 "
26/09/2024 13:40:13,Open Position,NSDQ100/USD," 299,99 ",0.296801," 0,00 "," 5.840,72 "," 1.650,76 ",2816073480,CFD," 0,00 "
26/09/2024 13:40:33,Open Position,NSDQ100/USD," 149,99 ",0.148487," 0,00 "," 5.840,72 "," 1.500,77 ",2816075010,CFD," 0,00 "
26/09/2024 13:42:11,Position closed,NSDQ100/USD," 150,85 ",0.148487," 0,86 "," 5.841,58 "," 1.651,62 ",2816075010,CFD," 0,00 "
26/09/2024 13:44:29,Position closed,NSDQ100/USD," 297,78 ",0.296801,"(2,21)"," 5.839,37 "," 1.949,40 ",2816073480,CFD," 0,00 "
26/09/2024 13:45:32,Open Position,NSDQ100/USD," 299,99 ",0.296983," 0,00 "," 5.839,37 "," 1.649,41 ",2816087308,CFD," 0,00 "
26/09/2024 13:47:47,Position closed,NSDQ100/USD," 302,51 ",0.296983," 2,52 "," 5.841,89 "," 1.951,92 ",2816087308,CFD," 0,00 "
26/09/2024 13:48:32,Open Position,NSDQ100/USD," 299,98 ",0.297176," 0,00 "," 5.841,89 "," 1.651,94 ",2816093437,CFD," 0,00 "
26/09/2024 13:49:59,Open Position,NSDQ100/USD," 420,00 ",0.415741," 0,00 "," 5.841,89 "," 1.231,94 ",2816097119,CFD," 0,00 "
26/09/2024 13:52:25,Position closed,NSDQ100/USD," 301,13 ",0.297176," 1,15 "," 5.843,04 "," 1.533,07 ",2816093437,CFD," 0,00 "
26/09/2024 13:53:13,Position closed,NSDQ100/USD," 419,99 ",0.415741,"(0,01)"," 5.843,03 "," 1.953,06 ",2816097119,CFD," 0,00 "
26/09/2024 13:55:15,Open Position,NSDQ100/USD," 350,00 ",0.346519," 0,00 "," 5.843,03 "," 1.603,06 ",2816163022,CFD," 0,00 "
26/09/2024 13:55:27,Open Position,NSDQ100/USD," 200,00 ",0.198040," 0,00 "," 5.843,03 "," 1.403,06 ",2816163879,CFD," 0,00 "
26/09/2024 13:59:09,Position closed,NSDQ100/USD," 201,32 ",0.198040," 1,32 "," 5.844,35 "," 1.604,38 ",2816163879,CFD," 0,00 "
26/09/2024 14:00:25,Position closed,NSDQ100/USD," 353,28 ",0.346519," 3,28 "," 5.847,63 "," 1.957,66 ",2816163022,CFD," 0,00 "
26/09/2024 14:00:37,Open Position,NSDQ100/USD," 489,99 ",0.485132," 0,00 "," 5.847,63 "," 1.467,67 ",2816177487,CFD," 0,00 "
26/09/2024 14:01:18,Open Position,NSDQ100/USD," 299,99 ",0.297012," 0,00 "," 5.847,63 "," 1.167,68 ",2816178832,CFD," 0,00 "
26/09/2024 14:01:35,Position closed,NSDQ100/USD," 491,67 ",0.485132," 1,68 "," 5.849,31 "," 1.659,35 ",2816177487,CFD," 0,00 "
26/09/2024 14:01:53,Open Position,NSDQ100/USD," 299,99 ",0.297068," 0,00 "," 5.849,31 "," 1.359,36 ",2816179658,CFD," 0,00 "
26/09/2024 14:03:32,Open Position,NSDQ100/USD," 250,00 ",0.247532," 0,00 "," 5.849,31 "," 1.109,36 ",2816182255,CFD," 0,00 "
26/09/2024 14:09:39,Open Position,NSDQ100/USD," 249,98 ",0.247724," 0,00 "," 5.849,31 "," 859,38 ",2816192597,CFD," 0,00 "
26/09/2024 14:11:11,Position closed,NSDQ100/USD," 251,58 ",0.247724," 1,60 "," 5.850,91 "," 1.110,96 ",2816192597,CFD," 0,00 "
26/09/2024 14:14:52,Open Position,NSDQ100/USD," 299,99 ",0.297371," 0,00 "," 5.850,91 "," 810,97 ",2816203416,CFD," 0,00 "
26/09/2024 14:16:20,Position closed,NSDQ100/USD," 301,56 ",0.297371," 1,57 "," 5.852,48 "," 1.112,53 ",2816203416,CFD," 0,00 "
26/09/2024 14:17:21,Open Position,NSDQ100/USD," 279,99 ",0.277597," 0,00 "," 5.852,48 "," 832,54 ",2816207009,CFD," 0,00 "
26/09/2024 14:18:14,Position closed,NSDQ100/USD," 281,45 ",0.277597," 1,46 "," 5.853,94 "," 1.113,99 ",2816207009,CFD," 0,00 "
26/09/2024 14:19:50,Open Position,NSDQ100/USD," 279,99 ",0.277538," 0,00 "," 5.853,94 "," 834,00 ",2816209614,CFD," 0,00 "
26/09/2024 14:21:57,Open Position,NSDQ100/USD," 210,00 ",0.208263," 0,00 "," 5.853,94 "," 624,00 ",2816213031,CFD," 0,00 "
26/09/2024 14:26:55,Open Position,NSDQ100/USD," 299,99 ",0.297786," 0,00 "," 5.853,94 "," 324,01 ",2816222306,CFD," 0,00 "
26/09/2024 14:32:41,Open Position,NSDQ100/USD," 149,99 ",0.149205," 0,00 "," 5.853,94 "," 174,02 ",2816232303,CFD," 0,00 "
26/09/2024 14:36:05,Position closed,NSDQ100/USD," 151,29 ",0.149205," 1,30 "," 5.855,24 "," 325,31 ",2816232303,CFD," 0,00 "
26/09/2024 15:06:42,Open Position,NSDQ100/USD," 250,00 ",0.249499," 0,00 "," 5.855,24 "," 75,31 ",2816286631,CFD," 0,00 "
26/09/2024 15:07:28,Position closed,NSDQ100/USD," 253,27 ",0.249499," 3,27 "," 5.858,51 "," 328,58 ",2816286631,CFD," 0,00 "
26/09/2024 15:23:05,Open Position,NSDQ100/USD," 200,00 ",0.199721," 0,00 "," 5.858,51 "," 128,58 ",2816305050,CFD," 0,00 "
26/09/2024 15:30:40,Position closed,NSDQ100/USD," 196,29 ",0.199721,"(3,71)"," 5.854,80 "," 324,87 ",2816305050,CFD," 0,00 "
26/09/2024 15:34:13,Open Position,NSDQ100/USD," 149,99 ",0.149883," 0,00 "," 5.854,80 "," 174,88 ",2816315818,CFD," 0,00 "
26/09/2024 15:38:54,Position closed,NSDQ100/USD," 151,88 ",0.149883," 1,89 "," 5.856,69 "," 326,76 ",2816315818,CFD," 0,00 "
26/09/2024 16:07:11,Position closed,NSDQ100/USD," 273,48 ",0.297786,"(26,51)"," 5.830,18 "," 600,24 ",2816222306,CFD," 0,00 "
26/09/2024 16:19:31,Open Position,NSDQ100/USD," 159,99 ",0.159607," 0,00 "," 5.830,18 "," 440,25 ",2816377209,CFD," 0,00 "
26/09/2024 16:35:40,Open Position,NSDQ100/USD," 200,00 ",0.199684," 0,00 "," 5.830,18 "," 240,25 ",2816389364,CFD," 0,00 "
26/09/2024 16:42:28,Deposit,4000.00 USDRON CreditCard," 872,44 ",-," 872,44 "," 6.702,62 "," 1.112,69 ",-,-," 0,00 "
26/09/2024 16:42:28,Deposit Conversion Fee,-,"(26,47)",-," 0,00 "," 6.702,62 "," 1.112,69 ",-,-," 0,00 "
26/09/2024 16:44:46,Position closed,NSDQ100/USD," 200,42 ",0.199684," 0,42 "," 6.703,04 "," 1.313,11 ",2816389364,CFD," 0,00 "
26/09/2024 16:52:57,Open Position,NSDQ100/USD," 250,00 ",0.249531," 0,00 "," 6.703,04 "," 1.063,11 ",2816401658,CFD," 0,00 "
26/09/2024 17:00:35,Open Position,NSDQ100/USD," 269,99 ",0.269691," 0,00 "," 6.703,04 "," 793,12 ",2816406939,CFD," 0,00 "
26/09/2024 17:10:59,Position closed,NSDQ100/USD," 268,94 ",0.269691,"(1,05)"," 6.701,99 "," 1.062,06 ",2816406939,CFD," 0,00 "
26/09/2024 17:13:42,Open Position,NSDQ100/USD," 299,99 ",0.299735," 0,00 "," 6.701,99 "," 762,07 ",2816417452,CFD," 0,00 "
26/09/2024 17:25:04,Open Position,NSDQ100/USD," 350,00 ",0.350198," 0,00 "," 6.701,99 "," 412,07 ",2816426851,CFD," 0,00 "
26/09/2024 17:31:10,Position closed,NSDQ100/USD," 303,74 ",0.299735," 3,75 "," 6.705,74 "," 715,81 ",2816417452,CFD," 0,00 "
26/09/2024 17:31:17,Position closed,NSDQ100/USD," 364,15 ",0.350198," 14,15 "," 6.719,89 "," 1.079,96 ",2816426851,CFD," 0,00 "
26/09/2024 17:31:30,Position closed,NSDQ100/USD," 248,25 ",0.249531,"(1,75)"," 6.718,14 "," 1.328,21 ",2816401658,CFD," 0,00 "
26/09/2024 17:32:46,Position closed,NSDQ100/USD," 158,07 ",0.159607,"(1,92)"," 6.716,22 "," 1.486,28 ",2816377209,CFD," 0,00 "
26/09/2024 17:46:42,Open Position,NSDQ100/USD," 200,00 ",0.199452," 0,00 "," 6.716,22 "," 1.286,28 ",2816445507,CFD," 0,00 "
26/09/2024 17:48:29,Position closed,NSDQ100/USD," 223,47 ",0.295385,"(76,53)"," 6.639,69 "," 1.509,75 ",2815911969,CFD," 0,00 "
26/09/2024 17:48:44,Open Position,NSDQ100/USD," 250,00 ",0.249326," 0,00 "," 6.639,69 "," 1.259,75 ",2816447038,CFD," 0,00 "
26/09/2024 18:08:58,Position closed,NSDQ100/USD," 251,97 ",0.249326," 1,97 "," 6.641,66 "," 1.511,72 ",2816447038,CFD," 0,00 "
26/09/2024 18:17:37,Position closed,NSDQ100/USD," 211,90 ",0.199452," 11,90 "," 6.653,56 "," 1.723,62 ",2816445507,CFD," 0,00 "
26/09/2024 18:18:19,Position closed,NSDQ100/USD," 196,52 ",0.208263,"(13,48)"," 6.640,08 "," 1.920,14 ",2816213031,CFD," 0,00 "
26/09/2024 18:21:58,Position closed,NSDQ100/USD," 236,39 ",0.295326,"(63,61)"," 6.576,47 "," 2.156,53 ",2815912828,CFD," 0,00 "
26/09/2024 18:40:09,Open Position,NSDQ100/USD," 299,99 ",0.298362," 0,00 "," 6.576,47 "," 1.856,54 ",2816487015,CFD," 0,00 "
26/09/2024 19:01:43,Open Position,NSDQ100/USD," 200,00 ",0.198983," 0,00 "," 6.576,47 "," 1.656,54 ",2816507336,CFD," 0,00 "
26/09/2024 19:10:27,Position closed,NSDQ100/USD," 300,31 ",0.298362," 0,32 "," 6.576,79 "," 1.956,85 ",2816487015,CFD," 0,00 "
26/09/2024 19:10:36,Position closed,NSDQ100/USD," 202,18 ",0.198983," 2,18 "," 6.578,97 "," 2.159,03 ",2816507336,CFD," 0,00 "
26/09/2024 19:27:26,Open Position,NSDQ100/USD," 307,99 ",0.305953," 0,00 "," 6.578,97 "," 1.851,04 ",2816523599,CFD," 0,00 "
26/09/2024 22:06:27,Open Position,NSDQ100/USD," 469,99 ",0.466897," 0,00 "," 6.578,97 "," 1.381,05 ",2816583994,CFD," 0,00 "
26/09/2024 22:06:39,Open Position,NSDQ100/USD," 399,99 ",0.397357," 0,00 "," 6.578,97 "," 981,06 ",2816584004,CFD," 0,00 "
26/09/2024 23:24:51,Position closed,NSDQ100/USD," 401,02 ",0.397357," 1,03 "," 6.580,00 "," 1.382,08 ",2816584004,CFD," 0,00 "
26/09/2024 23:24:58,Position closed,NSDQ100/USD," 471,10 ",0.466897," 1,11 "," 6.581,11 "," 1.853,18 ",2816583994,CFD," 0,00 "
26/09/2024 23:25:05,Position closed,NSDQ100/USD," 308,31 ",0.305953," 0,32 "," 6.581,43 "," 2.161,49 ",2816523599,CFD," 0,00 "
26/09/2024 23:25:24,Position closed,NSDQ100/USD," 268,03 ",0.277538,"(11,96)"," 6.569,47 "," 2.429,52 ",2816209614,CFD," 0,00 "
27/09/2024 00:32:34,Index price adjustment,NSDQ100/USD," 0,12 ",-," 0,12 "," 6.569,59 "," 2.429,64 ",2815912022,CFD," 0,00 "
27/09/2024 00:32:34,Index price adjustment,NSDQ100/USD," 0,09 ",-," 0,09 "," 6.569,68 "," 2.429,73 ",2815918855,CFD," 0,00 "
27/09/2024 00:32:34,Index price adjustment,NSDQ100/USD," 0,10 ",-," 0,10 "," 6.569,78 "," 2.429,83 ",2815918943,CFD," 0,00 "
27/09/2024 00:32:34,Index price adjustment,NSDQ100/USD," 0,12 ",-," 0,12 "," 6.569,90 "," 2.429,95 ",2815919706,CFD," 0,00 "
27/09/2024 00:32:34,Index price adjustment,NSDQ100/USD," 0,10 ",-," 0,10 "," 6.570,00 "," 2.430,05 ",2815920081,CFD," 0,00 "
27/09/2024 00:32:34,Index price adjustment,NSDQ100/USD," 0,39 ",-," 0,39 "," 6.570,39 "," 2.430,44 ",2816008530,CFD," 0,00 "
27/09/2024 00:32:34,Index price adjustment,NSDQ100/USD," 0,29 ",-," 0,29 "," 6.570,68 "," 2.430,73 ",2816012051,CFD," 0,00 "
27/09/2024 00:32:34,Index price adjustment,NSDQ100/USD," 0,12 ",-," 0,12 "," 6.570,80 "," 2.430,85 ",2816050000,CFD," 0,00 "
27/09/2024 00:32:34,Index price adjustment,NSDQ100/USD," 0,12 ",-," 0,12 "," 6.570,92 "," 2.430,97 ",2816178832,CFD," 0,00 "
27/09/2024 00:32:34,Index price adjustment,NSDQ100/USD," 0,12 ",-," 0,12 "," 6.571,04 "," 2.431,09 ",2816179658,CFD," 0,00 "
27/09/2024 00:32:34,Index price adjustment,NSDQ100/USD," 0,10 ",-," 0,10 "," 6.571,14 "," 2.431,19 ",2816182255,CFD," 0,00 "
27/09/2024 00:32:34,Index price adjustment,NSDQ100/USD," 0,11 ",-," 0,11 "," 6.571,25 "," 2.431,30 ",2816209614,CFD," 0,00 "
27/09/2024 00:32:34,Index price adjustment,NSDQ100/USD," 0,13 ",-," 0,13 "," 6.571,38 "," 2.431,43 ",2816523599,CFD," 0,00 "
27/09/2024 00:48:15,Overnight fee,Daily,"(1,15)",-,"(1,15)"," 6.570,23 "," 2.430,28 ",2815918855,CFD," 0,00 "
27/09/2024 00:48:15,Overnight fee,Daily,"(1,25)",-,"(1,25)"," 6.568,98 "," 2.429,03 ",2815918943,CFD," 0,00 "
27/09/2024 00:48:15,Overnight fee,Daily,"(1,25)",-,"(1,25)"," 6.567,73 "," 2.427,78 ",2815920081,CFD," 0,00 "
27/09/2024 00:48:15,Overnight fee,Daily,"(1,26)",-,"(1,26)"," 6.566,47 "," 2.426,52 ",2816182255,CFD," 0,00 "
27/09/2024 00:48:15,Overnight fee,Daily,"(1,41)",-,"(1,41)"," 6.565,06 "," 2.425,11 ",2816209614,CFD," 0,00 "
27/09/2024 00:48:15,Overnight fee,Daily,"(1,50)",-,"(1,50)"," 6.563,56 "," 2.423,61 ",2815919706,CFD," 0,00 "
27/09/2024 00:48:15,Overnight fee,Daily,"(1,50)",-,"(1,50)"," 6.562,06 "," 2.422,11 ",2816050000,CFD," 0,00 "
27/09/2024 00:48:15,Overnight fee,Daily,"(1,50)",-,"(1,50)"," 6.560,56 "," 2.420,61 ",2815912022,CFD," 0,00 "
27/09/2024 00:48:15,Overnight fee,Daily,"(1,51)",-,"(1,51)"," 6.559,05 "," 2.419,10 ",2816178832,CFD," 0,00 "
27/09/2024 00:48:15,Overnight fee,Daily,"(1,51)",-,"(1,51)"," 6.557,54 "," 2.417,59 ",2816179658,CFD," 0,00 "
27/09/2024 00:48:15,Overnight fee,Daily,"(1,55)",-,"(1,55)"," 6.555,99 "," 2.416,04 ",2816523599,CFD," 0,00 "
27/09/2024 00:48:15,Overnight fee,Daily,"(3,56)",-,"(3,56)"," 6.552,43 "," 2.412,48 ",2816012051,CFD," 0,00 "
27/09/2024 00:48:15,Overnight fee,Daily,"(4,76)",-,"(4,76)"," 6.547,67 "," 2.407,72 ",2816008530,CFD," 0,00 "
27/09/2024 02:01:32,Open Position,NSDQ100/USD," 499,99 ",0.498132," 0,00 "," 6.547,67 "," 1.907,73 ",2816600281,CFD," 0,00 "
27/09/2024 06:28:30,Open Position,NSDQ100/USD," 399,99 ",0.398994," 0,00 "," 6.547,67 "," 1.507,74 ",2816631031,CFD," 0,00 "
27/09/2024 06:28:30,Open Position,NSDQ100/USD," 609,99 ",0.608466," 0,00 "," 6.547,67 "," 897,75 ",2816631032,CFD," 0,00 "
27/09/2024 07:01:04,Position closed,NSDQ100/USD," 613,15 ",0.608466," 3,16 "," 6.550,83 "," 1.510,90 ",2816631032,CFD," 0,00 "
27/09/2024 07:03:12,Position closed,NSDQ100/USD," 405,65 ",0.398994," 5,66 "," 6.556,49 "," 1.916,55 ",2816631031,CFD," 0,00 "
27/09/2024 07:03:32,Position closed,NSDQ100/USD," 494,41 ",0.498132,"(5,58)"," 6.550,91 "," 2.410,96 ",2816600281,CFD," 0,00 "
27/09/2024 07:05:02,Open Position,NSDQ100/USD," 350,00 ",0.348685," 0,00 "," 6.550,91 "," 2.060,96 ",2816694416,CFD," 0,00 "
27/09/2024 07:08:28,Position closed,NSDQ100/USD," 351,53 ",0.348685," 1,53 "," 6.552,44 "," 2.412,49 ",2816694416,CFD," 0,00 "
27/09/2024 07:16:08,Position closed,NSDQ100/USD," 229,14 ",0.295340,"(70,86)"," 6.481,58 "," 2.641,63 ",2815912022,CFD," 0,00 "
27/09/2024 07:16:21,Position closed,NSDQ100/USD," 180,50 ",0.226685,"(49,49)"," 6.432,09 "," 2.822,13 ",2815918855,CFD," 0,00 "
27/09/2024 07:16:41,Position closed,NSDQ100/USD," 196,72 ",0.246396,"(53,28)"," 6.378,81 "," 3.018,85 ",2815918943,CFD," 0,00 "
27/09/2024 07:17:54,Open Position,NSDQ100/USD," 349,99 ",0.348669," 0,00 "," 6.378,81 "," 2.668,86 ",2816698918,CFD," 0,00 "
27/09/2024 07:20:41,Open Position,NSDQ100/USD," 499,99 ",0.498132," 0,00 "," 6.378,81 "," 2.168,87 ",2816709798,CFD," 0,00 "
27/09/2024 07:21:27,Open Position,NSDQ100/USD," 399,99 ",0.398751," 0,00 "," 6.378,81 "," 1.768,88 ",2816712363,CFD," 0,00 "
27/09/2024 07:27:03,Position closed,NSDQ100/USD," 401,86 ",0.398751," 1,87 "," 6.380,68 "," 2.170,74 ",2816712363,CFD," 0,00 "
27/09/2024 07:28:15,Open Position,NSDQ100/USD," 350,00 ",0.348815," 0,00 "," 6.380,68 "," 1.820,74 ",2816717263,CFD," 0,00 "
27/09/2024 07:30:42,Open Position,NSDQ100/USD," 300,00 ",0.299033," 0,00 "," 6.380,68 "," 1.520,74 ",2816718159,CFD," 0,00 "
27/09/2024 07:42:30,Open Position,NSDQ100/USD," 300,00 ",0.299309," 0,00 "," 6.380,68 "," 1.220,74 ",2816723148,CFD," 0,00 "
27/09/2024 07:54:12,Open Position,NSDQ100/USD," 249,99 ",0.249589," 0,00 "," 6.380,68 "," 970,75 ",2816730887,CFD," 0,00 "
27/09/2024 08:03:10,Position closed,NSDQ100/USD," 252,61 ",0.249589," 2,62 "," 6.383,30 "," 1.223,36 ",2816730887,CFD," 0,00 "
27/09/2024 08:03:59,Open Position,NSDQ100/USD," 310,00 ",0.309290," 0,00 "," 6.383,30 "," 913,36 ",2816753173,CFD," 0,00 "
27/09/2024 08:19:36,Position closed,NSDQ100/USD," 314,02 ",0.309290," 4,02 "," 6.387,32 "," 1.227,38 ",2816753173,CFD," 0,00 "
27/09/2024 08:20:30,Position closed,NSDQ100/USD," 300,00 ",0.299033," 0,00 "," 6.387,32 "," 1.527,38 ",2816718159,CFD," 0,00 "
27/09/2024 08:23:58,Position closed,NSDQ100/USD," 311,28 ",0.299309," 11,28 "," 6.398,60 "," 1.838,66 ",2816723148,CFD," 0,00 "
27/09/2024 08:24:29,Position closed,NSDQ100/USD," 356,13 ",0.348815," 6,13 "," 6.404,73 "," 2.194,79 ",2816717263,CFD," 0,00 "
27/09/2024 08:24:50,Position closed,NSDQ100/USD," 353,40 ",0.348669," 3,41 "," 6.408,14 "," 2.548,19 ",2816698918,CFD," 0,00 "
27/09/2024 08:25:04,Position closed,NSDQ100/USD," 503,62 ",0.498132," 3,63 "," 6.411,77 "," 3.051,81 ",2816709798,CFD," 0,00 "
27/09/2024 08:37:27,Open Position,NSDQ100/USD," 300,00 ",0.298605," 0,00 "," 6.411,77 "," 2.751,81 ",2816764265,CFD," 0,00 "
27/09/2024 08:42:26,Position closed,NSDQ100/USD," 238,39 ",0.295755,"(61,61)"," 6.350,16 "," 2.990,20 ",2815919706,CFD," 0,00 "
27/09/2024 08:55:29,Open Position,NSDQ100/USD," 300,00 ",0.298914," 0,00 "," 6.350,16 "," 2.690,20 ",2816769819,CFD," 0,00 "
27/09/2024 09:03:57,Position closed,NSDQ100/USD," 302,90 ",0.298914," 2,90 "," 6.353,06 "," 2.993,10 ",2816769819,CFD," 0,00 "
27/09/2024 09:42:21,Open Position,NSDQ100/USD," 350,00 ",0.348701," 0,00 "," 6.353,06 "," 2.643,10 ",2816782789,CFD," 0,00 "
27/09/2024 09:42:43,Open Position,NSDQ100/USD," 249,99 ",0.249046," 0,00 "," 6.353,06 "," 2.393,11 ",2816782838,CFD," 0,00 "
27/09/2024 09:47:06,Position closed,NSDQ100/USD," 352,44 ",0.348701," 2,44 "," 6.355,50 "," 2.745,55 ",2816782789,CFD," 0,00 "
27/09/2024 09:47:14,Position closed,NSDQ100/USD," 251,71 ",0.249046," 1,72 "," 6.357,22 "," 2.997,26 ",2816782838,CFD," 0,00 "
27/09/2024 09:56:12,Position closed,NSDQ100/USD," 298,86 ",0.298605,"(1,14)"," 6.356,08 "," 3.296,12 ",2816764265,CFD," 0,00 "
27/09/2024 10:03:36,Open Position,NSDQ100/USD," 350,00 ",0.348534," 0,00 "," 6.356,08 "," 2.946,12 ",2816787878,CFD," 0,00 "
27/09/2024 10:19:53,Open Position,NSDQ100/USD," 739,99 ",0.736813," 0,00 "," 6.356,08 "," 2.206,13 ",2816792935,CFD," 0,00 "
27/09/2024 10:20:35,Position closed,NSDQ100/USD," 741,16 ",0.736813," 1,17 "," 6.357,25 "," 2.947,29 ",2816792935,CFD," 0,00 "
27/09/2024 10:20:42,Position closed,NSDQ100/USD," 351,43 ",0.348534," 1,43 "," 6.358,68 "," 3.298,72 ",2816787878,CFD," 0,00 "
27/09/2024 10:21:57,Open Position,NSDQ100/USD," 350,00 ",0.348503," 0,00 "," 6.358,68 "," 2.948,72 ",2816793198,CFD," 0,00 "
27/09/2024 10:23:15,Open Position,NSDQ100/USD," 499,99 ",0.497822," 0,00 "," 6.358,68 "," 2.448,73 ",2816793800,CFD," 0,00 "
27/09/2024 10:31:48,Open Position,NSDQ100/USD," 619,99 ",0.617532," 0,00 "," 6.358,68 "," 1.828,74 ",2816795659,CFD," 0,00 "
27/09/2024 10:35:39,Open Position,NSDQ100/USD," 350,00 ",0.348591," 0,00 "," 6.358,68 "," 1.478,74 ",2816796555,CFD," 0,00 "
27/09/2024 10:44:40,Open Position,NSDQ100/USD," 300,00 ",0.298926," 0,00 "," 6.358,68 "," 1.178,74 ",2816799157,CFD," 0,00 "
27/09/2024 10:47:40,Position closed,NSDQ100/USD," 300,30 ",0.298926," 0,30 "," 6.358,98 "," 1.479,04 ",2816799157,CFD," 0,00 "
27/09/2024 11:23:59,Position closed,NSDQ100/USD," 354,60 ",0.348591," 4,60 "," 6.363,58 "," 1.833,64 ",2816796555,CFD," 0,00 "
27/09/2024 11:24:10,Position closed,NSDQ100/USD," 628,63 ",0.617532," 8,64 "," 6.372,22 "," 2.462,27 ",2816795659,CFD," 0,00 "
27/09/2024 11:24:16,Position closed,NSDQ100/USD," 502,23 ",0.497822," 2,24 "," 6.374,46 "," 2.964,50 ",2816793800,CFD," 0,00 "
27/09/2024 11:24:21,Position closed,NSDQ100/USD," 351,98 ",0.348503," 1,98 "," 6.376,44 "," 3.316,48 ",2816793198,CFD," 0,00 "
27/09/2024 11:57:41,Position closed,NSDQ100/USD," 831,10 ",0.938476,"(118,89)"," 6.257,55 "," 4.147,58 ",2816008530,CFD," 0,00 "
27/09/2024 11:58:16,Open Position,NSDQ100/USD," 350,00 ",0.347819," 0,00 "," 6.257,55 "," 3.797,58 ",2816815450,CFD," 0,00 "
27/09/2024 11:58:59,Open Position,NSDQ100/USD," 350,00 ",0.347834," 0,00 "," 6.257,55 "," 3.447,58 ",2816815579,CFD," 0,00 "
27/09/2024 12:03:17,Open Position,NSDQ100/USD," 350,00 ",0.347660," 0,00 "," 6.257,55 "," 3.097,58 ",2816817914,CFD," 0,00 "
27/09/2024 12:04:52,Position closed,NSDQ100/USD," 350,13 ",0.347660," 0,13 "," 6.257,68 "," 3.447,71 ",2816817914,CFD," 0,00 "
27/09/2024 12:09:16,Position closed,NSDQ100/USD," 355,25 ",0.347834," 5,25 "," 6.262,93 "," 3.802,96 ",2816815579,CFD," 0,00 "
27/09/2024 12:09:23,Position closed,NSDQ100/USD," 354,69 ",0.347819," 4,69 "," 6.267,62 "," 4.157,65 ",2816815450,CFD," 0,00 "
27/09/2024 12:10:40,Position closed,NSDQ100/USD," 636,49 ",0.701523,"(73,51)"," 6.194,11 "," 4.794,14 ",2816012051,CFD," 0,00 "
27/09/2024 12:11:01,Position closed,NSDQ100/USD," 214,10 ",0.246516,"(35,90)"," 6.158,21 "," 5.008,24 ",2815920081,CFD," 0,00 "
27/09/2024 12:11:29,Open Position,NSDQ100/USD," 599,99 ",0.595879," 0,00 "," 6.158,21 "," 4.408,25 ",2816820560,CFD," 0,00 "
27/09/2024 12:12:02,Open Position,NSDQ100/USD," 350,00 ",0.347661," 0,00 "," 6.158,21 "," 4.058,25 ",2816820739,CFD," 0,00 "
27/09/2024 12:22:06,Position closed,NSDQ100/USD," 601,29 ",0.595879," 1,30 "," 6.159,51 "," 4.659,54 ",2816820560,CFD," 0,00 "
27/09/2024 12:22:48,Position closed,NSDQ100/USD," 351,59 ",0.347661," 1,59 "," 6.161,10 "," 5.011,13 ",2816820739,CFD," 0,00 "
27/09/2024 12:23:04,Open Position,NSDQ100/USD," 350,00 ",0.347525," 0,00 "," 6.161,10 "," 4.661,13 ",2816823498,CFD," 0,00 "
27/09/2024 12:23:15,Open Position,NSDQ100/USD," 350,00 ",0.347558," 0,00 "," 6.161,10 "," 4.311,13 ",2816823541,CFD," 0,00 "
27/09/2024 12:24:06,Open Position,NSDQ100/USD," 300,00 ",0.297927," 0,00 "," 6.161,10 "," 4.011,13 ",2816823655,CFD," 0,00 "
27/09/2024 12:29:17,Position closed,NSDQ100/USD," 349,82 ",0.347558,"(0,18)"," 6.160,92 "," 4.360,95 ",2816823541,CFD," 0,00 "
27/09/2024 12:30:12,Position closed,NSDQ100/USD," 301,10 ",0.297927," 1,10 "," 6.162,02 "," 4.662,05 ",2816823655,CFD," 0,00 "
27/09/2024 12:30:53,Position closed,NSDQ100/USD," 355,90 ",0.347525," 5,90 "," 6.167,92 "," 5.017,95 ",2816823498,CFD," 0,00 "
27/09/2024 12:31:04,Open Position,NSDQ100/USD," 300,00 ",0.297548," 0,00 "," 6.167,92 "," 4.717,95 ",2816827466,CFD," 0,00 "
27/09/2024 12:31:39,Open Position,NSDQ100/USD," 250,00 ",0.247999," 0,00 "," 6.167,92 "," 4.467,95 ",2816829367,CFD," 0,00 "
27/09/2024 12:32:53,Open Position,NSDQ100/USD," 300,00 ",0.297555," 0,00 "," 6.167,92 "," 4.167,95 ",2816829827,CFD," 0,00 "
27/09/2024 12:34:24,Open Position,NSDQ100/USD," 350,00 ",0.347396," 0,00 "," 6.167,92 "," 3.817,95 ",2816830843,CFD," 0,00 "
27/09/2024 12:35:08,Open Position,NSDQ100/USD," 959,99 ",0.952616," 0,00 "," 6.167,92 "," 2.857,96 ",2816831164,CFD," 0,00 "
27/09/2024 12:38:54,Position closed,NSDQ100/USD," 300,59 ",0.297548," 0,59 "," 6.168,51 "," 3.158,55 ",2816827466,CFD," 0,00 "
27/09/2024 12:39:04,Position closed,NSDQ100/USD," 970,26 ",0.952616," 10,27 "," 6.178,78 "," 4.128,81 ",2816831164,CFD," 0,00 "
27/09/2024 12:39:12,Position closed,NSDQ100/USD," 355,73 ",0.347396," 5,73 "," 6.184,51 "," 4.484,54 ",2816830843,CFD," 0,00 "
27/09/2024 12:39:29,Open Position,NSDQ100/USD," 350,00 ",0.347060," 0,00 "," 6.184,51 "," 4.134,54 ",2816832622,CFD," 0,00 "
27/09/2024 12:39:49,Open Position,NSDQ100/USD," 399,99 ",0.396588," 0,00 "," 6.184,51 "," 3.734,55 ",2816832737,CFD," 0,00 "
27/09/2024 12:41:02,Open Position,NSDQ100/USD," 300,00 ",0.297568," 0,00 "," 6.184,51 "," 3.434,55 ",2816833299,CFD," 0,00 "
27/09/2024 12:41:57,Open Position,NSDQ100/USD," 300,00 ",0.297491," 0,00 "," 6.184,51 "," 3.134,55 ",2816833526,CFD," 0,00 "
27/09/2024 12:45:47,Position closed,NSDQ100/USD," 300,26 ",0.297568," 0,26 "," 6.184,77 "," 3.434,81 ",2816833299,CFD," 0,00 "
27/09/2024 12:46:37,Position closed,NSDQ100/USD," 251,26 ",0.247999," 1,26 "," 6.186,03 "," 3.686,07 ",2816829367,CFD," 0,00 "
27/09/2024 12:47:00,Position closed,NSDQ100/USD," 300,17 ",0.297555," 0,17 "," 6.186,20 "," 3.986,24 ",2816829827,CFD," 0,00 "
27/09/2024 12:48:49,Position closed,NSDQ100/USD," 301,06 ",0.297491," 1,06 "," 6.187,26 "," 4.287,30 ",2816833526,CFD," 0,00 "
27/09/2024 12:49:21,Position closed,NSDQ100/USD," 400,49 ",0.396588," 0,50 "," 6.187,76 "," 4.687,79 ",2816832737,CFD," 0,00 "
27/09/2024 12:51:58,Open Position,NSDQ100/USD," 300,00 ",0.297626," 0,00 "," 6.187,76 "," 4.387,79 ",2816837049,CFD," 0,00 "
27/09/2024 12:53:00,Open Position,NSDQ100/USD," 399,99 ",0.396970," 0,00 "," 6.187,76 "," 3.987,80 ",2816837422,CFD," 0,00 "
27/09/2024 12:55:59,Open Position,NSDQ100/USD," 350,00 ",0.347394," 0,00 "," 6.187,76 "," 3.637,80 ",2816838412,CFD," 0,00 "
27/09/2024 12:57:27,Open Position,NSDQ100/USD," 350,00 ",0.347368," 0,00 "," 6.187,76 "," 3.287,80 ",2816838753,CFD," 0,00 "
27/09/2024 12:58:58,Open Position,NSDQ100/USD," 830,00 ",0.823555," 0,00 "," 6.187,76 "," 2.457,80 ",2816841311,CFD," 0,00 "
27/09/2024 13:02:32,Open Position,NSDQ100/USD," 250,00 ",0.248051," 0,00 "," 6.187,76 "," 2.207,80 ",2816842921,CFD," 0,00 "
27/09/2024 13:04:40,Position closed,NSDQ100/USD," 352,39 ",0.347394," 2,39 "," 6.190,15 "," 2.560,19 ",2816838412,CFD," 0,00 "
27/09/2024 13:05:05,Position closed,NSDQ100/USD," 300,41 ",0.297626," 0,41 "," 6.190,56 "," 2.860,60 ",2816837049,CFD," 0,00 "
27/09/2024 13:05:39,Position closed,NSDQ100/USD," 353,50 ",0.347368," 3,50 "," 6.194,06 "," 3.214,10 ",2816838753,CFD," 0,00 "
27/09/2024 13:05:51,Open Position,NSDQ100/USD," 350,00 ",0.347129," 0,00 "," 6.194,06 "," 2.864,10 ",2816844116,CFD," 0,00 "
27/09/2024 13:06:53,Position closed,NSDQ100/USD," 834,60 ",0.823555," 4,60 "," 6.198,66 "," 3.698,70 ",2816841311,CFD," 0,00 "
27/09/2024 13:07:09,Position closed,NSDQ100/USD," 349,68 ",0.347129,"(0,32)"," 6.198,34 "," 4.048,38 ",2816844116,CFD," 0,00 "
27/09/2024 13:07:20,Open Position,NSDQ100/USD," 300,00 ",0.297481," 0,00 "," 6.198,34 "," 3.748,38 ",2816844784,CFD," 0,00 "
27/09/2024 13:08:04,Open Position,NSDQ100/USD," 300,00 ",0.297515," 0,00 "," 6.198,34 "," 3.448,38 ",2816845096,CFD," 0,00 "
27/09/2024 13:09:33,Open Position,NSDQ100/USD," 839,99 ",0.832873," 0,00 "," 6.198,34 "," 2.608,39 ",2816845528,CFD," 0,00 "
27/09/2024 13:10:24,Open Position,NSDQ100/USD," 300,00 ",0.297469," 0,00 "," 6.198,34 "," 2.308,39 ",2816845702,CFD," 0,00 "
27/09/2024 13:24:20,Position closed,NSDQ100/USD," 251,11 ",0.248051," 1,11 "," 6.199,45 "," 2.559,50 ",2816842921,CFD," 0,00 "
27/09/2024 13:24:28,Position closed,NSDQ100/USD," 403,55 ",0.396970," 3,56 "," 6.203,01 "," 2.963,05 ",2816837422,CFD," 0,00 "
27/09/2024 13:26:37,Open Position,NSDQ100/USD," 300,00 ",0.297707," 0,00 "," 6.203,01 "," 2.663,05 ",2816850805,CFD," 0,00 "
27/09/2024 13:27:06,Open Position,NSDQ100/USD," 300,00 ",0.297676," 0,00 "," 6.203,01 "," 2.363,05 ",2816850941,CFD," 0,00 "
27/09/2024 13:28:40,Open Position,NSDQ100/USD," 300,00 ",0.297595," 0,00 "," 6.203,01 "," 2.063,05 ",2816851444,CFD," 0,00 "
27/09/2024 13:30:41,Open Position,NSDQ100/USD," 199,99 ",0.198495," 0,00 "," 6.203,01 "," 1.863,06 ",2816888383,CFD," 0,00 "
27/09/2024 13:31:03,Open Position,BABA/USD," 99,94 ",4.714339," 0,00 "," 6.203,01 "," 1.763,12 ",2816906815,CFD," 0,00 "
27/09/2024 13:31:23,Open Position,NSDQ100/USD," 200,00 ",0.198616," 0,00 "," 6.203,01 "," 1.563,12 ",2816930977,CFD," 0,00 "
27/09/2024 13:33:03,Open Position,NSDQ100/USD," 149,99 ",0.148978," 0,00 "," 6.203,01 "," 1.413,13 ",2816956046,CFD," 0,00 "
27/09/2024 13:44:57,Open Position,NSDQ100/USD," 360,00 ",0.357974," 0,00 "," 6.203,01 "," 1.053,13 ",2816981448,CFD," 0,00 "
27/09/2024 13:55:11,Open Position,NSDQ100/USD," 269,99 ",0.268358," 0,00 "," 6.203,01 "," 783,14 ",2817079668,CFD," 0,00 "
27/09/2024 14:10:03,Open Position,NSDQ100/USD," 200,00 ",0.198860," 0,00 "," 6.203,01 "," 583,14 ",2817111837,CFD," 0,00 "
27/09/2024 14:35:06,Position closed,BABA/USD," 111,53 ",4.714339," 11,59 "," 6.214,60 "," 694,67 ",2816906815,CFD," 0,00 "
27/09/2024 14:35:29,Open Position,NSDQ100/USD," 299,99 ",0.298920," 0,00 "," 6.214,60 "," 394,68 ",2817158665,CFD," 0,00 "
27/09/2024 15:24:23,Open Position,NSDQ100/USD," 250,00 ",0.249586," 0,00 "," 6.214,60 "," 144,68 ",2817309544,CFD," 0,00 "
27/09/2024 15:40:42,Open Position,NSDQ100/USD," 144,67 ",0.144393," 0,00 "," 6.214,60 "," 0,01 ",2817327556,CFD," 0,00 "
27/09/2024 15:45:23,Position closed,NSDQ100/USD," 254,99 ",0.249586," 4,99 "," 6.219,59 "," 255,00 ",2817309544,CFD," 0,00 "
27/09/2024 15:45:37,Position closed,NSDQ100/USD," 146,11 ",0.144393," 1,44 "," 6.221,03 "," 401,11 ",2817327556,CFD," 0,00 "
27/09/2024 15:46:24,Open Position,NSDQ100/USD," 299,99 ",0.299240," 0,00 "," 6.221,03 "," 101,12 ",2817331645,CFD," 0,00 "
27/09/2024 16:56:21,Position closed,NSDQ100/USD," 297,29 ",0.299240,"(2,70)"," 6.218,33 "," 398,41 ",2817331645,CFD," 0,00 "
27/09/2024 17:20:11,Open Position,NSDQ100/USD," 299,99 ",0.299674," 0,00 "," 6.218,33 "," 98,42 ",2817418162,CFD," 0,00 "
27/09/2024 17:50:38,Position closed,NSDQ100/USD," 303,92 ",0.299674," 3,93 "," 6.222,26 "," 402,34 ",2817418162,CFD," 0,00 "
27/09/2024 17:56:54,Position closed,NSDQ100/USD," 292,34 ",0.298920,"(7,65)"," 6.214,61 "," 694,68 ",2817158665,CFD," 0,00 "
27/09/2024 18:41:09,Open Position,NSDQ100/USD," 350,00 ",0.350368," 0,00 "," 6.214,61 "," 344,68 ",2817465813,CFD," 0,00 "
27/09/2024 18:45:39,Position closed,NSDQ100/USD," 361,04 ",0.350368," 11,04 "," 6.225,65 "," 705,72 ",2817465813,CFD," 0,00 "
27/09/2024 18:46:34,Open Position,NSDQ100/USD," 180,00 ",0.179907," 0,00 "," 6.225,65 "," 525,72 ",2817494723,CFD," 0,00 "
27/09/2024 18:47:55,Position closed,NSDQ100/USD," 179,64 ",0.179907,"(0,36)"," 6.225,29 "," 705,36 ",2817494723,CFD," 0,00 "
27/09/2024 18:58:12,Open Position,NSDQ100/USD," 179,99 ",0.179739," 0,00 "," 6.225,29 "," 525,37 ",2817500053,CFD," 0,00 "
27/09/2024 18:58:51,Position closed,NSDQ100/USD," 237,61 ",0.296459,"(62,38)"," 6.162,91 "," 762,98 ",2816050000,CFD," 0,00 "
27/09/2024 18:59:21,Open Position,NSDQ100/USD," 200,00 ",0.199684," 0,00 "," 6.162,91 "," 562,98 ",2817500423,CFD," 0,00 "
27/09/2024 19:03:04,Position closed,NSDQ100/USD," 180,31 ",0.179739," 0,32 "," 6.163,23 "," 743,29 ",2817500053,CFD," 0,00 "
27/09/2024 19:03:34,Open Position,NSDQ100/USD," 200,00 ",0.199747," 0,00 "," 6.163,23 "," 543,29 ",2817502341,CFD," 0,00 "
27/09/2024 19:13:05,Open Position,NSDQ100/USD," 200,00 ",0.199813," 0,00 "," 6.163,23 "," 343,29 ",2817505968,CFD," 0,00 "
27/09/2024 19:18:29,Position closed,NSDQ100/USD," 200,70 ",0.199747," 0,70 "," 6.163,93 "," 543,99 ",2817502341,CFD," 0,00 "
27/09/2024 19:18:36,Position closed,NSDQ100/USD," 201,86 ",0.199813," 1,86 "," 6.165,79 "," 745,85 ",2817505968,CFD," 0,00 "
27/09/2024 19:18:52,Position closed,NSDQ100/USD," 198,24 ",0.199684,"(1,76)"," 6.164,03 "," 944,09 ",2817500423,CFD," 0,00 "
27/09/2024 19:20:24,Open Position,NSDQ100/USD," 300,00 ",0.299645," 0,00 "," 6.164,03 "," 644,09 ",2817508621,CFD," 0,00 "
27/09/2024 19:22:22,Open Position,NSDQ100/USD," 299,99 ",0.299633," 0,00 "," 6.164,03 "," 344,10 ",2817509515,CFD," 0,00 "
27/09/2024 19:22:48,Position closed,NSDQ100/USD," 300,27 ",0.299645," 0,27 "," 6.164,30 "," 644,37 ",2817508621,CFD," 0,00 "
27/09/2024 19:26:38,Open Position,NSDQ100/USD," 200,00 ",0.199942," 0,00 "," 6.164,30 "," 444,37 ",2817511127,CFD," 0,00 "
27/09/2024 19:41:27,Open Position,NSDQ100/USD," 200,00 ",0.199885," 0,00 "," 6.164,30 "," 244,37 ",2817518094,CFD," 0,00 "
27/09/2024 20:14:34,Open Position,NSDQ100/USD," 100,00 ",0.100064," 0,00 "," 6.164,30 "," 144,37 ",2817530288,CFD," 0,00 "
28/09/2024 00:14:15,Index price adjustment,NSDQ100/USD," 0,25 ",-," 0,25 "," 6.164,55 "," 144,62 ",2816178832,CFD," 0,00 "
28/09/2024 00:14:15,Index price adjustment,NSDQ100/USD," 0,25 ",-," 0,25 "," 6.164,80 "," 144,87 ",2816179658,CFD," 0,00 "
28/09/2024 00:14:15,Index price adjustment,NSDQ100/USD," 0,21 ",-," 0,21 "," 6.165,01 "," 145,08 ",2816182255,CFD," 0,00 "
28/09/2024 00:14:15,Index price adjustment,NSDQ100/USD," 0,29 ",-," 0,29 "," 6.165,30 "," 145,37 ",2816832622,CFD," 0,00 "
28/09/2024 00:14:15,Index price adjustment,NSDQ100/USD," 0,25 ",-," 0,25 "," 6.165,55 "," 145,62 ",2816844784,CFD," 0,00 "
28/09/2024 00:14:15,Index price adjustment,NSDQ100/USD," 0,25 ",-," 0,25 "," 6.165,80 "," 145,87 ",2816845096,CFD," 0,00 "
28/09/2024 00:14:15,Index price adjustment,NSDQ100/USD," 0,69 ",-," 0,69 "," 6.166,49 "," 146,56 ",2816845528,CFD," 0,00 "
28/09/2024 00:14:15,Index price adjustment,NSDQ100/USD," 0,25 ",-," 0,25 "," 6.166,74 "," 146,81 ",2816845702,CFD," 0,00 "
28/09/2024 00:14:15,Index price adjustment,NSDQ100/USD," 0,25 ",-," 0,25 "," 6.166,99 "," 147,06 ",2816850805,CFD," 0,00 "
28/09/2024 00:14:15,Index price adjustment,NSDQ100/USD," 0,25 ",-," 0,25 "," 6.167,24 "," 147,31 ",2816850941,CFD," 0,00 "
28/09/2024 00:14:15,Index price adjustment,NSDQ100/USD," 0,25 ",-," 0,25 "," 6.167,49 "," 147,56 ",2816851444,CFD," 0,00 "
28/09/2024 00:14:15,Index price adjustment,NSDQ100/USD," 0,16 ",-," 0,16 "," 6.167,65 "," 147,72 ",2816888383,CFD," 0,00 "
28/09/2024 00:14:15,Index price adjustment,NSDQ100/USD," 0,16 ",-," 0,16 "," 6.167,81 "," 147,88 ",2816930977,CFD," 0,00 "
28/09/2024 00:14:15,Index price adjustment,NSDQ100/USD," 0,12 ",-," 0,12 "," 6.167,93 "," 148,00 ",2816956046,CFD," 0,00 "
28/09/2024 00:14:15,Index price adjustment,NSDQ100/USD," 0,30 ",-," 0,30 "," 6.168,23 "," 148,30 ",2816981448,CFD," 0,00 "
28/09/2024 00:14:15,Index price adjustment,NSDQ100/USD," 0,22 ",-," 0,22 "," 6.168,45 "," 148,52 ",2817079668,CFD," 0,00 "
28/09/2024 00:14:15,Index price adjustment,NSDQ100/USD," 0,17 ",-," 0,17 "," 6.168,62 "," 148,69 ",2817111837,CFD," 0,00 "
28/09/2024 00:14:15,Index price adjustment,NSDQ100/USD," 0,25 ",-," 0,25 "," 6.168,87 "," 148,94 ",2817509515,CFD," 0,00 "
28/09/2024 00:14:15,Index price adjustment,NSDQ100/USD," 0,17 ",-," 0,17 "," 6.169,04 "," 149,11 ",2817511127,CFD," 0,00 "
28/09/2024 00:14:15,Index price adjustment,NSDQ100/USD," 0,17 ",-," 0,17 "," 6.169,21 "," 149,28 ",2817518094,CFD," 0,00 "
28/09/2024 00:48:14,Overnight fee,Weekend Fee,"(1,52)",-,"(1,52)"," 6.167,69 "," 147,76 ",2817530288,CFD," 0,00 "
28/09/2024 00:48:14,Overnight fee,Weekend Fee,"(2,27)",-,"(2,27)"," 6.165,42 "," 145,49 ",2816956046,CFD," 0,00 "
28/09/2024 00:48:14,Overnight fee,Weekend Fee,"(3,02)",-,"(3,02)"," 6.162,40 "," 142,47 ",2816888383,CFD," 0,00 "
28/09/2024 00:48:14,Overnight fee,Weekend Fee,"(3,02)",-,"(3,02)"," 6.159,38 "," 139,45 ",2816930977,CFD," 0,00 "
28/09/2024 00:48:14,Overnight fee,Weekend Fee,"(3,03)",-,"(3,03)"," 6.156,35 "," 136,42 ",2817111837,CFD," 0,00 "
28/09/2024 00:48:14,Overnight fee,Weekend Fee,"(3,04)",-,"(3,04)"," 6.153,31 "," 133,38 ",2817518094,CFD," 0,00 "
28/09/2024 00:48:14,Overnight fee,Weekend Fee,"(3,04)",-,"(3,04)"," 6.150,27 "," 130,34 ",2817511127,CFD," 0,00 "
28/09/2024 00:48:14,Overnight fee,Weekend Fee,"(3,77)",-,"(3,77)"," 6.146,50 "," 126,57 ",2816182255,CFD," 0,00 "
28/09/2024 00:48:14,Overnight fee,Weekend Fee,"(4,09)",-,"(4,09)"," 6.142,41 "," 122,48 ",2817079668,CFD," 0,00 "
28/09/2024 00:48:14,Overnight fee,Weekend Fee,"(4,52)",-,"(4,52)"," 6.137,89 "," 117,96 ",2816179658,CFD," 0,00 "
28/09/2024 00:48:14,Overnight fee,Weekend Fee,"(4,52)",-,"(4,52)"," 6.133,37 "," 113,44 ",2816178832,CFD," 0,00 "
28/09/2024 00:48:14,Overnight fee,Weekend Fee,"(4,53)",-,"(4,53)"," 6.128,84 "," 108,91 ",2816850805,CFD," 0,00 "
28/09/2024 00:48:14,Overnight fee,Weekend Fee,"(4,53)",-,"(4,53)"," 6.124,31 "," 104,38 ",2816851444,CFD," 0,00 "
28/09/2024 00:48:14,Overnight fee,Weekend Fee,"(4,53)",-,"(4,53)"," 6.119,78 "," 99,85 ",2816844784,CFD," 0,00 "
28/09/2024 00:48:14,Overnight fee,Weekend Fee,"(4,53)",-,"(4,53)"," 6.115,25 "," 95,32 ",2816845702,CFD," 0,00 "
28/09/2024 00:48:14,Overnight fee,Weekend Fee,"(4,53)",-,"(4,53)"," 6.110,72 "," 90,79 ",2816845096,CFD," 0,00 "
28/09/2024 00:48:14,Overnight fee,Weekend Fee,"(4,53)",-,"(4,53)"," 6.106,19 "," 86,26 ",2816850941,CFD," 0,00 "
28/09/2024 00:48:14,Overnight fee,Weekend Fee,"(4,56)",-,"(4,56)"," 6.101,63 "," 81,70 ",2817509515,CFD," 0,00 "
28/09/2024 00:48:14,Overnight fee,Weekend Fee,"(5,28)",-,"(5,28)"," 6.096,35 "," 76,42 ",2816832622,CFD," 0,00 "
28/09/2024 00:48:14,Overnight fee,Weekend Fee,"(5,45)",-,"(5,45)"," 6.090,90 "," 70,97 ",2816981448,CFD," 0,00 "
28/09/2024 00:48:14,Overnight fee,Weekend Fee,"(12,68)",-,"(12,68)"," 6.078,22 "," 58,29 ",2816845528,CFD," 0,00 "
29/09/2024 22:25:45,Position closed,NSDQ100/USD," 101,22 ",0.100064," 1,22 "," 6.079,44 "," 159,51 ",2817530288,CFD," 0,00 "
29/09/2024 23:48:06,Position closed,NSDQ100/USD," 307,83 ",0.299633," 7,84 "," 6.087,28 "," 467,34 ",2817509515,CFD," 0,00 "
29/09/2024 23:48:21,Position closed,NSDQ100/USD," 208,81 ",0.199942," 8,81 "," 6.096,09 "," 676,15 ",2817511127,CFD," 0,00 "
29/09/2024 23:48:31,Position closed,NSDQ100/USD," 207,47 ",0.199885," 7,47 "," 6.103,56 "," 883,62 ",2817518094,CFD," 0,00 "
30/09/2024 05:06:29,Open Position,NSDQ100/USD," 649,99 ",0.650585," 0,00 "," 6.103,56 "," 233,63 ",2817637935,CFD," 0,00 "
30/09/2024 06:33:44,Open Position,NSDQ100/USD," 199,99 ",0.200507," 0,00 "," 6.103,56 "," 33,64 ",2817649596,CFD," 0,00 "
30/09/2024 06:39:26,Position closed,NSDQ100/USD," 200,65 ",0.200507," 0,66 "," 6.104,22 "," 234,29 ",2817649596,CFD," 0,00 "
30/09/2024 06:59:01,Position closed,NSDQ100/USD," 645,31 ",0.650585,"(4,68)"," 6.099,54 "," 879,60 ",2817637935,CFD," 0,00 "
30/09/2024 07:01:19,Open Position,NSDQ100/USD," 250,00 ",0.250222," 0,00 "," 6.099,54 "," 629,60 ",2817699818,CFD," 0,00 "
30/09/2024 07:25:37,Position closed,NSDQ100/USD," 256,43 ",0.250222," 6,43 "," 6.105,97 "," 886,03 ",2817699818,CFD," 0,00 "
30/09/2024 07:27:45,Open Position,NSDQ100/USD," 249,99 ",0.249896," 0,00 "," 6.105,97 "," 636,04 ",2817747663,CFD," 0,00 "
30/09/2024 07:29:10,Position closed,NSDQ100/USD," 241,87 ",0.297012,"(58,12)"," 6.047,85 "," 877,91 ",2816178832,CFD," 0,00 "
30/09/2024 07:29:48,Open Position,NSDQ100/USD," 199,99 ",0.199915," 0,00 "," 6.047,85 "," 677,92 ",2817748694,CFD," 0,00 "
30/09/2024 08:12:01,Open Position,NSDQ100/USD," 250,00 ",0.250132," 0,00 "," 6.047,85 "," 427,92 ",2817769186,CFD," 0,00 "
30/09/2024 09:08:01,Position closed,NSDQ100/USD," 247,57 ",0.250132,"(2,43)"," 6.045,42 "," 675,49 ",2817769186,CFD," 0,00 "
30/09/2024 09:27:00,Position closed,NSDQ100/USD," 128,35 ",0.148978,"(21,64)"," 6.023,78 "," 803,84 ",2816956046,CFD," 0,00 "
30/09/2024 09:44:24,Open Position,NSDQ100/USD," 300,00 ",0.300271," 0,00 "," 6.023,78 "," 503,84 ",2817821270,CFD," 0,00 "
30/09/2024 09:57:24,Position closed,NSDQ100/USD," 301,68 ",0.300271," 1,68 "," 6.025,46 "," 805,52 ",2817821270,CFD," 0,00 "
30/09/2024 10:20:15,Position closed,NSDQ100/USD," 240,02 ",0.297068,"(59,97)"," 5.965,49 "," 1.045,54 ",2816179658,CFD," 0,00 "
30/09/2024 10:21:15,Open Position,NSDQ100/USD," 300,00 ",0.300009," 0,00 "," 5.965,49 "," 745,54 ",2817865008,CFD," 0,00 "
30/09/2024 10:24:06,Open Position,XAU/USD," 400,00 ",3.023054," 0,00 "," 5.965,49 "," 345,54 ",2817865563,CFD," 0,00 "
30/09/2024 10:26:07,Position closed,NSDQ100/USD," 300,09 ",0.300009," 0,09 "," 5.965,58 "," 645,63 ",2817865008,CFD," 0,00 "
30/09/2024 10:28:45,Position closed,XAU/USD," 395,25 ",3.023054,"(4,75)"," 5.960,83 "," 1.040,88 ",2817865563,CFD," 0,00 "
30/09/2024 10:38:44,Open Position,NSDQ100/USD," 300,00 ",0.300256," 0,00 "," 5.960,83 "," 740,88 ",2817881643,CFD," 0,00 "
30/09/2024 11:13:03,Open Position,NSDQ100/USD," 300,00 ",0.300847," 0,00 "," 5.960,83 "," 440,88 ",2817892559,CFD," 0,00 "
30/09/2024 11:22:07,Position closed,NSDQ100/USD," 301,66 ",0.300847," 1,66 "," 5.962,49 "," 742,54 ",2817892559,CFD," 0,00 "
30/09/2024 11:22:47,Open Position,XAU/USD," 199,99 ",1.515610," 0,00 "," 5.962,49 "," 542,55 ",2817894792,CFD," 0,00 "
30/09/2024 11:23:41,Position closed,NSDQ100/USD," 188,50 ",0.247532,"(61,50)"," 5.900,99 "," 731,05 ",2816182255,CFD," 0,00 "
30/09/2024 11:23:56,Open Position,XAU/USD," 199,99 ",1.515650," 0,00 "," 5.900,99 "," 531,06 ",2817895191,CFD," 0,00 "
30/09/2024 11:31:32,Position closed,NSDQ100/USD," 273,08 ",0.347060,"(76,92)"," 5.824,07 "," 804,14 ",2816832622,CFD," 0,00 "
30/09/2024 11:31:51,Open Position,XAU/USD," 350,00 ",2.651515," 0,00 "," 5.824,07 "," 454,14 ",2817909125,CFD," 0,00 "
30/09/2024 11:38:41,Position closed,NSDQ100/USD," 230,15 ",0.297469,"(69,85)"," 5.754,22 "," 684,29 ",2816845702,CFD," 0,00 "
30/09/2024 11:40:18,Position closed,XAU/USD," 204,13 ",1.515610," 4,14 "," 5.758,36 "," 888,42 ",2817894792,CFD," 0,00 "
30/09/2024 11:40:18,Position closed,XAU/USD," 355,12 ",2.651515," 5,12 "," 5.763,48 "," 1.243,54 ",2817909125,CFD," 0,00 "
30/09/2024 11:40:18,Position closed,XAU/USD," 204,23 ",1.515650," 4,24 "," 5.767,72 "," 1.447,77 ",2817895191,CFD," 0,00 "
30/09/2024 11:41:51,Open Position,NSDQ100/USD," 399,99 ",0.401370," 0,00 "," 5.767,72 "," 1.047,78 ",2817923988,CFD," 0,00 "
30/09/2024 11:43:37,Open Position,XAU/USD," 299,99 ",2.271410," 0,00 "," 5.767,72 "," 747,79 ",2817924681,CFD," 0,00 "
30/09/2024 11:48:45,Open Position,NSDQ100/USD," 199,99 ",0.200758," 0,00 "," 5.767,72 "," 547,80 ",2817925920,CFD," 0,00 "
30/09/2024 12:03:01,Position closed,NSDQ100/USD," 200,05 ",0.200758," 0,06 "," 5.767,78 "," 747,85 ",2817925920,CFD," 0,00 "
30/09/2024 12:03:46,Position closed,NSDQ100/USD," 633,35 ",0.832873,"(206,64)"," 5.561,14 "," 1.381,20 ",2816845528,CFD," 0,00 "
30/09/2024 12:04:23,Open Position,XAU/USD," 309,99 ",2.347026," 0,00 "," 5.561,14 "," 1.071,21 ",2817956107,CFD," 0,00 "
30/09/2024 12:07:08,Position closed,NSDQ100/USD," 231,84 ",0.297481,"(68,16)"," 5.492,98 "," 1.303,05 ",2816844784,CFD," 0,00 "
30/09/2024 12:07:41,Position closed,NSDQ100/USD," 404,41 ",0.401370," 4,42 "," 5.497,40 "," 1.707,46 ",2817923988,CFD," 0,00 "
30/09/2024 12:08:19,Open Position,XAU/USD," 390,00 ",2.952744," 0,00 "," 5.497,40 "," 1.317,46 ",2817970764,CFD," 0,00 "
30/09/2024 12:10:26,Open Position,XAU/USD," 299,99 ",2.270448," 0,00 "," 5.497,40 "," 1.017,47 ",2817975296,CFD," 0,00 "
30/09/2024 12:10:51,Position closed,XAU/USD," 391,33 ",2.952744," 1,33 "," 5.498,73 "," 1.408,80 ",2817970764,CFD," 0,00 "
30/09/2024 12:11:08,Position closed,XAU/USD," 310,88 ",2.347026," 0,89 "," 5.499,62 "," 1.719,68 ",2817956107,CFD," 0,00 "
30/09/2024 12:14:07,Position closed,XAU/USD," 305,17 ",2.271410," 5,18 "," 5.504,80 "," 2.024,85 ",2817924681,CFD," 0,00 "
30/09/2024 12:14:07,Position closed,XAU/USD," 302,62 ",2.270448," 2,63 "," 5.507,43 "," 2.327,47 ",2817975296,CFD," 0,00 "
30/09/2024 12:15:55,Open Position,XAU/USD," 549,99 ",4.161826," 0,00 "," 5.507,43 "," 1.777,48 ",2817984338,CFD," 0,00 "
30/09/2024 12:17:20,Open Position,XAU/USD," 409,99 ",3.103615," 0,00 "," 5.507,43 "," 1.367,49 ",2817984577,CFD," 0,00 "
30/09/2024 12:17:47,Open Position,XAU/USD," 309,99 ",2.347089," 0,00 "," 5.507,43 "," 1.057,50 ",2817984679,CFD," 0,00 "
30/09/2024 12:35:50,Open Position,XAU/USD," 299,99 ",2.274959," 0,00 "," 5.507,43 "," 757,51 ",2817989302,CFD," 0,00 "
30/09/2024 12:37:18,Position closed,NSDQ100/USD," 235,26 ",0.297515,"(64,74)"," 5.442,69 "," 992,77 ",2816845096,CFD," 0,00 "
30/09/2024 12:38:00,Position closed,NSDQ100/USD," 159,60 ",0.198495,"(40,39)"," 5.402,30 "," 1.152,37 ",2816888383,CFD," 0,00 "
30/09/2024 12:38:00,Position closed,NSDQ100/USD," 236,37 ",0.297595,"(63,63)"," 5.338,67 "," 1.388,74 ",2816851444,CFD," 0,00 "
30/09/2024 12:38:00,Position closed,NSDQ100/USD," 238,61 ",0.297707,"(61,39)"," 5.277,28 "," 1.627,35 ",2816850805,CFD," 0,00 "
30/09/2024 12:38:00,Position closed,NSDQ100/USD," 237,99 ",0.297676,"(62,01)"," 5.215,27 "," 1.865,34 ",2816850941,CFD," 0,00 "
30/09/2024 12:38:00,Position closed,NSDQ100/USD," 223,15 ",0.268358,"(46,84)"," 5.168,43 "," 2.088,49 ",2817079668,CFD," 0,00 "
30/09/2024 12:38:00,Position closed,NSDQ100/USD," 300,81 ",0.357974,"(59,19)"," 5.109,24 "," 2.389,30 ",2816981448,CFD," 0,00 "
30/09/2024 12:38:00,Position closed,NSDQ100/USD," 166,84 ",0.198860,"(33,16)"," 5.076,08 "," 2.556,14 ",2817111837,CFD," 0,00 "
30/09/2024 12:38:00,Position closed,NSDQ100/USD," 161,95 ",0.198616,"(38,05)"," 5.038,03 "," 2.718,09 ",2816930977,CFD," 0,00 "
30/09/2024 12:38:00,Position closed,NSDQ100/USD," 289,46 ",0.300256,"(10,54)"," 5.027,49 "," 3.007,55 ",2817881643,CFD," 0,00 "
30/09/2024 12:38:00,Position closed,NSDQ100/USD," 187,86 ",0.199915,"(12,13)"," 5.015,36 "," 3.195,41 ",2817748694,CFD," 0,00 "
30/09/2024 12:38:00,Position closed,NSDQ100/USD," 234,87 ",0.249896,"(15,12)"," 5.000,24 "," 3.430,28 ",2817747663,CFD," 0,00 "
30/09/2024 12:39:49,Open Position,XAU/USD," 199,99 ",1.517070," 0,00 "," 5.000,24 "," 3.230,29 ",2817990471,CFD," 0,00 "
30/09/2024 13:03:47,Position closed,XAU/USD," 544,54 ",4.161826,"(5,45)"," 4.994,79 "," 3.774,83 ",2817984338,CFD," 0,00 "
30/09/2024 13:03:47,Position closed,XAU/USD," 309,89 ",2.274959," 9,90 "," 5.004,69 "," 4.084,72 ",2817989302,CFD," 0,00 "
30/09/2024 13:03:47,Position closed,XAU/USD," 409,00 ",3.103615,"(0,99)"," 5.003,70 "," 4.493,72 ",2817984577,CFD," 0,00 "
30/09/2024 13:03:47,Position closed,XAU/USD," 310,44 ",2.347089," 0,45 "," 5.004,15 "," 4.804,16 ",2817984679,CFD," 0,00 "
30/09/2024 13:03:47,Position closed,XAU/USD," 207,73 ",1.517070," 7,74 "," 5.011,89 "," 5.011,89 ",2817990471,CFD," 0,00 "
30/09/2024 13:05:21,Open Position,XAU/USD," 199,99 ",1.514262," 0,00 "," 5.011,89 "," 4.811,90 ",2817996026,CFD," 0,00 "
30/09/2024 13:06:19,Open Position,NSDQ100/USD," 199,99 ",0.200372," 0,00 "," 5.011,89 "," 4.611,91 ",2817996275,CFD," 0,00 "
30/09/2024 13:07:10,Open Position,XAU/USD," 199,99 ",1.514526," 0,00 "," 5.011,89 "," 4.411,92 ",2817996449,CFD," 0,00 "
30/09/2024 13:08:09,Open Position,XAU/USD," 500,00 ",3.788811," 0,00 "," 5.011,89 "," 3.911,92 ",2817996707,CFD," 0,00 "
30/09/2024 13:08:56,Position closed,NSDQ100/USD," 200,11 ",0.200372," 0,12 "," 5.012,01 "," 4.112,03 ",2817996275,CFD," 0,00 "
30/09/2024 13:17:14,Position closed,XAU/USD," 501,21 ",3.788811," 1,21 "," 5.013,22 "," 4.613,24 ",2817996707,CFD," 0,00 "
30/09/2024 13:17:48,Open Position,NSDQ100/USD," 249,99 ",0.250385," 0,00 "," 5.013,22 "," 4.363,25 ",2818001615,CFD," 0,00 "
30/09/2024 13:20:03,Open Position,NSDQ100/USD," 299,98 ",0.300558," 0,00 "," 5.013,22 "," 4.063,27 ",2818002069,CFD," 0,00 "
30/09/2024 13:20:58,Position closed,NSDQ100/USD," 250,99 ",0.250385," 1,00 "," 5.014,22 "," 4.314,26 ",2818001615,CFD," 0,00 "
30/09/2024 13:21:07,Position closed,NSDQ100/USD," 299,32 ",0.300558,"(0,66)"," 5.013,56 "," 4.613,58 ",2818002069,CFD," 0,00 "
30/09/2024 13:23:14,Position closed,XAU/USD," 198,94 ",1.514526,"(1,05)"," 5.012,51 "," 4.812,52 ",2817996449,CFD," 0,00 "
30/09/2024 13:23:34,Position closed,XAU/USD," 198,08 ",1.514262,"(1,91)"," 5.010,60 "," 5.010,60 ",2817996026,CFD," 0,00 "
30/09/2024 13:26:02,Open Position,NSDQ100/USD," 200,00 ",0.200412," 0,00 "," 5.010,60 "," 4.810,60 ",2818006997,CFD," 0,00 "
30/09/2024 13:26:57,Position closed,NSDQ100/USD," 198,50 ",0.200412,"(1,50)"," 5.009,10 "," 5.009,10 ",2818006997,CFD," 0,00 "
30/09/2024 13:28:07,Open Position,NSDQ100/USD," 300,00 ",0.300447," 0,00 "," 5.009,10 "," 4.709,10 ",2818007722,CFD," 0,00 "
30/09/2024 13:30:12,Position closed,NSDQ100/USD," 298,51 ",0.300447,"(1,49)"," 5.007,61 "," 5.007,61 ",2818007722,CFD," 0,00 "
30/09/2024 13:30:51,Open Position,BABA/USD," 199,55 ",8.941897," 0,00 "," 5.007,61 "," 4.808,06 ",2818030107,CFD," 0,00 "
30/09/2024 13:30:51,Open Position,BABA/USD," 299,42 ",13.413069," 0,00 "," 5.007,61 "," 4.508,64 ",2818030135,CFD," 0,00 "
30/09/2024 13:33:14,Open Position,NSDQ100/USD," 300,00 ",0.299886," 0,00 "," 5.007,61 "," 4.208,64 ",2818151277,CFD," 0,00 "
30/09/2024 13:35:02,Open Position,NSDQ100/USD," 299,99 ",0.299843," 0,00 "," 5.007,61 "," 3.908,65 ",2818155811,CFD," 0,00 "
30/09/2024 13:36:37,Position closed,NSDQ100/USD," 293,58 ",0.299886,"(6,42)"," 5.001,19 "," 4.202,23 ",2818151277,CFD," 0,00 "
30/09/2024 13:36:41,Position closed,NSDQ100/USD," 293,63 ",0.299843,"(6,36)"," 4.994,83 "," 4.495,86 ",2818155811,CFD," 0,00 "
30/09/2024 13:44:00,Open Position,NSDQ100/USD," 300,00 ",0.299638," 0,00 "," 4.994,83 "," 4.195,86 ",2818180347,CFD," 0,00 "
30/09/2024 13:45:13,Position closed,NSDQ100/USD," 295,20 ",0.299638,"(4,80)"," 4.990,03 "," 4.491,06 ",2818180347,CFD," 0,00 "
30/09/2024 13:47:16,Open Position,XAU/USD," 199,99 ",1.518822," 0,00 "," 4.990,03 "," 4.291,07 ",2818191512,CFD," 0,00 "
30/09/2024 13:47:58,Open Position,XAU/USD," 299,99 ",2.279210," 0,00 "," 4.990,03 "," 3.991,08 ",2818192924,CFD," 0,00 "
30/09/2024 13:50:14,Position closed,XAU/USD," 304,23 ",2.279210," 4,24 "," 4.994,27 "," 4.295,31 ",2818192924,CFD," 0,00 "
30/09/2024 13:50:14,Position closed,XAU/USD," 201,10 ",1.518822," 1,11 "," 4.995,38 "," 4.496,41 ",2818191512,CFD," 0,00 "
30/09/2024 13:50:32,Position closed,BABA/USD," 291,86 ",13.413069,"(7,56)"," 4.987,82 "," 4.788,27 ",2818030135,CFD," 0,00 "
30/09/2024 13:50:32,Position closed,BABA/USD," 194,78 ",8.941897,"(4,77)"," 4.983,05 "," 4.983,05 ",2818030107,CFD," 0,00 "
30/09/2024 13:53:45,Open Position,XAU/USD," 299,99 ",2.275088," 0,00 "," 4.983,05 "," 4.683,06 ",2818313115,CFD," 0,00 "
30/09/2024 13:55:50,Open Position,NSDQ100/USD," 249,99 ",0.249767," 0,00 "," 4.983,05 "," 4.433,07 ",2818329012,CFD," 0,00 "
30/09/2024 13:56:57,Position closed,NSDQ100/USD," 250,76 ",0.249767," 0,77 "," 4.983,82 "," 4.683,83 ",2818329012,CFD," 0,00 "
30/09/2024 13:58:50,Position closed,XAU/USD," 301,51 ",2.275088," 1,52 "," 4.985,34 "," 4.985,34 ",2818313115,CFD," 0,00 "
30/09/2024 13:59:04,Open Position,NSDQ100/USD," 500,00 ",0.499883," 0,00 "," 4.985,34 "," 4.485,34 ",2818337227,CFD," 0,00 "
30/09/2024 14:00:02,Position closed,NSDQ100/USD," 506,10 ",0.499883," 6,10 "," 4.991,44 "," 4.991,44 ",2818337227,CFD," 0,00 "
30/09/2024 14:00:19,Open Position,NSDQ100/USD," 500,00 ",0.500381," 0,00 "," 4.991,44 "," 4.491,44 ",2818339563,CFD," 0,00 "
30/09/2024 14:01:36,Open Position,NSDQ100/USD," 149,99 ",0.150016," 0,00 "," 4.991,44 "," 4.341,45 ",2818342775,CFD," 0,00 "
30/09/2024 14:02:27,Position closed,NSDQ100/USD," 489,39 ",0.500381,"(10,61)"," 4.980,83 "," 4.830,84 ",2818339563,CFD," 0,00 "
30/09/2024 14:02:33,Position closed,NSDQ100/USD," 150,14 ",0.150016," 0,15 "," 4.980,98 "," 4.980,98 ",2818342775,CFD," 0,00 "
30/09/2024 14:07:12,Open Position,NSDQ100/USD," 499,99 ",0.500326," 0,00 "," 4.980,98 "," 4.480,99 ",2818359345,CFD," 0,00 "
30/09/2024 14:08:04,Open Position,NSDQ100/USD," 299,99 ",0.300329," 0,00 "," 4.980,98 "," 4.181,00 ",2818360417,CFD," 0,00 "
30/09/2024 14:08:53,Open Position,NSDQ100/USD," 299,99 ",0.300458," 0,00 "," 4.980,98 "," 3.881,01 ",2818362494,CFD," 0,00 "
30/09/2024 14:09:39,Open Position,NSDQ100/USD," 299,99 ",0.300483," 0,00 "," 4.980,98 "," 3.581,02 ",2818364354,CFD," 0,00 "
30/09/2024 14:10:56,Position closed,NSDQ100/USD," 303,45 ",0.300483," 3,46 "," 4.984,44 "," 3.884,47 ",2818364354,CFD," 0,00 "
30/09/2024 14:11:03,Position closed,NSDQ100/USD," 302,87 ",0.300458," 2,88 "," 4.987,32 "," 4.187,34 ",2818362494,CFD," 0,00 "
30/09/2024 14:11:13,Position closed,NSDQ100/USD," 300,89 ",0.300329," 0,90 "," 4.988,22 "," 4.488,23 ",2818360417,CFD," 0,00 "
30/09/2024 14:11:48,Position closed,NSDQ100/USD," 499,19 ",0.500326,"(0,80)"," 4.987,42 "," 4.987,42 ",2818359345,CFD," 0,00 "
30/09/2024 14:13:02,Open Position,NSDQ100/USD," 299,99 ",0.300322," 0,00 "," 4.987,42 "," 4.687,43 ",2818374407,CFD," 0,00 "
30/09/2024 14:14:00,Open Position,NSDQ100/USD," 299,99 ",0.300413," 0,00 "," 4.987,42 "," 4.387,44 ",2818376954,CFD," 0,00 "
30/09/2024 14:14:42,Open Position,NSDQ100/USD," 200,00 ",0.200320," 0,00 "," 4.987,42 "," 4.187,44 ",2818379889,CFD," 0,00 "
30/09/2024 14:15:09,Open Position,NSDQ100/USD," 299,98 ",0.300525," 0,00 "," 4.987,42 "," 3.887,46 ",2818381433,CFD," 0,00 "
30/09/2024 15:07:47,Position closed,NSDQ100/USD," 303,68 ",0.300322," 3,69 "," 4.991,11 "," 4.191,14 ",2818374407,CFD," 0,00 "
30/09/2024 15:07:47,Position closed,NSDQ100/USD," 204,51 ",0.200320," 4,51 "," 4.995,62 "," 4.395,65 ",2818379889,CFD," 0,00 "
30/09/2024 15:07:47,Position closed,NSDQ100/USD," 305,49 ",0.300413," 5,50 "," 5.001,12 "," 4.701,14 ",2818376954,CFD," 0,00 "
30/09/2024 15:07:47,Position closed,NSDQ100/USD," 307,95 ",0.300525," 7,97 "," 5.009,09 "," 5.009,09 ",2818381433,CFD," 0,00 "
30/09/2024 15:19:27,Open Position,NSDQ100/USD," 299,99 ",0.300134," 0,00 "," 5.009,09 "," 4.709,10 ",2818513226,CFD," 0,00 "
30/09/2024 15:19:44,Open Position,NSDQ100/USD," 99,99 ",0.100029," 0,00 "," 5.009,09 "," 4.609,11 ",2818513398,CFD," 0,00 "
30/09/2024 15:28:05,Position closed,NSDQ100/USD," 302,33 ",0.300134," 2,34 "," 5.011,43 "," 4.911,44 ",2818513226,CFD," 0,00 "
30/09/2024 15:28:05,Position closed,NSDQ100/USD," 100,47 ",0.100029," 0,48 "," 5.011,91 "," 5.011,91 ",2818513398,CFD," 0,00 "
30/09/2024 15:29:55,Open Position,NSDQ100/USD," 200,00 ",0.199869," 0,00 "," 5.011,91 "," 4.811,91 ",2818605235,CFD," 0,00 "
30/09/2024 15:44:29,Open Position,NSDQ100/USD," 350,00 ",0.350186," 0,00 "," 5.011,91 "," 4.461,91 ",2818621392,CFD," 0,00 "
30/09/2024 15:59:57,Position closed,NSDQ100/USD," 351,30 ",0.350186," 1,30 "," 5.013,21 "," 4.813,21 ",2818621392,CFD," 0,00 "
30/09/2024 16:02:31,Open Position,NSDQ100/USD," 249,99 ",0.249935," 0,00 "," 5.013,21 "," 4.563,22 ",2818637850,CFD," 0,00 "
30/09/2024 16:09:35,Position closed,NSDQ100/USD," 253,09 ",0.249935," 3,10 "," 5.016,31 "," 4.816,31 ",2818637850,CFD," 0,00 "
30/09/2024 16:09:42,Position closed,NSDQ100/USD," 200,58 ",0.199869," 0,58 "," 5.016,89 "," 5.016,89 ",2818605235,CFD," 0,00 "
30/09/2024 16:10:31,Open Position,XAU/USD," 249,99 ",1.896849," 0,00 "," 5.016,89 "," 4.766,90 ",2818644363,CFD," 0,00 "
30/09/2024 16:10:47,Open Position,NSDQ100/USD," 250,00 ",0.249581," 0,00 "," 5.016,89 "," 4.516,90 ",2818644498,CFD," 0,00 "
30/09/2024 16:12:15,Open Position,NSDQ100/USD," 249,99 ",0.249848," 0,00 "," 5.016,89 "," 4.266,91 ",2818646219,CFD," 0,00 "
30/09/2024 16:22:19,Position closed,NSDQ100/USD," 252,81 ",0.249848," 2,82 "," 5.019,71 "," 4.519,72 ",2818646219,CFD," 0,00 "
30/09/2024 16:22:19,Position closed,NSDQ100/USD," 247,28 ",0.249581,"(2,72)"," 5.016,99 "," 4.767,00 ",2818644498,CFD," 0,00 "
30/09/2024 16:31:15,Open Position,NSDQ100/USD," 250,00 ",0.249668," 0,00 "," 5.016,99 "," 4.517,00 ",2818662756,CFD," 0,00 "
30/09/2024 16:31:34,Position closed,XAU/USD," 251,56 ",1.896849," 1,57 "," 5.018,56 "," 4.768,56 ",2818644363,CFD," 0,00 "
30/09/2024 16:39:09,Open Position,NSDQ100/USD," 350,00 ",0.349784," 0,00 "," 5.018,56 "," 4.418,56 ",2818665950,CFD," 0,00 "
30/09/2024 16:45:05,Open Position,NSDQ100/USD," 249,98 ",0.249925," 0,00 "," 5.018,56 "," 4.168,58 ",2818669315,CFD," 0,00 "
30/09/2024 17:11:55,Open Position,NSDQ100/USD," 350,00 ",0.350542," 0,00 "," 5.018,56 "," 3.818,58 ",2818687333,CFD," 0,00 "
30/09/2024 17:16:11,Open Position,NSDQ100/USD," 200,00 ",0.200385," 0,00 "," 5.018,56 "," 3.618,58 ",2818690110,CFD," 0,00 "
30/09/2024 17:31:19,Position closed,NSDQ100/USD," 348,42 ",0.350542,"(1,58)"," 5.016,98 "," 3.967,00 ",2818687333,CFD," 0,00 "
30/09/2024 17:31:32,Position closed,NSDQ100/USD," 200,18 ",0.200385," 0,18 "," 5.017,16 "," 4.167,18 ",2818690110,CFD," 0,00 "
30/09/2024 17:33:42,Open Position,NSDQ100/USD," 400,00 ",0.400573," 0,00 "," 5.017,16 "," 3.767,18 ",2818766747,CFD," 0,00 "
30/09/2024 18:36:23,Open Position,NSDQ100/USD," 400,00 ",0.401625," 0,00 "," 5.017,16 "," 3.367,18 ",2818852530,CFD," 0,00 "
30/09/2024 18:44:41,Position closed,NSDQ100/USD," 407,83 ",0.401625," 7,83 "," 5.024,99 "," 3.775,01 ",2818852530,CFD," 0,00 "
30/09/2024 18:50:05,Open Position,NSDQ100/USD," 499,98 ",0.501219," 0,00 "," 5.024,99 "," 3.275,03 ",2818861495,CFD," 0,00 "
30/09/2024 18:59:58,Open Position,NSDQ100/USD," 299,99 ",0.300959," 0,00 "," 5.024,99 "," 2.975,04 ",2818868358,CFD," 0,00 "
30/09/2024 20:34:44,Position closed,NSDQ100/USD," 428,02 ",0.400573," 28,02 "," 5.053,01 "," 3.403,06 ",2818766747,CFD," 0,00 "
30/09/2024 20:34:44,Position closed,NSDQ100/USD," 259,01 ",0.249925," 9,03 "," 5.062,04 "," 3.662,07 ",2818669315,CFD," 0,00 "
30/09/2024 20:34:44,Position closed,NSDQ100/USD," 253,68 ",0.249668," 3,68 "," 5.065,72 "," 3.915,75 ",2818662756,CFD," 0,00 "
30/09/2024 20:34:44,Position closed,NSDQ100/USD," 360,13 ",0.349784," 10,13 "," 5.075,85 "," 4.275,88 ",2818665950,CFD," 0,00 "
30/09/2024 20:34:44,Position closed,NSDQ100/USD," 545,27 ",0.501219," 45,29 "," 5.121,14 "," 4.821,15 ",2818861495,CFD," 0,00 "
30/09/2024 20:34:44,Position closed,NSDQ100/USD," 331,61 ",0.300959," 31,62 "," 5.152,76 "," 5.152,76 ",2818868358,CFD," 0,00 "
30/09/2024 20:50:56,Open Position,NSDQ100/USD," 250,00 ",0.249603," 0,00 "," 5.152,76 "," 4.902,76 ",2818927972,CFD," 0,00 "
30/09/2024 20:56:17,Open Position,NSDQ100/USD," 299,99 ",0.299571," 0,00 "," 5.152,76 "," 4.602,77 ",2818928300,CFD," 0,00 "
01/10/2024 00:34:16,Position closed,NSDQ100/USD," 295,94 ",0.299571,"(4,05)"," 5.148,71 "," 4.898,71 ",2818928300,CFD," 0,00 "
01/10/2024 00:34:33,Position closed,NSDQ100/USD," 247,28 ",0.249603,"(2,72)"," 5.145,99 "," 5.145,99 ",2818927972,CFD," 0,00 "
01/10/2024 00:48:09,Overnight fee,Daily,"(0,01)",-,"(0,01)"," 5.145,98 "," 5.145,98 ",2818928300,CFD," 0,00 "
01/10/2024 00:48:09,Overnight fee,Daily,"(0,01)",-,"(0,01)"," 5.145,97 "," 5.145,97 ",2818927972,CFD," 0,00 "
01/10/2024 05:23:44,Open Position,NSDQ100/USD," 358,00 ",0.357128," 0,00 "," 5.145,97 "," 4.787,97 ",2818950336,CFD," 0,00 "
01/10/2024 08:01:02,Position closed,NSDQ100/USD," 367,46 ",0.357128," 9,46 "," 5.155,43 "," 5.155,43 ",2818950336,CFD," 0,00 "
01/10/2024 08:47:19,Open Position,NSDQ100/USD," 300,00 ",0.299032," 0,00 "," 5.155,43 "," 4.855,43 ",2819104276,CFD," 0,00 "
01/10/2024 09:14:41,Open Position,NSDQ100/USD," 300,00 ",0.299195," 0,00 "," 5.155,43 "," 4.555,43 ",2819111598,CFD," 0,00 "
01/10/2024 10:12:27,Position closed,NSDQ100/USD," 303,58 ",0.299032," 3,58 "," 5.159,01 "," 4.859,01 ",2819104276,CFD," 0,00 "
01/10/2024 10:12:34,Position closed,NSDQ100/USD," 306,67 ",0.299195," 6,67 "," 5.165,68 "," 5.165,68 ",2819111598,CFD," 0,00 "
01/10/2024 10:55:49,Open Position,NSDQ100/USD," 199,99 ",0.199055," 0,00 "," 5.165,68 "," 4.965,69 ",2819240620,CFD," 0,00 "
01/10/2024 10:57:13,Open Position,DJ30/USD," 249,99 ",0.118410," 0,00 "," 5.165,68 "," 4.715,70 ",2819240998,CFD," 0,00 "
01/10/2024 10:57:37,Open Position,RTY/USD," 250,00 ",0.560487," 0,00 "," 5.165,68 "," 4.465,70 ",2819241090,CFD," 0,00 "
01/10/2024 11:05:12,Position closed,RTY/USD," 250,70 ",0.560487," 0,70 "," 5.166,38 "," 4.716,40 ",2819241090,CFD," 0,00 "
01/10/2024 11:05:41,Position closed,NSDQ100/USD," 203,17 ",0.199055," 3,18 "," 5.169,56 "," 4.919,57 ",2819240620,CFD," 0,00 "
01/10/2024 11:28:36,Position closed,DJ30/USD," 250,46 ",0.118410," 0,47 "," 5.170,03 "," 5.170,03 ",2819240998,CFD," 0,00 "
01/10/2024 11:29:11,Open Position,NSDQ100/USD," 249,99 ",0.249064," 0,00 "," 5.170,03 "," 4.920,04 ",2819249761,CFD," 0,00 "
01/10/2024 11:42:27,Open Position,NSDQ100/USD," 449,99 ",0.448741," 0,00 "," 5.170,03 "," 4.470,05 ",2819253868,CFD," 0,00 "
01/10/2024 11:42:42,Open Position,NSDQ100/USD," 100,00 ",0.099727," 0,00 "," 5.170,03 "," 4.370,05 ",2819253885,CFD," 0,00 "
01/10/2024 11:46:39,Open Position,NSDQ100/USD," 149,99 ",0.149543," 0,00 "," 5.170,03 "," 4.220,06 ",2819254760,CFD," 0,00 "
01/10/2024 12:23:57,Position closed,NSDQ100/USD," 452,05 ",0.448741," 2,06 "," 5.172,09 "," 4.672,11 ",2819253868,CFD," 0,00 "
01/10/2024 12:24:21,Open Position,NSDQ100/USD," 250,00 ",0.249181," 0,00 "," 5.172,09 "," 4.422,11 ",2819267122,CFD," 0,00 "
01/10/2024 13:21:20,Open Position,NSDQ100/USD," 399,99 ",0.399275," 0,00 "," 5.172,09 "," 4.022,12 ",2819284208,CFD," 0,00 "
01/10/2024 13:21:43,Open Position,NSDQ100/USD," 199,99 ",0.199644," 0,00 "," 5.172,09 "," 3.822,13 ",2819284286,CFD," 0,00 "
01/10/2024 13:30:30,Position closed,NSDQ100/USD," 406,87 ",0.399275," 6,88 "," 5.178,97 "," 4.229,00 ",2819284208,CFD," 0,00 "
01/10/2024 13:30:39,Position closed,NSDQ100/USD," 202,47 ",0.199644," 2,48 "," 5.181,45 "," 4.431,47 ",2819284286,CFD," 0,00 "
01/10/2024 13:32:17,Open Position,NSDQ100/USD," 350,00 ",0.349385," 0,00 "," 5.181,45 "," 4.081,47 ",2819367970,CFD," 0,00 "
01/10/2024 13:34:22,Open Position,NSDQ100/USD," 499,99 ",0.500702," 0,00 "," 5.181,45 "," 3.581,48 ",2819374492,CFD," 0,00 "
01/10/2024 13:34:44,Open Position,NSDQ100/USD," 349,99 ",0.350711," 0,00 "," 5.181,45 "," 3.231,49 ",2819375771,CFD," 0,00 "
01/10/2024 13:36:54,Open Position,NSDQ100/USD," 349,99 ",0.350895," 0,00 "," 5.181,45 "," 2.881,50 ",2819387453,CFD," 0,00 "
01/10/2024 13:49:01,Open Position,NSDQ100/USD," 400,00 ",0.403357," 0,00 "," 5.181,45 "," 2.481,50 ",2819594682,CFD," 0,00 "
01/10/2024 13:59:23,Open Position,NSDQ100/USD," 250,00 ",0.252150," 0,00 "," 5.181,45 "," 2.231,50 ",2820053482,CFD," 0,00 "
01/10/2024 14:09:41,Open Position,NSDQ100/USD," 559,99 ",0.566700," 0,00 "," 5.181,45 "," 1.671,51 ",2820514630,CFD," 0,00 "
01/10/2024 14:12:48,Open Position,NSDQ100/USD," 299,99 ",0.303938," 0,00 "," 5.181,45 "," 1.371,52 ",2820610032,CFD," 0,00 "
01/10/2024 14:13:34,Position closed,NSDQ100/USD," 302,07 ",0.303938," 2,08 "," 5.183,53 "," 1.673,59 ",2820610032,CFD," 0,00 "
01/10/2024 14:14:32,Open Position,NSDQ100/USD," 200,00 ",0.202568," 0,00 "," 5.183,53 "," 1.473,59 ",2820633571,CFD," 0,00 "
01/10/2024 14:15:17,Open Position,NSDQ100/USD," 149,99 ",0.152048," 0,00 "," 5.183,53 "," 1.323,60 ",2820635628,CFD," 0,00 "
01/10/2024 14:22:01,Position closed,NSDQ100/USD," 151,76 ",0.152048," 1,77 "," 5.185,30 "," 1.475,36 ",2820635628,CFD," 0,00 "
01/10/2024 14:22:31,Open Position,NSDQ100/USD," 149,99 ",0.151937," 0,00 "," 5.185,30 "," 1.325,37 ",2820671837,CFD," 0,00 "
01/10/2024 14:23:33,Position closed,NSDQ100/USD," 563,75 ",0.566700," 3,76 "," 5.189,06 "," 1.889,12 ",2820514630,CFD," 0,00 "
01/10/2024 14:24:49,Position closed,NSDQ100/USD," 150,66 ",0.151937," 0,67 "," 5.189,73 "," 2.039,78 ",2820671837,CFD," 0,00 "
01/10/2024 14:25:16,Open Position,NSDQ100/USD," 509,99 ",0.516481," 0,00 "," 5.189,73 "," 1.529,79 ",2820715613,CFD," 0,00 "
01/10/2024 14:26:28,Open Position,NSDQ100/USD," 390,00 ",0.395400," 0,00 "," 5.189,73 "," 1.139,79 ",2820717409,CFD," 0,00 "
01/10/2024 14:28:51,Open Position,NSDQ100/USD," 299,99 ",0.304933," 0,00 "," 5.189,73 "," 839,80 ",2820722287,CFD," 0,00 "
01/10/2024 14:30:01,Position closed,NSDQ100/USD," 304,43 ",0.304933," 4,44 "," 5.194,17 "," 1.144,23 ",2820722287,CFD," 0,00 "
01/10/2024 14:31:22,Open Position,NSDQ100/USD," 289,99 ",0.294671," 0,00 "," 5.194,17 "," 854,24 ",2820752638,CFD," 0,00 "
01/10/2024 14:34:18,Position closed,NSDQ100/USD," 291,95 ",0.294671," 1,96 "," 5.196,13 "," 1.146,19 ",2820752638,CFD," 0,00 "
01/10/2024 14:35:40,Open Position,NSDQ100/USD," 289,99 ",0.294619," 0,00 "," 5.196,13 "," 856,20 ",2820905219,CFD," 0,00 "
01/10/2024 14:36:35,Position closed,NSDQ100/USD," 297,34 ",0.294619," 7,35 "," 5.203,48 "," 1.153,54 ",2820905219,CFD," 0,00 "
01/10/2024 14:38:20,Position closed,NSDQ100/USD," 385,19 ",0.395400,"(4,81)"," 5.198,67 "," 1.538,73 ",2820717409,CFD," 0,00 "
01/10/2024 14:44:47,Open Position,NSDQ100/USD," 200,00 ",0.202583," 0,00 "," 5.198,67 "," 1.338,73 ",2820930418,CFD," 0,00 "
01/10/2024 14:56:28,Open Position,NSDQ100/USD," 249,99 ",0.253569," 0,00 "," 5.198,67 "," 1.088,74 ",2821216188,CFD," 0,00 "
01/10/2024 15:14:29,Open Position,NSDQ100/USD," 349,99 ",0.356505," 0,00 "," 5.198,67 "," 738,75 ",2821623640,CFD," 0,00 "
01/10/2024 15:21:41,Position closed,NSDQ100/USD," 345,59 ",0.356505,"(4,40)"," 5.194,27 "," 1.084,34 ",2821623640,CFD," 0,00 "
01/10/2024 15:27:58,Open Position,NSDQ100/USD," 279,99 ",0.284752," 0,00 "," 5.194,27 "," 804,35 ",2821746102,CFD," 0,00 "
01/10/2024 15:28:24,Position closed,NSDQ100/USD," 280,00 ",0.284752," 0,01 "," 5.194,28 "," 1.084,35 ",2821746102,CFD," 0,00 "
01/10/2024 15:33:06,Open Position,NSDQ100/USD," 250,00 ",0.253872," 0,00 "," 5.194,28 "," 834,35 ",2821760231,CFD," 0,00 "
01/10/2024 15:33:42,Position closed,NSDQ100/USD," 251,33 ",0.253872," 1,33 "," 5.195,61 "," 1.085,68 ",2821760231,CFD," 0,00 "
01/10/2024 15:41:36,Position closed,NSDQ100/USD," 255,27 ",0.253569," 5,28 "," 5.200,89 "," 1.340,95 ",2821216188,CFD," 0,00 "
01/10/2024 15:43:04,Position closed,NSDQ100/USD," 517,50 ",0.516481," 7,51 "," 5.208,40 "," 1.858,45 ",2820715613,CFD," 0,00 "
01/10/2024 15:43:20,Position closed,NSDQ100/USD," 202,56 ",0.202568," 2,56 "," 5.210,96 "," 2.061,01 ",2820633571,CFD," 0,00 "
01/10/2024 15:45:55,Open Position,NSDQ100/USD," 200,00 ",0.202576," 0,00 "," 5.210,96 "," 1.861,01 ",2821786383,CFD," 0,00 "
01/10/2024 16:05:18,Position closed,NSDQ100/USD," 201,83 ",0.202583," 1,83 "," 5.212,79 "," 2.062,84 ",2820930418,CFD," 0,00 "
01/10/2024 16:17:00,Position closed,NSDQ100/USD," 202,11 ",0.202576," 2,11 "," 5.214,90 "," 2.264,95 ",2821786383,CFD," 0,00 "
01/10/2024 16:29:15,Open Position,NSDQ100/USD," 250,00 ",0.253228," 0,00 "," 5.214,90 "," 2.014,95 ",2822107609,CFD," 0,00 "
01/10/2024 17:09:17,Open Position,NSDQ100/USD," 349,99 ",0.355672," 0,00 "," 5.214,90 "," 1.664,96 ",2822146345,CFD," 0,00 "
01/10/2024 17:09:29,Open Position,NSDQ100/USD," 149,99 ",0.152410," 0,00 "," 5.214,90 "," 1.514,97 ",2822146479,CFD," 0,00 "
01/10/2024 17:31:38,Open Position,NSDQ100/USD," 400,00 ",0.406582," 0,00 "," 5.214,90 "," 1.114,97 ",2822173498,CFD," 0,00 "
01/10/2024 18:06:31,Position closed,NSDQ100/USD," 268,09 ",0.253228," 18,09 "," 5.232,99 "," 1.383,06 ",2822107609,CFD," 0,00 "
01/10/2024 18:06:38,Position closed,NSDQ100/USD," 245,92 ",0.252150,"(4,08)"," 5.228,91 "," 1.628,98 ",2820053482,CFD," 0,00 "
01/10/2024 18:06:50,Position closed,NSDQ100/USD," 395,03 ",0.355672," 45,04 "," 5.273,95 "," 2.024,01 ",2822146345,CFD," 0,00 "
01/10/2024 18:07:30,Position closed,NSDQ100/USD," 168,80 ",0.152410," 18,81 "," 5.292,76 "," 2.192,81 ",2822146479,CFD," 0,00 "
01/10/2024 18:07:37,Position closed,NSDQ100/USD," 389,61 ",0.403357,"(10,39)"," 5.282,37 "," 2.582,42 ",2819594682,CFD," 0,00 "
01/10/2024 18:07:45,Position closed,NSDQ100/USD," 453,16 ",0.406582," 53,16 "," 5.335,53 "," 3.035,58 ",2822173498,CFD," 0,00 "
01/10/2024 18:09:11,Open Position,NSDQ100/USD," 299,99 ",0.302759," 0,00 "," 5.335,53 "," 2.735,59 ",2822251347,CFD," 0,00 "
01/10/2024 18:16:13,Position closed,NSDQ100/USD," 306,02 ",0.302759," 6,03 "," 5.341,56 "," 3.041,61 ",2822251347,CFD," 0,00 "
01/10/2024 18:16:24,Open Position,NSDQ100/USD," 499,99 ",0.503850," 0,00 "," 5.341,56 "," 2.541,62 ",2822279899,CFD," 0,00 "
01/10/2024 18:22:16,Position closed,NSDQ100/USD," 494,11 ",0.503850,"(5,88)"," 5.335,68 "," 3.035,73 ",2822279899,CFD," 0,00 "
01/10/2024 18:54:24,Position closed,NSDQ100/USD," 424,09 ",0.500702,"(75,90)"," 5.259,78 "," 3.459,82 ",2819374492,CFD," 0,00 "
01/10/2024 18:59:55,Open Position,NSDQ100/USD," 299,98 ",0.302259," 0,00 "," 5.259,78 "," 3.159,84 ",2822412483,CFD," 0,00 "
01/10/2024 19:17:47,Open Position,NSDQ100/USD," 300,00 ",0.302792," 0,00 "," 5.259,78 "," 2.859,84 ",2822429331,CFD," 0,00 "
01/10/2024 19:36:52,Position closed,NSDQ100/USD," 309,54 ",0.302792," 9,54 "," 5.269,32 "," 3.169,38 ",2822429331,CFD," 0,00 "
01/10/2024 19:37:22,Open Position,NSDQ100/USD," 799,99 ",0.809043," 0,00 "," 5.269,32 "," 2.369,39 ",2822438679,CFD," 0,00 "
01/10/2024 19:37:35,Position closed,NSDQ100/USD," 794,43 ",0.809043,"(5,56)"," 5.263,76 "," 3.163,82 ",2822438679,CFD," 0,00 "
01/10/2024 19:37:46,Open Position,NSDQ100/USD," 800,00 ",0.809271," 0,00 "," 5.263,76 "," 2.363,82 ",2822442864,CFD," 0,00 "
01/10/2024 19:38:22,Open Position,NSDQ100/USD," 500,00 ",0.505968," 0,00 "," 5.263,76 "," 1.863,82 ",2822443130,CFD," 0,00 "
01/10/2024 19:50:57,Open Position,NSDQ100/USD," 299,98 ",0.303352," 0,00 "," 5.263,76 "," 1.563,84 ",2822453357,CFD," 0,00 "
01/10/2024 19:51:31,Open Position,NSDQ100/USD," 299,99 ",0.303282," 0,00 "," 5.263,76 "," 1.263,85 ",2822453679,CFD," 0,00 "
01/10/2024 20:31:42,Position closed,NSDQ100/USD," 304,19 ",0.303352," 4,21 "," 5.267,97 "," 1.568,04 ",2822453357,CFD," 0,00 "
01/10/2024 20:32:51,Position closed,NSDQ100/USD," 805,41 ",0.809271," 5,41 "," 5.273,38 "," 2.373,45 ",2822442864,CFD," 0,00 "
01/10/2024 20:33:59,Position closed,NSDQ100/USD," 501,41 ",0.505968," 1,41 "," 5.274,79 "," 2.874,86 ",2822443130,CFD," 0,00 "
01/10/2024 20:34:16,Open Position,NSDQ100/USD," 249,99 ",0.253022," 0,00 "," 5.274,79 "," 2.624,87 ",2822468499,CFD," 0,00 "
01/10/2024 20:34:26,Open Position,NSDQ100/USD," 660,00 ",0.668160," 0,00 "," 5.274,79 "," 1.964,87 ",2822468518,CFD," 0,00 "
01/10/2024 20:34:46,Position closed,NSDQ100/USD," 248,74 ",0.253022,"(1,25)"," 5.273,54 "," 2.213,61 ",2822468499,CFD," 0,00 "
01/10/2024 20:35:00,Open Position,NSDQ100/USD," 250,00 ",0.253084," 0,00 "," 5.273,54 "," 1.963,61 ",2822468586,CFD," 0,00 "
01/10/2024 20:44:43,Position closed,NSDQ100/USD," 251,33 ",0.253084," 1,33 "," 5.274,87 "," 2.214,94 ",2822468586,CFD," 0,00 "
01/10/2024 20:44:51,Position closed,NSDQ100/USD," 663,63 ",0.668160," 3,63 "," 5.278,50 "," 2.878,57 ",2822468518,CFD," 0,00 "
01/10/2024 20:45:19,Open Position,NSDQ100/USD," 720,00 ",0.729349," 0,00 "," 5.278,50 "," 2.158,57 ",2822470201,CFD," 0,00 "
01/10/2024 20:45:30,Open Position,NSDQ100/USD," 250,00 ",0.253252," 0,00 "," 5.278,50 "," 1.908,57 ",2822470221,CFD," 0,00 "
01/10/2024 20:47:54,Open Position,NSDQ100/USD," 479,99 ",0.486135," 0,00 "," 5.278,50 "," 1.428,58 ",2822470834,CFD," 0,00 "
01/10/2024 22:00:36,Position closed,NSDQ100/USD," 489,54 ",0.486135," 9,55 "," 5.288,05 "," 1.918,12 ",2822470834,CFD," 0,00 "
01/10/2024 22:00:36,Open Position,NSDQ100/USD," 250,00 ",0.252944," 0,00 "," 5.288,05 "," 1.668,12 ",2822477406,CFD," 0,00 "
01/10/2024 22:31:02,Position closed,NSDQ100/USD," 261,80 ",0.252944," 11,80 "," 5.299,85 "," 1.929,92 ",2822477406,CFD," 0,00 "
01/10/2024 22:31:09,Position closed,NSDQ100/USD," 255,73 ",0.253252," 5,73 "," 5.305,58 "," 2.185,65 ",2822470221,CFD," 0,00 "
01/10/2024 22:31:25,Position closed,NSDQ100/USD," 735,42 ",0.729349," 15,42 "," 5.321,00 "," 2.921,07 ",2822470201,CFD," 0,00 "
01/10/2024 22:32:20,Open Position,NSDQ100/USD," 399,99 ",0.405591," 0,00 "," 5.321,00 "," 2.521,08 ",2822479964,CFD," 0,00 "
01/10/2024 22:34:23,Position closed,NSDQ100/USD," 397,69 ",0.405591,"(2,30)"," 5.318,70 "," 2.918,77 ",2822479964,CFD," 0,00 "
01/10/2024 22:34:43,Open Position,NSDQ100/USD," 699,99 ",0.709839," 0,00 "," 5.318,70 "," 2.218,78 ",2822480085,CFD," 0,00 "
01/10/2024 22:35:04,Position closed,NSDQ100/USD," 698,39 ",0.709839,"(1,60)"," 5.317,10 "," 2.917,17 ",2822480085,CFD," 0,00 "
01/10/2024 22:35:17,Open Position,NSDQ100/USD," 730,00 ",0.740304," 0,00 "," 5.317,10 "," 2.187,17 ",2822480110,CFD," 0,00 "
01/10/2024 22:37:32,Open Position,NSDQ100/USD," 249,99 ",0.253389," 0,00 "," 5.317,10 "," 1.937,18 ",2822480243,CFD," 0,00 "
01/10/2024 22:41:45,Position closed,NSDQ100/USD," 724,48 ",0.740304,"(5,52)"," 5.311,58 "," 2.661,66 ",2822480110,CFD," 0,00 "
01/10/2024 22:44:51,Open Position,NSDQ100/USD," 250,00 ",0.253869," 0,00 "," 5.311,58 "," 2.411,66 ",2822480605,CFD," 0,00 "
01/10/2024 22:47:02,Open Position,NSDQ100/USD," 250,00 ",0.253741," 0,00 "," 5.311,58 "," 2.161,66 ",2822480763,CFD," 0,00 "
02/10/2024 00:48:31,Overnight fee,Daily,"(0,01)",-,"(0,01)"," 5.311,57 "," 2.161,65 ",2822470221,CFD," 0,00 "
02/10/2024 00:48:31,Overnight fee,Daily,"(0,02)",-,"(0,02)"," 5.311,55 "," 2.161,63 ",2822470201,CFD," 0,00 "
02/10/2024 00:48:31,Overnight fee,Daily,"(0,51)",-,"(0,51)"," 5.311,04 "," 2.161,12 ",2819253885,CFD," 0,00 "
02/10/2024 00:48:31,Overnight fee,Daily,"(0,77)",-,"(0,77)"," 5.310,27 "," 2.160,35 ",2819254760,CFD," 0,00 "
02/10/2024 00:48:31,Overnight fee,Daily,"(1,28)",-,"(1,28)"," 5.308,99 "," 2.159,07 ",2819267122,CFD," 0,00 "
02/10/2024 00:48:31,Overnight fee,Daily,"(1,28)",-,"(1,28)"," 5.307,71 "," 2.157,79 ",2819249761,CFD," 0,00 "
02/10/2024 00:48:31,Overnight fee,Daily,"(1,55)",-,"(1,55)"," 5.306,16 "," 2.156,24 ",2822412483,CFD," 0,00 "
02/10/2024 00:48:31,Overnight fee,Daily,"(1,55)",-,"(1,55)"," 5.304,61 "," 2.154,69 ",2822453679,CFD," 0,00 "
02/10/2024 00:48:31,Overnight fee,Daily,"(1,79)",-,"(1,79)"," 5.302,82 "," 2.152,90 ",2819367970,CFD," 0,00 "
02/10/2024 00:48:31,Overnight fee,Daily,"(1,80)",-,"(1,80)"," 5.301,02 "," 2.151,10 ",2819375771,CFD," 0,00 "
02/10/2024 00:48:31,Overnight fee,Daily,"(1,80)",-,"(1,80)"," 5.299,22 "," 2.149,30 ",2819387453,CFD," 0,00 "
02/10/2024 00:48:31,Overnight fee,Daily,"(2,49)",-,"(2,49)"," 5.296,73 "," 2.146,81 ",2822470834,CFD," 0,00 "
02/10/2024 06:13:39,Open Position,NSDQ100/USD," 300,00 ",0.304406," 0,00 "," 5.296,73 "," 1.846,81 ",2822542921,CFD," 0,00 "
02/10/2024 07:07:34,Position closed,NSDQ100/USD," 303,06 ",0.304406," 3,06 "," 5.299,79 "," 2.149,87 ",2822542921,CFD," 0,00 "
02/10/2024 07:13:14,Open Position,NSDQ100/USD," 540,00 ",0.547581," 0,00 "," 5.299,79 "," 1.609,87 ",2822612956,CFD," 0,00 "
02/10/2024 07:55:52,Position closed,NSDQ100/USD," 558,86 ",0.547581," 18,86 "," 5.318,65 "," 2.168,73 ",2822612956,CFD," 0,00 "
02/10/2024 07:58:22,Open Position,NSDQ100/USD," 249,99 ",0.253026," 0,00 "," 5.318,65 "," 1.918,74 ",2822656812,CFD," 0,00 "
02/10/2024 08:00:58,Position closed,NSDQ100/USD," 250,58 ",0.253389," 0,59 "," 5.319,24 "," 2.169,32 ",2822480243,CFD," 0,00 "
02/10/2024 08:02:08,Open Position,NSDQ100/USD," 199,99 ",0.202698," 0,00 "," 5.319,24 "," 1.969,33 ",2822657692,CFD," 0,00 "
02/10/2024 08:03:05,Position closed,NSDQ100/USD," 200,42 ",0.202698," 0,43 "," 5.319,67 "," 2.169,75 ",2822657692,CFD," 0,00 "
02/10/2024 08:31:03,Open Position,NSDQ100/USD," 300,00 ",0.303807," 0,00 "," 5.319,67 "," 1.869,75 ",2822668244,CFD," 0,00 "
02/10/2024 08:34:26,Position closed,NSDQ100/USD," 301,74 ",0.303807," 1,74 "," 5.321,41 "," 2.171,49 ",2822668244,CFD," 0,00 "
02/10/2024 08:46:38,Open Position,NSDQ100/USD," 300,00 ",0.303865," 0,00 "," 5.321,41 "," 1.871,49 ",2822673779,CFD," 0,00 "
02/10/2024 09:10:41,Open Position,NSDQ100/USD," 350,00 ",0.355034," 0,00 "," 5.321,41 "," 1.521,49 ",2822679096,CFD," 0,00 "
02/10/2024 09:30:51,Position closed,NSDQ100/USD," 352,22 ",0.355034," 2,22 "," 5.323,63 "," 1.873,71 ",2822679096,CFD," 0,00 "
02/10/2024 09:33:36,Open Position,NSDQ100/USD," 249,99 ",0.253439," 0,00 "," 5.323,63 "," 1.623,72 ",2822684379,CFD," 0,00 "
02/10/2024 09:55:58,Position closed,NSDQ100/USD," 249,25 ",0.253741,"(0,75)"," 5.322,88 "," 1.872,97 ",2822480763,CFD," 0,00 "
02/10/2024 09:59:18,Open Position,NSDQ100/USD," 249,99 ",0.253710," 0,00 "," 5.322,88 "," 1.622,98 ",2822690083,CFD," 0,00 "
02/10/2024 10:09:08,Position closed,NSDQ100/USD," 253,08 ",0.253869," 3,08 "," 5.325,96 "," 1.876,06 ",2822480605,CFD," 0,00 "
02/10/2024 10:11:12,Position closed,NSDQ100/USD," 244,04 ",0.253710,"(5,95)"," 5.320,01 "," 2.120,10 ",2822690083,CFD," 0,00 "
02/10/2024 10:12:29,Open Position,NSDQ100/USD," 300,00 ",0.304870," 0,00 "," 5.320,01 "," 1.820,10 ",2822694003,CFD," 0,00 "
02/10/2024 10:27:06,Position closed,NSDQ100/USD," 309,34 ",0.304870," 9,34 "," 5.329,35 "," 2.129,44 ",2822694003,CFD," 0,00 "
02/10/2024 10:27:46,Position closed,NSDQ100/USD," 246,02 ",0.253439,"(3,97)"," 5.325,38 "," 2.375,46 ",2822684379,CFD," 0,00 "
02/10/2024 10:35:07,Position closed,NSDQ100/USD," 300,13 ",0.303865," 0,13 "," 5.325,51 "," 2.675,59 ",2822673779,CFD," 0,00 "
02/10/2024 10:36:35,Open Position,NSDQ100/USD," 500,00 ",0.506415," 0,00 "," 5.325,51 "," 2.175,59 ",2822700093,CFD," 0,00 "
02/10/2024 10:36:58,Position closed,NSDQ100/USD," 102,17 ",0.149543,"(47,82)"," 5.277,69 "," 2.277,76 ",2819254760,CFD," 0,00 "
02/10/2024 10:37:06,Position closed,NSDQ100/USD," 68,56 ",0.099727,"(31,44)"," 5.246,25 "," 2.346,32 ",2819253885,CFD," 0,00 "
02/10/2024 10:37:14,Open Position,NSDQ100/USD," 299,99 ",0.303957," 0,00 "," 5.246,25 "," 2.046,33 ",2822700308,CFD," 0,00 "
02/10/2024 10:38:24,Position closed,NSDQ100/USD," 170,56 ",0.249181,"(79,44)"," 5.166,81 "," 2.216,89 ",2819267122,CFD," 0,00 "
02/10/2024 10:38:36,Open Position,NSDQ100/USD," 299,99 ",0.303898," 0,00 "," 5.166,81 "," 1.916,90 ",2822700688,CFD," 0,00 "
02/10/2024 10:38:54,Position closed,NSDQ100/USD," 166,61 ",0.249064,"(83,38)"," 5.083,43 "," 2.083,51 ",2819249761,CFD," 0,00 "
02/10/2024 10:40:06,Position closed,NSDQ100/USD," 248,35 ",0.349385,"(101,65)"," 4.981,78 "," 2.331,86 ",2819367970,CFD," 0,00 "
02/10/2024 10:42:54,Position closed,NSDQ100/USD," 502,65 ",0.506415," 2,65 "," 4.984,43 "," 2.834,51 ",2822700093,CFD," 0,00 "
02/10/2024 10:44:01,Open Position,NSDQ100/USD," 299,99 ",0.304006," 0,00 "," 4.984,43 "," 2.534,52 ",2822702947,CFD," 0,00 "
02/10/2024 10:51:28,Open Position,NSDQ100/USD," 150,00 ",0.151872," 0,00 "," 4.984,43 "," 2.384,52 ",2822705053,CFD," 0,00 "
02/10/2024 10:52:44,Position closed,NSDQ100/USD," 249,82 ",0.253026,"(0,17)"," 4.984,26 "," 2.634,34 ",2822656812,CFD," 0,00 "
02/10/2024 10:55:05,Position closed,NSDQ100/USD," 278,82 ",0.350711,"(71,17)"," 4.913,09 "," 2.913,16 ",2819375771,CFD," 0,00 "
02/10/2024 10:55:52,Open Position,NSDQ100/USD," 299,99 ",0.303797," 0,00 "," 4.913,09 "," 2.613,17 ",2822706274,CFD," 0,00 "
02/10/2024 11:01:44,Position closed,NSDQ100/USD," 279,63 ",0.350895,"(70,36)"," 4.842,73 "," 2.892,80 ",2819387453,CFD," 0,00 "
02/10/2024 11:02:38,Position closed,NSDQ100/USD," 301,19 ",0.303797," 1,20 "," 4.843,93 "," 3.193,99 ",2822706274,CFD," 0,00 "
02/10/2024 11:03:29,Open Position,NSDQ100/USD," 300,00 ",0.303777," 0,00 "," 4.843,93 "," 2.893,99 ",2822709314,CFD," 0,00 "
02/10/2024 11:05:14,Position closed,NSDQ100/USD," 298,58 ",0.303777,"(1,42)"," 4.842,51 "," 3.192,57 ",2822709314,CFD," 0,00 "
02/10/2024 11:06:31,Open Position,XAU/USD," 299,99 ",2.264885," 0,00 "," 4.842,51 "," 2.892,58 ",2822709873,CFD," 0,00 "
02/10/2024 11:08:08,Position closed,NSDQ100/USD," 261,44 ",0.302259,"(38,54)"," 4.803,97 "," 3.154,02 ",2822412483,CFD," 0,00 "
02/10/2024 11:08:26,Position closed,NSDQ100/USD," 153,62 ",0.151872," 3,62 "," 4.807,59 "," 3.307,64 ",2822705053,CFD," 0,00 "
02/10/2024 11:08:31,Position closed,NSDQ100/USD," 302,46 ",0.304006," 2,47 "," 4.810,06 "," 3.610,10 ",2822702947,CFD," 0,00 "
02/10/2024 11:08:47,Position closed,NSDQ100/USD," 281,88 ",0.303282,"(18,11)"," 4.791,95 "," 3.891,98 ",2822453679,CFD," 0,00 "
02/10/2024 11:09:41,Position closed,NSDQ100/USD," 304,56 ",0.303957," 4,57 "," 4.796,52 "," 4.196,54 ",2822700308,CFD," 0,00 "
02/10/2024 11:09:41,Position closed,NSDQ100/USD," 305,72 ",0.303898," 5,73 "," 4.802,25 "," 4.502,26 ",2822700688,CFD," 0,00 "
02/10/2024 11:10:24,Open Position,NSDQ100/USD," 299,99 ",0.304214," 0,00 "," 4.802,25 "," 4.202,27 ",2822710877,CFD," 0,00 "
02/10/2024 11:11:18,Open Position,NSDQ100/USD," 399,99 ",0.405431," 0,00 "," 4.802,25 "," 3.802,28 ",2822711145,CFD," 0,00 "
02/10/2024 11:14:09,Position closed,NSDQ100/USD," 291,33 ",0.304214,"(8,66)"," 4.793,59 "," 4.093,61 ",2822710877,CFD," 0,00 "
02/10/2024 11:14:09,Position closed,NSDQ100/USD," 406,61 ",0.405431," 6,62 "," 4.800,21 "," 4.500,22 ",2822711145,CFD," 0,00 "
02/10/2024 11:14:34,Position closed,XAU/USD," 300,35 ",2.264885," 0,36 "," 4.800,57 "," 4.800,57 ",2822709873,CFD," 0,00 "
02/10/2024 11:15:17,Open Position,NSDQ100/USD," 400,00 ",0.405128," 0,00 "," 4.800,57 "," 4.400,57 ",2822712382,CFD," 0,00 "
02/10/2024 11:18:05,Position closed,NSDQ100/USD," 403,22 ",0.405128," 3,22 "," 4.803,79 "," 4.803,79 ",2822712382,CFD," 0,00 "
02/10/2024 11:19:23,Open Position,NSDQ100/USD," 299,99 ",0.304081," 0,00 "," 4.803,79 "," 4.503,80 ",2822713560,CFD," 0,00 "
02/10/2024 11:19:46,Open Position,NSDQ100/USD," 200,00 ",0.202711," 0,00 "," 4.803,79 "," 4.303,80 ",2822713705,CFD," 0,00 "
02/10/2024 11:20:04,Open Position,NSDQ100/USD," 200,00 ",0.202774," 0,00 "," 4.803,79 "," 4.103,80 ",2822713763,CFD," 0,00 "
02/10/2024 11:30:52,Open Position,NSDQ100/USD," 250,00 ",0.253100," 0,00 "," 4.803,79 "," 3.853,80 ",2822721202,CFD," 0,00 "
02/10/2024 11:34:33,Position closed,NSDQ100/USD," 250,82 ",0.253100," 0,82 "," 4.804,61 "," 4.104,62 ",2822721202,CFD," 0,00 "
02/10/2024 11:41:04,Open Position,NSDQ100/USD," 200,00 ",0.202345," 0,00 "," 4.804,61 "," 3.904,62 ",2822723804,CFD," 0,00 "
02/10/2024 11:41:41,Open Position,XAU/USD," 400,00 ",3.016284," 0,00 "," 4.804,61 "," 3.504,62 ",2822724076,CFD," 0,00 "
02/10/2024 11:48:53,Position closed,NSDQ100/USD," 200,76 ",0.202345," 0,76 "," 4.805,37 "," 3.705,38 ",2822723804,CFD," 0,00 "
02/10/2024 11:51:11,Open Position,NSDQ100/USD," 200,00 ",0.202563," 0,00 "," 4.805,37 "," 3.505,38 ",2822726469,CFD," 0,00 "
02/10/2024 11:58:12,Position closed,NSDQ100/USD," 202,97 ",0.202563," 2,97 "," 4.808,34 "," 3.708,35 ",2822726469,CFD," 0,00 "
02/10/2024 11:58:27,Position closed,NSDQ100/USD," 199,95 ",0.202711,"(0,05)"," 4.808,29 "," 3.908,30 ",2822713705,CFD," 0,00 "
02/10/2024 11:59:13,Position closed,NSDQ100/USD," 299,70 ",0.304081,"(0,29)"," 4.808,00 "," 4.208,00 ",2822713560,CFD," 0,00 "
02/10/2024 12:10:37,Open Position,XAU/USD," 250,00 ",1.886885," 0,00 "," 4.808,00 "," 3.958,00 ",2822735080,CFD," 0,00 "
02/10/2024 12:10:52,Open Position,XAU/USD," 150,00 ",1.132126," 0,00 "," 4.808,00 "," 3.808,00 ",2822735164,CFD," 0,00 "
02/10/2024 12:12:53,Open Position,NSDQ100/USD," 349,99 ",0.354604," 0,00 "," 4.808,00 "," 3.458,01 ",2822735787,CFD," 0,00 "
02/10/2024 12:26:20,Open Position,NSDQ100/USD," 200,00 ",0.202568," 0,00 "," 4.808,00 "," 3.258,01 ",2822741234,CFD," 0,00 "
02/10/2024 12:29:38,Position closed,NSDQ100/USD," 199,24 ",0.202774,"(0,76)"," 4.807,24 "," 3.457,25 ",2822713763,CFD," 0,00 "
02/10/2024 12:29:38,Position closed,NSDQ100/USD," 203,31 ",0.202568," 3,31 "," 4.810,55 "," 3.660,56 ",2822741234,CFD," 0,00 "
02/10/2024 12:29:38,Position closed,NSDQ100/USD," 353,62 ",0.354604," 3,63 "," 4.814,18 "," 4.014,18 ",2822735787,CFD," 0,00 "
02/10/2024 12:29:54,Open Position,XAU/USD," 299,99 ",2.267462," 0,00 "," 4.814,18 "," 3.714,19 ",2822742138,CFD," 0,00 "
02/10/2024 12:35:21,Position closed,XAU/USD," 253,25 ",1.886885," 3,25 "," 4.817,43 "," 3.967,44 ",2822735080,CFD," 0,00 "
02/10/2024 12:35:21,Position closed,XAU/USD," 151,94 ",1.132126," 1,94 "," 4.819,37 "," 4.119,38 ",2822735164,CFD," 0,00 "
02/10/2024 12:35:21,Position closed,XAU/USD," 397,92 ",3.016284,"(2,08)"," 4.817,29 "," 4.517,30 ",2822724076,CFD," 0,00 "
02/10/2024 12:35:21,Position closed,XAU/USD," 312,35 ",2.267462," 12,36 "," 4.829,65 "," 4.829,65 ",2822742138,CFD," 0,00 "
02/10/2024 12:35:55,Open Position,XAU/USD," 250,00 ",1.884964," 0,00 "," 4.829,65 "," 4.579,65 ",2822743693,CFD," 0,00 "
02/10/2024 12:36:32,Open Position,NSDQ100/USD," 299,99 ",0.303723," 0,00 "," 4.829,65 "," 4.279,66 ",2822744307,CFD," 0,00 "
02/10/2024 12:55:33,Open Position,NSDQ100/USD," 299,99 ",0.303227," 0,00 "," 4.829,65 "," 3.979,67 ",2822750188,CFD," 0,00 "
02/10/2024 12:58:07,Position closed,NSDQ100/USD," 302,15 ",0.303227," 2,16 "," 4.831,81 "," 4.281,82 ",2822750188,CFD," 0,00 "
02/10/2024 12:58:24,Open Position,NSDQ100/USD," 200,00 ",0.202308," 0,00 "," 4.831,81 "," 4.081,82 ",2822750910,CFD," 0,00 "
02/10/2024 13:01:37,Position closed,NSDQ100/USD," 203,08 ",0.202308," 3,08 "," 4.834,89 "," 4.284,90 ",2822750910,CFD," 0,00 "
02/10/2024 13:02:46,Open Position,XAU/USD," 250,00 ",1.886885," 0,00 "," 4.834,89 "," 4.034,90 ",2822751911,CFD," 0,00 "
02/10/2024 13:03:46,Position closed,NSDQ100/USD," 301,73 ",0.303723," 1,74 "," 4.836,63 "," 4.336,63 ",2822744307,CFD," 0,00 "
02/10/2024 13:04:12,Open Position,NSDQ100/USD," 249,99 ",0.253209," 0,00 "," 4.836,63 "," 4.086,64 ",2822752342,CFD," 0,00 "
02/10/2024 13:04:23,Open Position,NSDQ100/USD," 299,99 ",0.303912," 0,00 "," 4.836,63 "," 3.786,65 ",2822752373,CFD," 0,00 "
02/10/2024 13:04:43,Position closed,XAU/USD," 248,10 ",1.884964,"(1,90)"," 4.834,73 "," 4.034,75 ",2822743693,CFD," 0,00 "
02/10/2024 13:04:47,Position closed,XAU/USD," 253,57 ",1.886885," 3,57 "," 4.838,30 "," 4.288,32 ",2822751911,CFD," 0,00 "
02/10/2024 13:05:57,Open Position,NSDQ100/USD," 349,99 ",0.354410," 0,00 "," 4.838,30 "," 3.938,33 ",2822752922,CFD," 0,00 "
02/10/2024 13:06:09,Open Position,NSDQ100/USD," 300,00 ",0.303683," 0,00 "," 4.838,30 "," 3.638,33 ",2822752952,CFD," 0,00 "
02/10/2024 13:06:32,Position closed,NSDQ100/USD," 300,35 ",0.303683," 0,35 "," 4.838,65 "," 3.938,68 ",2822752952,CFD," 0,00 "
02/10/2024 13:07:25,Position closed,NSDQ100/USD," 253,75 ",0.253209," 3,76 "," 4.842,41 "," 4.192,43 ",2822752342,CFD," 0,00 "
02/10/2024 13:07:29,Position closed,NSDQ100/USD," 292,86 ",0.303912,"(7,13)"," 4.835,28 "," 4.485,29 ",2822752373,CFD," 0,00 "
02/10/2024 13:07:46,Open Position,NSDQ100/USD," 249,99 ",0.252961," 0,00 "," 4.835,28 "," 4.235,30 ",2822753452,CFD," 0,00 "
02/10/2024 13:08:58,Open Position,NSDQ100/USD," 349,99 ",0.354401," 0,00 "," 4.835,28 "," 3.885,31 ",2822753727,CFD," 0,00 "
02/10/2024 13:10:01,Position closed,NSDQ100/USD," 351,81 ",0.354401," 1,82 "," 4.837,10 "," 4.237,12 ",2822753727,CFD," 0,00 "
02/10/2024 13:10:06,Position closed,NSDQ100/USD," 351,63 ",0.354410," 1,64 "," 4.838,74 "," 4.588,75 ",2822752922,CFD," 0,00 "
02/10/2024 13:10:43,Open Position,NSDQ100/USD," 349,99 ",0.354577," 0,00 "," 4.838,74 "," 4.238,76 ",2822754144,CFD," 0,00 "
02/10/2024 13:10:55,Open Position,NSDQ100/USD," 250,00 ",0.253239," 0,00 "," 4.838,74 "," 3.988,76 ",2822754216,CFD," 0,00 "
02/10/2024 13:14:12,Position closed,NSDQ100/USD," 250,26 ",0.253239," 0,26 "," 4.839,00 "," 4.239,02 ",2822754216,CFD," 0,00 "
02/10/2024 13:18:11,Position closed,NSDQ100/USD," 351,92 ",0.354577," 1,93 "," 4.840,93 "," 4.590,94 ",2822754144,CFD," 0,00 "
02/10/2024 13:19:08,Open Position,NSDQ100/USD," 249,99 ",0.253346," 0,00 "," 4.840,93 "," 4.340,95 ",2822756554,CFD," 0,00 "
02/10/2024 13:19:37,Open Position,NSDQ100/USD," 299,99 ",0.304072," 0,00 "," 4.840,93 "," 4.040,96 ",2822756645,CFD," 0,00 "
02/10/2024 13:22:11,Position closed,NSDQ100/USD," 249,19 ",0.253346,"(0,80)"," 4.840,13 "," 4.290,15 ",2822756554,CFD," 0,00 "
02/10/2024 13:26:20,Open Position,NSDQ100/USD," 400,00 ",0.405578," 0,00 "," 4.840,13 "," 3.890,15 ",2822758511,CFD," 0,00 "
02/10/2024 13:27:05,Position closed,NSDQ100/USD," 301,16 ",0.304072," 1,17 "," 4.841,30 "," 4.191,31 ",2822756645,CFD," 0,00 "
02/10/2024 13:34:56,Open Position,NSDQ100/USD," 299,99 ",0.303886," 0,00 "," 4.841,30 "," 3.891,32 ",2822847978,CFD," 0,00 "
02/10/2024 13:39:42,Position closed,NSDQ100/USD," 416,06 ",0.405578," 16,06 "," 4.857,36 "," 4.307,38 ",2822758511,CFD," 0,00 "
02/10/2024 13:40:13,Open Position,NSDQ100/USD," 250,00 ",0.253944," 0,00 "," 4.857,36 "," 4.057,38 ",2822862315,CFD," 0,00 "
02/10/2024 13:42:06,Open Position,NSDQ100/USD," 299,99 ",0.305059," 0,00 "," 4.857,36 "," 3.757,39 ",2822867456,CFD," 0,00 "
02/10/2024 13:43:45,Open Position,NSDQ100/USD," 149,99 ",0.152688," 0,00 "," 4.857,36 "," 3.607,40 ",2822871256,CFD," 0,00 "
02/10/2024 13:45:28,Open Position,NSDQ100/USD," 149,99 ",0.152708," 0,00 "," 4.857,36 "," 3.457,41 ",2822876696,CFD," 0,00 "
02/10/2024 14:00:23,Position closed,NSDQ100/USD," 158,47 ",0.152708," 8,48 "," 4.865,84 "," 3.615,88 ",2822876696,CFD," 0,00 "
02/10/2024 14:00:27,Position closed,NSDQ100/USD," 311,23 ",0.305059," 11,24 "," 4.877,08 "," 3.927,11 ",2822867456,CFD," 0,00 "
02/10/2024 14:00:42,Position closed,NSDQ100/USD," 161,60 ",0.152688," 11,61 "," 4.888,69 "," 4.088,71 ",2822871256,CFD," 0,00 "
02/10/2024 14:01:15,Position closed,NSDQ100/USD," 257,81 ",0.253944," 7,81 "," 4.896,50 "," 4.346,52 ",2822862315,CFD," 0,00 "
02/10/2024 14:01:36,Open Position,NSDQ100/USD," 249,99 ",0.253546," 0,00 "," 4.896,50 "," 4.096,53 ",2823075816,CFD," 0,00 "
02/10/2024 14:02:01,Open Position,NSDQ100/USD," 249,99 ",0.253545," 0,00 "," 4.896,50 "," 3.846,54 ",2823077052,CFD," 0,00 "
02/10/2024 14:03:04,Position closed,NSDQ100/USD," 258,09 ",0.253545," 8,10 "," 4.904,60 "," 4.104,63 ",2823077052,CFD," 0,00 "
02/10/2024 14:03:45,Position closed,NSDQ100/USD," 247,94 ",0.252961,"(2,05)"," 4.902,55 "," 4.352,57 ",2822753452,CFD," 0,00 "
02/10/2024 14:03:54,Position closed,NSDQ100/USD," 302,71 ",0.303886," 2,72 "," 4.905,27 "," 4.655,28 ",2822847978,CFD," 0,00 "
02/10/2024 14:04:05,Open Position,NSDQ100/USD," 299,99 ",0.303663," 0,00 "," 4.905,27 "," 4.355,29 ",2823125853,CFD," 0,00 "
02/10/2024 14:04:34,Open Position,NSDQ100/USD," 349,99 ",0.354362," 0,00 "," 4.905,27 "," 4.005,30 ",2823126818,CFD," 0,00 "
02/10/2024 14:05:05,Open Position,NSDQ100/USD," 249,99 ",0.253234," 0,00 "," 4.905,27 "," 3.755,31 ",2823128209,CFD," 0,00 "
02/10/2024 14:09:42,Open Position,NSDQ100/USD," 149,99 ",0.151874," 0,00 "," 4.905,27 "," 3.605,32 ",2823135652,CFD," 0,00 "
02/10/2024 14:09:52,Open Position,NSDQ100/USD," 199,99 ",0.202546," 0,00 "," 4.905,27 "," 3.405,33 ",2823135772,CFD," 0,00 "
02/10/2024 14:16:12,Position closed,NSDQ100/USD," 350,57 ",0.354362," 0,58 "," 4.905,85 "," 3.755,90 ",2823126818,CFD," 0,00 "
02/10/2024 14:33:54,Position closed,NSDQ100/USD," 158,48 ",0.151874," 8,49 "," 4.914,34 "," 3.914,38 ",2823135652,CFD," 0,00 "
02/10/2024 14:34:02,Position closed,NSDQ100/USD," 315,09 ",0.303663," 15,10 "," 4.929,44 "," 4.229,47 ",2823125853,CFD," 0,00 "
02/10/2024 14:34:12,Position closed,NSDQ100/USD," 185,78 ",0.202546,"(14,21)"," 4.915,23 "," 4.415,25 ",2823135772,CFD," 0,00 "
02/10/2024 14:34:57,Open Position,NSDQ100/USD," 249,99 ",0.252622," 0,00 "," 4.915,23 "," 4.165,26 ",2823177912,CFD," 0,00 "
02/10/2024 14:36:11,Open Position,NSDQ100/USD," 250,00 ",0.252444," 0,00 "," 4.915,23 "," 3.915,26 ",2823180695,CFD," 0,00 "
02/10/2024 14:40:38,Position closed,NSDQ100/USD," 251,27 ",0.252444," 1,27 "," 4.916,50 "," 4.166,53 ",2823180695,CFD," 0,00 "
02/10/2024 14:40:51,Open Position,NSDQ100/USD," 249,98 ",0.252399," 0,00 "," 4.916,50 "," 3.916,55 ",2823186738,CFD," 0,00 "
02/10/2024 14:42:11,Position closed,NSDQ100/USD," 249,94 ",0.252399,"(0,04)"," 4.916,46 "," 4.166,49 ",2823186738,CFD," 0,00 "
02/10/2024 14:44:17,Open Position,NSDQ100/USD," 239,98 ",0.242247," 0,00 "," 4.916,46 "," 3.926,51 ",2823190306,CFD," 0,00 "
02/10/2024 14:44:36,Open Position,NSDQ100/USD," 149,99 ",0.151428," 0,00 "," 4.916,46 "," 3.776,52 ",2823190477,CFD," 0,00 "
02/10/2024 14:53:31,Position closed,NSDQ100/USD," 240,74 ",0.242247," 0,76 "," 4.917,22 "," 4.017,26 ",2823190306,CFD," 0,00 "
02/10/2024 14:53:50,Open Position,NSDQ100/USD," 249,99 ",0.252502," 0,00 "," 4.917,22 "," 3.767,27 ",2823236834,CFD," 0,00 "
02/10/2024 14:59:56,Position closed,NSDQ100/USD," 252,19 ",0.252502," 2,20 "," 4.919,42 "," 4.019,46 ",2823236834,CFD," 0,00 "
02/10/2024 15:01:13,Open Position,NSDQ100/USD," 249,99 ",0.252546," 0,00 "," 4.919,42 "," 3.769,47 ",2823278179,CFD," 0,00 "
02/10/2024 15:11:15,Position closed,NSDQ100/USD," 153,57 ",0.151428," 3,58 "," 4.923,00 "," 3.923,04 ",2823190477,CFD," 0,00 "
02/10/2024 15:11:44,Open Position,NSDQ100/USD," 199,99 ",0.201717," 0,00 "," 4.923,00 "," 3.723,05 ",2823384086,CFD," 0,00 "
02/10/2024 15:11:56,Open Position,NSDQ100/USD," 149,99 ",0.151253," 0,00 "," 4.923,00 "," 3.573,06 ",2823384229,CFD," 0,00 "
02/10/2024 16:05:05,Position closed,NSDQ100/USD," 154,85 ",0.151253," 4,86 "," 4.927,86 "," 3.727,91 ",2823384229,CFD," 0,00 "
02/10/2024 16:13:52,Position closed,NSDQ100/USD," 230,70 ",0.252546,"(19,29)"," 4.908,57 "," 3.958,61 ",2823278179,CFD," 0,00 "
02/10/2024 16:13:52,Position closed,NSDQ100/USD," 229,18 ",0.252622,"(20,81)"," 4.887,76 "," 4.187,79 ",2823177912,CFD," 0,00 "
02/10/2024 16:13:53,Position closed,NSDQ100/USD," 210,82 ",0.253546,"(39,17)"," 4.848,59 "," 4.398,61 ",2823075816,CFD," 0,00 "
02/10/2024 16:13:53,Position closed,NSDQ100/USD," 217,03 ",0.253234,"(32,96)"," 4.815,63 "," 4.615,64 ",2823128209,CFD," 0,00 "
02/10/2024 16:13:53,Position closed,NSDQ100/USD," 190,92 ",0.201717,"(9,07)"," 4.806,56 "," 4.806,56 ",2823384086,CFD," 0,00 "
02/10/2024 16:22:33,Open Position,NSDQ100/USD," 150,00 ",0.151258," 0,00 "," 4.806,56 "," 4.656,56 ",2823457689,CFD," 0,00 "
02/10/2024 16:29:12,Position closed,NSDQ100/USD," 144,60 ",0.151258,"(5,40)"," 4.801,16 "," 4.801,16 ",2823457689,CFD," 0,00 "
02/10/2024 16:31:36,Open Position,NSDQ100/USD," 250,00 ",0.251910," 0,00 "," 4.801,16 "," 4.551,16 ",2823464076,CFD," 0,00 "
02/10/2024 17:09:14,Open Position,NSDQ100/USD," 299,99 ",0.303120," 0,00 "," 4.801,16 "," 4.251,17 ",2823543851,CFD," 0,00 "
02/10/2024 17:14:07,Open Position,NSDQ100/USD," 350,00 ",0.353743," 0,00 "," 4.801,16 "," 3.901,17 ",2823546317,CFD," 0,00 "
02/10/2024 17:23:17,Position closed,NSDQ100/USD," 349,83 ",0.353743,"(0,17)"," 4.800,99 "," 4.251,00 ",2823546317,CFD," 0,00 "
02/10/2024 17:23:32,Open Position,NSDQ100/USD," 200,00 ",0.202151," 0,00 "," 4.800,99 "," 4.051,00 ",2823551870,CFD," 0,00 "
02/10/2024 17:48:10,Position closed,NSDQ100/USD," 241,57 ",0.251910,"(8,43)"," 4.792,56 "," 4.292,57 ",2823464076,CFD," 0,00 "
02/10/2024 17:48:10,Position closed,NSDQ100/USD," 306,24 ",0.303120," 6,25 "," 4.798,81 "," 4.598,81 ",2823543851,CFD," 0,00 "
02/10/2024 17:48:10,Position closed,NSDQ100/USD," 205,60 ",0.202151," 5,60 "," 4.804,41 "," 4.804,41 ",2823551870,CFD," 0,00 "
02/10/2024 18:23:04,Open Position,NSDQ100/USD," 599,98 ",0.604915," 0,00 "," 4.804,41 "," 4.204,43 ",2823584789,CFD," 0,00 "
02/10/2024 18:30:58,Position closed,NSDQ100/USD," 617,00 ",0.604915," 17,02 "," 4.821,43 "," 4.821,43 ",2823584789,CFD," 0,00 "
02/10/2024 18:40:15,Open Position,NSDQ100/USD," 249,99 ",0.252297," 0,00 "," 4.821,43 "," 4.571,44 ",2823595599,CFD," 0,00 "
02/10/2024 18:40:37,Open Position,NSDQ100/USD," 200,00 ",0.201815," 0,00 "," 4.821,43 "," 4.371,44 ",2823595734,CFD," 0,00 "
02/10/2024 18:48:56,Position closed,NSDQ100/USD," 200,55 ",0.201815," 0,55 "," 4.821,98 "," 4.571,99 ",2823595734,CFD," 0,00 "
02/10/2024 18:49:14,Open Position,NSDQ100/USD," 249,99 ",0.252206," 0,00 "," 4.821,98 "," 4.322,00 ",2823602481,CFD," 0,00 "
02/10/2024 19:12:47,Open Position,NSDQ100/USD," 249,99 ",0.252164," 0,00 "," 4.821,98 "," 4.072,01 ",2823619649,CFD," 0,00 "
02/10/2024 19:58:17,Position closed,NSDQ100/USD," 252,97 ",0.252164," 2,98 "," 4.824,96 "," 4.324,98 ",2823619649,CFD," 0,00 "
02/10/2024 19:58:17,Position closed,NSDQ100/USD," 250,33 ",0.252297," 0,34 "," 4.825,30 "," 4.575,31 ",2823595599,CFD," 0,00 "
02/10/2024 19:58:17,Position closed,NSDQ100/USD," 252,14 ",0.252206," 2,15 "," 4.827,45 "," 4.827,45 ",2823602481,CFD," 0,00 "
02/10/2024 20:05:48,Open Position,NSDQ100/USD," 349,99 ",0.353092," 0,00 "," 4.827,45 "," 4.477,46 ",2823650638,CFD," 0,00 "
02/10/2024 20:22:03,Open Position,USD/JPY," 499,99 ",15000.000000," 0,00 "," 4.827,45 "," 3.977,47 ",2823652060,CFD," 0,00 "
02/10/2024 20:22:46,Open Position,USD/JPY," 300,00 ",9000.000000," 0,00 "," 4.827,45 "," 3.677,47 ",2823652106,CFD," 0,00 "
02/10/2024 20:25:27,Position closed,NSDQ100/USD," 343,01 ",0.353092,"(6,98)"," 4.820,47 "," 4.020,48 ",2823650638,CFD," 0,00 "
02/10/2024 20:29:20,Position closed,USD/JPY," 502,65 ",15000.000000," 2,66 "," 4.823,13 "," 4.523,13 ",2823652060,CFD," 0,00 "
02/10/2024 20:29:20,Position closed,USD/JPY," 300,98 ",9000.000000," 0,98 "," 4.824,11 "," 4.824,11 ",2823652106,CFD," 0,00 "
02/10/2024 20:35:31,Open Position,USD/JPY," 200,00 ",6000.000000," 0,00 "," 4.824,11 "," 4.624,11 ",2823653427,CFD," 0,00 "
02/10/2024 20:36:23,Open Position,NSDQ100/USD," 199,99 ",0.201532," 0,00 "," 4.824,11 "," 4.424,12 ",2823653493,CFD," 0,00 "
02/10/2024 20:43:37,Position closed,NSDQ100/USD," 202,71 ",0.201532," 2,72 "," 4.826,83 "," 4.626,83 ",2823653493,CFD," 0,00 "
02/10/2024 20:43:40,Position closed,USD/JPY," 198,28 ",6000.000000,"(1,72)"," 4.825,11 "," 4.825,11 ",2823653427,CFD," 0,00 "
02/10/2024 20:55:04,Open Position,NSDQ100/USD," 149,99 ",0.151016," 0,00 "," 4.825,11 "," 4.675,12 ",2823656647,CFD," 0,00 "
02/10/2024 22:35:41,Open Position,NSDQ100/USD," 349,99 ",0.352742," 0,00 "," 4.825,11 "," 4.325,13 ",2823662678,CFD," 0,00 "
02/10/2024 23:02:50,Position closed,NSDQ100/USD," 353,35 ",0.352742," 3,36 "," 4.828,47 "," 4.678,48 ",2823662678,CFD," 0,00 "
03/10/2024 00:48:47,Overnight fee,Daily,"(0,77)",-,"(0,77)"," 4.827,70 "," 4.677,71 ",2823656647,CFD," 0,00 "
03/10/2024 05:37:51,Position closed,NSDQ100/USD," 133,82 ",0.151016,"(16,17)"," 4.811,53 "," 4.811,53 ",2823656647,CFD," 0,00 "
03/10/2024 05:46:46,Open Position,NSDQ100/USD," 499,99 ",0.506537," 0,00 "," 4.811,53 "," 4.311,54 ",2823702845,CFD," 0,00 "
03/10/2024 06:14:56,Position closed,NSDQ100/USD," 503,00 ",0.506537," 3,01 "," 4.814,54 "," 4.814,54 ",2823702845,CFD," 0,00 "
03/10/2024 07:38:30,Open Position,NSDQ100/USD," 300,00 ",0.305036," 0,00 "," 4.814,54 "," 4.514,54 ",2823756249,CFD," 0,00 "
03/10/2024 07:39:28,Open Position,NSDQ100/USD," 399,99 ",0.406682," 0,00 "," 4.814,54 "," 4.114,55 ",2823757174,CFD," 0,00 "
03/10/2024 07:40:12,Open Position,NSDQ100/USD," 399,99 ",0.406798," 0,00 "," 4.814,54 "," 3.714,56 ",2823757344,CFD," 0,00 "
03/10/2024 07:42:47,Open Position,NSDQ100/USD," 929,98 ",0.945031," 0,00 "," 4.814,54 "," 2.784,58 ",2823758316,CFD," 0,00 "
03/10/2024 07:46:41,Open Position,NSDQ100/USD," 699,99 ",0.711770," 0,00 "," 4.814,54 "," 2.084,59 ",2823759970,CFD," 0,00 "
03/10/2024 07:50:57,Open Position,NSDQ100/USD," 530,00 ",0.539117," 0,00 "," 4.814,54 "," 1.554,59 ",2823762265,CFD," 0,00 "
03/10/2024 07:52:24,Open Position,NSDQ100/USD," 449,99 ",0.457787," 0,00 "," 4.814,54 "," 1.104,60 ",2823762719,CFD," 0,00 "
03/10/2024 07:53:04,Position closed,NSDQ100/USD," 406,52 ",0.406798," 6,53 "," 4.821,07 "," 1.511,12 ",2823757344,CFD," 0,00 "
03/10/2024 07:53:04,Position closed,NSDQ100/USD," 303,55 ",0.305036," 3,55 "," 4.824,62 "," 1.814,67 ",2823756249,CFD," 0,00 "
03/10/2024 07:53:04,Position closed,NSDQ100/USD," 404,12 ",0.406682," 4,13 "," 4.828,75 "," 2.218,79 ",2823757174,CFD," 0,00 "
03/10/2024 07:53:04,Position closed,NSDQ100/USD," 929,84 ",0.945031,"(0,14)"," 4.828,61 "," 3.148,63 ",2823758316,CFD," 0,00 "
03/10/2024 07:53:05,Position closed,NSDQ100/USD," 708,71 ",0.711770," 8,72 "," 4.837,33 "," 3.857,34 ",2823759970,CFD," 0,00 "
03/10/2024 07:53:05,Position closed,NSDQ100/USD," 540,64 ",0.539117," 10,64 "," 4.847,97 "," 4.397,98 ",2823762265,CFD," 0,00 "
03/10/2024 07:53:05,Position closed,NSDQ100/USD," 459,90 ",0.457787," 9,91 "," 4.857,88 "," 4.857,88 ",2823762719,CFD," 0,00 "
03/10/2024 07:53:27,Open Position,NSDQ100/USD," 600,00 ",0.609673," 0,00 "," 4.857,88 "," 4.257,88 ",2823763153,CFD," 0,00 "
03/10/2024 07:54:09,Open Position,NSDQ100/USD," 499,99 ",0.508151," 0,00 "," 4.857,88 "," 3.757,89 ",2823763340,CFD," 0,00 "
03/10/2024 07:54:55,Open Position,NSDQ100/USD," 499,99 ",0.508146," 0,00 "," 4.857,88 "," 3.257,90 ",2823764774,CFD," 0,00 "
03/10/2024 07:55:27,Open Position,NSDQ100/USD," 399,99 ",0.406645," 0,00 "," 4.857,88 "," 2.857,91 ",2823764889,CFD," 0,00 "
03/10/2024 07:56:06,Open Position,NSDQ100/USD," 300,00 ",0.304957," 0,00 "," 4.857,88 "," 2.557,91 ",2823765079,CFD," 0,00 "
03/10/2024 07:57:04,Open Position,NSDQ100/USD," 350,00 ",0.355722," 0,00 "," 4.857,88 "," 2.207,91 ",2823765379,CFD," 0,00 "
03/10/2024 08:02:15,Position closed,NSDQ100/USD," 607,41 ",0.609673," 7,41 "," 4.865,29 "," 2.815,32 ",2823763153,CFD," 0,00 "
03/10/2024 08:02:15,Position closed,NSDQ100/USD," 408,79 ",0.406645," 8,80 "," 4.874,09 "," 3.224,11 ",2823764889,CFD," 0,00 "
03/10/2024 08:02:15,Position closed,NSDQ100/USD," 507,94 ",0.508151," 7,95 "," 4.882,04 "," 3.732,05 ",2823763340,CFD," 0,00 "
03/10/2024 08:02:15,Position closed,NSDQ100/USD," 507,84 ",0.508146," 7,85 "," 4.889,89 "," 4.239,89 ",2823764774,CFD," 0,00 "
03/10/2024 08:02:15,Position closed,NSDQ100/USD," 306,08 ",0.304957," 6,08 "," 4.895,97 "," 4.545,97 ",2823765079,CFD," 0,00 "
03/10/2024 08:02:15,Position closed,NSDQ100/USD," 355,78 ",0.355722," 5,78 "," 4.901,75 "," 4.901,75 ",2823765379,CFD," 0,00 "
03/10/2024 08:02:35,Open Position,NSDQ100/USD," 300,00 ",0.304604," 0,00 "," 4.901,75 "," 4.601,75 ",2823768190,CFD," 0,00 "
03/10/2024 08:02:46,Open Position,NSDQ100/USD," 399,99 ",0.406085," 0,00 "," 4.901,75 "," 4.201,76 ",2823768254,CFD," 0,00 "
03/10/2024 08:11:08,Open Position,NSDQ100/USD," 399,99 ",0.406308," 0,00 "," 4.901,75 "," 3.801,77 ",2823770377,CFD," 0,00 "
03/10/2024 08:11:53,Open Position,NSDQ100/USD," 300,00 ",0.304742," 0,00 "," 4.901,75 "," 3.501,77 ",2823770925,CFD," 0,00 "
03/10/2024 08:12:55,Open Position,NSDQ100/USD," 499,99 ",0.507723," 0,00 "," 4.901,75 "," 3.001,78 ",2823771219,CFD," 0,00 "
03/10/2024 08:13:48,Position closed,NSDQ100/USD," 399,64 ",0.406085,"(0,35)"," 4.901,40 "," 3.401,42 ",2823768254,CFD," 0,00 "
03/10/2024 08:13:51,Position closed,NSDQ100/USD," 300,05 ",0.304604," 0,05 "," 4.901,45 "," 3.701,47 ",2823768190,CFD," 0,00 "
03/10/2024 08:14:08,Position closed,NSDQ100/USD," 304,04 ",0.304742," 4,04 "," 4.905,49 "," 4.005,51 ",2823770925,CFD," 0,00 "
03/10/2024 08:14:12,Position closed,NSDQ100/USD," 504,28 ",0.507723," 4,29 "," 4.909,78 "," 4.509,79 ",2823771219,CFD," 0,00 "
03/10/2024 08:14:17,Position closed,NSDQ100/USD," 405,82 ",0.406308," 5,83 "," 4.915,61 "," 4.915,61 ",2823770377,CFD," 0,00 "
03/10/2024 08:14:44,Open Position,NSDQ100/USD," 399,99 ",0.405978," 0,00 "," 4.915,61 "," 4.515,62 ",2823771577,CFD," 0,00 "
03/10/2024 08:15:03,Open Position,NSDQ100/USD," 300,00 ",0.304454," 0,00 "," 4.915,61 "," 4.215,62 ",2823771711,CFD," 0,00 "
03/10/2024 08:15:23,Open Position,NSDQ100/USD," 399,99 ",0.405856," 0,00 "," 4.915,61 "," 3.815,63 ",2823771783,CFD," 0,00 "
03/10/2024 09:21:05,Position closed,NSDQ100/USD," 402,93 ",0.405978," 2,94 "," 4.918,55 "," 4.218,56 ",2823771577,CFD," 0,00 "
03/10/2024 09:21:05,Position closed,NSDQ100/USD," 400,53 ",0.405856," 0,54 "," 4.919,09 "," 4.619,09 ",2823771783,CFD," 0,00 "
03/10/2024 09:21:05,Position closed,NSDQ100/USD," 301,63 ",0.304454," 1,63 "," 4.920,72 "," 4.920,72 ",2823771711,CFD," 0,00 "
03/10/2024 09:21:26,Open Position,NSDQ100/USD," 499,99 ",0.507151," 0,00 "," 4.920,72 "," 4.420,73 ",2823791694,CFD," 0,00 "
03/10/2024 09:21:52,Open Position,NSDQ100/USD," 399,99 ",0.405723," 0,00 "," 4.920,72 "," 4.020,74 ",2823791848,CFD," 0,00 "
03/10/2024 09:22:09,Open Position,NSDQ100/USD," 350,00 ",0.355047," 0,00 "," 4.920,72 "," 3.670,74 ",2823791913,CFD," 0,00 "
03/10/2024 09:22:19,Open Position,NSDQ100/USD," 249,99 ",0.253596," 0,00 "," 4.920,72 "," 3.420,75 ",2823791931,CFD," 0,00 "
03/10/2024 10:33:32,Position closed,NSDQ100/USD," 353,03 ",0.355047," 3,03 "," 4.923,75 "," 3.773,78 ",2823791913,CFD," 0,00 "
03/10/2024 10:33:32,Position closed,NSDQ100/USD," 251,98 ",0.253596," 1,99 "," 4.925,74 "," 4.025,76 ",2823791931,CFD," 0,00 "
03/10/2024 10:33:32,Position closed,NSDQ100/USD," 402,56 ",0.405723," 2,57 "," 4.928,31 "," 4.428,32 ",2823791848,CFD," 0,00 "
03/10/2024 10:33:32,Position closed,NSDQ100/USD," 503,15 ",0.507151," 3,16 "," 4.931,47 "," 4.931,47 ",2823791694,CFD," 0,00 "
03/10/2024 10:34:14,Open Position,NSDQ100/USD," 499,99 ",0.506855," 0,00 "," 4.931,47 "," 4.431,48 ",2823830087,CFD," 0,00 "
03/10/2024 10:34:23,Open Position,NSDQ100/USD," 249,99 ",0.253422," 0,00 "," 4.931,47 "," 4.181,49 ",2823830102,CFD," 0,00 "
03/10/2024 10:59:08,Position closed,NSDQ100/USD," 252,74 ",0.253422," 2,75 "," 4.934,22 "," 4.434,23 ",2823830102,CFD," 0,00 "
03/10/2024 11:01:28,Position closed,NSDQ100/USD," 515,67 ",0.506855," 15,68 "," 4.949,90 "," 4.949,90 ",2823830087,CFD," 0,00 "
03/10/2024 11:02:07,Open Position,NSDQ100/USD," 499,99 ",0.506073," 0,00 "," 4.949,90 "," 4.449,91 ",2823835326,CFD," 0,00 "
03/10/2024 11:02:14,Open Position,NSDQ100/USD," 100,00 ",0.101222," 0,00 "," 4.949,90 "," 4.349,91 ",2823835389,CFD," 0,00 "
03/10/2024 11:04:21,Open Position,XAU/USD," 350,00 ",2.644653," 0,00 "," 4.949,90 "," 3.999,91 ",2823835830,CFD," 0,00 "
03/10/2024 11:04:42,Open Position,USD/JPY," 249,99 ",7500.000000," 0,00 "," 4.949,90 "," 3.749,92 ",2823835887,CFD," 0,00 "
03/10/2024 11:06:20,Open Position,XAG/USD," 199,99 ",63.431652," 0,00 "," 4.949,90 "," 3.549,93 ",2823836119,CFD," 0,00 "
03/10/2024 11:07:56,Open Position,GER30/EUR," 200,00 ",0.189758," 0,00 "," 4.949,90 "," 3.349,93 ",2823836533,CFD," 0,00 "
03/10/2024 11:09:20,Open Position,NSDQ100/USD," 199,99 ",0.202553," 0,00 "," 4.949,90 "," 3.149,94 ",2823836810,CFD," 0,00 "
03/10/2024 11:09:29,Position closed,NSDQ100/USD," 98,84 ",0.101222,"(1,16)"," 4.948,74 "," 3.248,78 ",2823835389,CFD," 0,00 "
03/10/2024 11:14:55,Position closed,XAG/USD," 198,72 ",63.431652,"(1,27)"," 4.947,47 "," 3.447,50 ",2823836119,CFD," 0,00 "
03/10/2024 11:15:02,Position closed,XAU/USD," 349,26 ",2.644653,"(0,74)"," 4.946,73 "," 3.796,76 ",2823835830,CFD," 0,00 "
03/10/2024 11:15:43,Position closed,USD/JPY," 253,36 ",7500.000000," 3,37 "," 4.950,10 "," 4.050,12 ",2823835887,CFD," 0,00 "
03/10/2024 11:16:07,Open Position,NSDQ100/USD," 199,99 ",0.202642," 0,00 "," 4.950,10 "," 3.850,13 ",2823838128,CFD," 0,00 "
03/10/2024 11:17:06,Open Position,NSDQ100/USD," 149,99 ",0.152000," 0,00 "," 4.950,10 "," 3.700,14 ",2823838349,CFD," 0,00 "
03/10/2024 11:17:15,Open Position,NSDQ100/USD," 199,99 ",0.202662," 0,00 "," 4.950,10 "," 3.500,15 ",2823838368,CFD," 0,00 "
03/10/2024 11:17:24,Position closed,GER30/EUR," 197,41 ",0.189758,"(2,59)"," 4.947,51 "," 3.697,56 ",2823836533,CFD," 0,00 "
03/10/2024 11:30:25,Position closed,NSDQ100/USD," 202,21 ",0.202642," 2,22 "," 4.949,73 "," 3.899,77 ",2823838128,CFD," 0,00 "
03/10/2024 11:30:25,Position closed,NSDQ100/USD," 494,90 ",0.506073,"(5,09)"," 4.944,64 "," 4.394,67 ",2823835326,CFD," 0,00 "
03/10/2024 11:30:25,Position closed,NSDQ100/USD," 151,99 ",0.152000," 2,00 "," 4.946,64 "," 4.546,66 ",2823838349,CFD," 0,00 "
03/10/2024 11:30:25,Position closed,NSDQ100/USD," 200,40 ",0.202553," 0,41 "," 4.947,05 "," 4.747,06 ",2823836810,CFD," 0,00 "
03/10/2024 11:30:25,Position closed,NSDQ100/USD," 202,55 ",0.202662," 2,56 "," 4.949,61 "," 4.949,61 ",2823838368,CFD," 0,00 "
03/10/2024 11:32:45,Open Position,NSDQ100/USD," 300,00 ",0.303787," 0,00 "," 4.949,61 "," 4.649,61 ",2823841672,CFD," 0,00 "
03/10/2024 11:32:59,Open Position,NSDQ100/USD," 300,00 ",0.303814," 0,00 "," 4.949,61 "," 4.349,61 ",2823841740,CFD," 0,00 "
03/10/2024 12:07:00,Position closed,NSDQ100/USD," 305,42 ",0.303787," 5,42 "," 4.955,03 "," 4.655,03 ",2823841672,CFD," 0,00 "
03/10/2024 12:07:00,Position closed,NSDQ100/USD," 305,97 ",0.303814," 5,97 "," 4.961,00 "," 4.961,00 ",2823841740,CFD," 0,00 "
03/10/2024 12:52:45,Open Position,NSDQ100/USD," 300,00 ",0.303871," 0,00 "," 4.961,00 "," 4.661,00 ",2823862641,CFD," 0,00 "
03/10/2024 12:52:54,Open Position,NSDQ100/USD," 199,99 ",0.202586," 0,00 "," 4.961,00 "," 4.461,01 ",2823862675,CFD," 0,00 "
03/10/2024 12:55:08,Open Position,NSDQ100/USD," 149,99 ",0.151956," 0,00 "," 4.961,00 "," 4.311,02 ",2823863414,CFD," 0,00 "
03/10/2024 13:11:53,Open Position,NSDQ100/USD," 350,00 ",0.354989," 0,00 "," 4.961,00 "," 3.961,02 ",2823867795,CFD," 0,00 "
03/10/2024 13:19:57,Open Position,NSDQ100/USD," 100,00 ",0.101443," 0,00 "," 4.961,00 "," 3.861,02 ",2823869910,CFD," 0,00 "
03/10/2024 13:22:20,Open Position,NSDQ100/USD," 50,00 ",0.050737," 0,00 "," 4.961,00 "," 3.811,02 ",2823870499,CFD," 0,00 "
03/10/2024 13:40:30,Position closed,NSDQ100/USD," 305,13 ",0.303871," 5,13 "," 4.966,13 "," 4.116,15 ",2823862641,CFD," 0,00 "
03/10/2024 13:40:30,Position closed,NSDQ100/USD," 365,33 ",0.354989," 15,33 "," 4.981,46 "," 4.481,48 ",2823867795,CFD," 0,00 "
03/10/2024 13:40:30,Position closed,NSDQ100/USD," 152,97 ",0.151956," 2,98 "," 4.984,44 "," 4.634,45 ",2823863414,CFD," 0,00 "
03/10/2024 13:40:30,Position closed,NSDQ100/USD," 203,51 ",0.202586," 3,52 "," 4.987,96 "," 4.837,96 ",2823862675,CFD," 0,00 "
03/10/2024 13:40:30,Position closed,NSDQ100/USD," 52,68 ",0.050737," 2,68 "," 4.990,64 "," 4.890,64 ",2823870499,CFD," 0,00 "
03/10/2024 13:40:30,Position closed,NSDQ100/USD," 104,73 ",0.101443," 4,73 "," 4.995,37 "," 4.995,37 ",2823869910,CFD," 0,00 "
03/10/2024 13:41:09,Open Position,NSDQ100/USD," 299,99 ",0.303472," 0,00 "," 4.995,37 "," 4.695,38 ",2823963804,CFD," 0,00 "
03/10/2024 13:41:25,Open Position,NSDQ100/USD," 200,00 ",0.202232," 0,00 "," 4.995,37 "," 4.495,38 ",2823964368,CFD," 0,00 "
03/10/2024 13:47:28,Position closed,NSDQ100/USD," 301,85 ",0.303472," 1,86 "," 4.997,23 "," 4.797,23 ",2823963804,CFD," 0,00 "
03/10/2024 13:48:04,Position closed,NSDQ100/USD," 200,29 ",0.202232," 0,29 "," 4.997,52 "," 4.997,52 ",2823964368,CFD," 0,00 "
03/10/2024 13:51:45,Open Position,NSDQ100/USD," 299,99 ",0.303236," 0,00 "," 4.997,52 "," 4.697,53 ",2824027145,CFD," 0,00 "
03/10/2024 14:01:25,Position closed,NSDQ100/USD," 321,10 ",0.303236," 21,11 "," 5.018,63 "," 5.018,63 ",2824027145,CFD," 0,00 "
03/10/2024 14:01:52,Open Position,NSDQ100/USD," 149,99 ",0.151070," 0,00 "," 5.018,63 "," 4.868,64 ",2824045376,CFD," 0,00 "
03/10/2024 14:02:57,Position closed,NSDQ100/USD," 151,46 ",0.151070," 1,47 "," 5.020,10 "," 5.020,10 ",2824045376,CFD," 0,00 "
03/10/2024 14:03:39,Open Position,NSDQ100/USD," 249,99 ",0.251804," 0,00 "," 5.020,10 "," 4.770,11 ",2824048100,CFD," 0,00 "
03/10/2024 14:04:25,Position closed,NSDQ100/USD," 253,14 ",0.251804," 3,15 "," 5.023,25 "," 5.023,25 ",2824048100,CFD," 0,00 "
03/10/2024 14:04:48,Open Position,NSDQ100/USD," 149,99 ",0.150862," 0,00 "," 5.023,25 "," 4.873,26 ",2824049887,CFD," 0,00 "
03/10/2024 14:05:18,Open Position,NSDQ100/USD," 149,99 ",0.150807," 0,00 "," 5.023,25 "," 4.723,27 ",2824050858,CFD," 0,00 "
03/10/2024 14:05:37,Position closed,NSDQ100/USD," 151,12 ",0.150862," 1,13 "," 5.024,38 "," 4.874,39 ",2824049887,CFD," 0,00 "
03/10/2024 14:05:56,Position closed,NSDQ100/USD," 150,58 ",0.150807," 0,59 "," 5.024,97 "," 5.024,97 ",2824050858,CFD," 0,00 "
03/10/2024 14:06:14,Open Position,NSDQ100/USD," 159,99 ",0.160800," 0,00 "," 5.024,97 "," 4.864,98 ",2824052639,CFD," 0,00 "
03/10/2024 14:06:58,Open Position,NSDQ100/USD," 299,99 ",0.301461," 0,00 "," 5.024,97 "," 4.564,99 ",2824054464,CFD," 0,00 "
03/10/2024 14:07:43,Open Position,NSDQ100/USD," 149,99 ",0.150707," 0,00 "," 5.024,97 "," 4.415,00 ",2824055970,CFD," 0,00 "
03/10/2024 14:13:55,Position closed,NSDQ100/USD," 137,05 ",0.150707,"(12,94)"," 5.012,03 "," 4.552,05 ",2824055970,CFD," 0,00 "
03/10/2024 14:14:27,Open Position,NSDQ100/USD," 199,98 ",0.201935," 0,00 "," 5.012,03 "," 4.352,07 ",2824069282,CFD," 0,00 "
03/10/2024 14:14:58,Position closed,NSDQ100/USD," 203,52 ",0.201935," 3,54 "," 5.015,57 "," 4.555,59 ",2824069282,CFD," 0,00 "
03/10/2024 14:16:16,Open Position,NSDQ100/USD," 200,00 ",0.201858," 0,00 "," 5.015,57 "," 4.355,59 ",2824090841,CFD," 0,00 "
03/10/2024 14:17:23,Open Position,NSDQ100/USD," 149,99 ",0.151049," 0,00 "," 5.015,57 "," 4.205,60 ",2824147216,CFD," 0,00 "
03/10/2024 14:21:20,Position closed,NSDQ100/USD," 142,98 ",0.151049,"(7,01)"," 5.008,56 "," 4.348,58 ",2824147216,CFD," 0,00 "
03/10/2024 14:21:38,Open Position,NSDQ100/USD," 250,00 ",0.252463," 0,00 "," 5.008,56 "," 4.098,58 ",2824259274,CFD," 0,00 "
03/10/2024 14:22:00,Open Position,NSDQ100/USD," 149,99 ",0.151393," 0,00 "," 5.008,56 "," 3.948,59 ",2824259861,CFD," 0,00 "
03/10/2024 14:23:09,Open Position,NSDQ100/USD," 250,00 ",0.253178," 0,00 "," 5.008,56 "," 3.698,59 ",2824262998,CFD," 0,00 "
03/10/2024 14:23:26,Open Position,NSDQ100/USD," 149,99 ",0.151821," 0,00 "," 5.008,56 "," 3.548,60 ",2824263485,CFD," 0,00 "
03/10/2024 14:24:29,Position closed,NSDQ100/USD," 258,49 ",0.253178," 8,49 "," 5.017,05 "," 3.807,09 ",2824262998,CFD," 0,00 "
03/10/2024 14:24:43,Position closed,NSDQ100/USD," 152,29 ",0.151821," 2,30 "," 5.019,35 "," 3.959,38 ",2824263485,CFD," 0,00 "
03/10/2024 14:25:02,Open Position,NSDQ100/USD," 200,00 ",0.202343," 0,00 "," 5.019,35 "," 3.759,38 ",2824265592,CFD," 0,00 "
03/10/2024 14:25:59,Position closed,NSDQ100/USD," 200,31 ",0.202343," 0,31 "," 5.019,66 "," 3.959,69 ",2824265592,CFD," 0,00 "
03/10/2024 14:26:38,Open Position,NSDQ100/USD," 200,00 ",0.202270," 0,00 "," 5.019,66 "," 3.759,69 ",2824267773,CFD," 0,00 "
03/10/2024 14:29:23,Position closed,NSDQ100/USD," 199,70 ",0.202270,"(0,30)"," 5.019,36 "," 3.959,39 ",2824267773,CFD," 0,00 "
03/10/2024 14:29:59,Open Position,NSDQ100/USD," 200,00 ",0.202397," 0,00 "," 5.019,36 "," 3.759,39 ",2824274050,CFD," 0,00 "
03/10/2024 14:30:45,Position closed,NSDQ100/USD," 195,45 ",0.202397,"(4,55)"," 5.014,81 "," 3.954,84 ",2824274050,CFD," 0,00 "
03/10/2024 14:32:29,Open Position,NSDQ100/USD," 99,99 ",0.101155," 0,00 "," 5.014,81 "," 3.854,85 ",2824278859,CFD," 0,00 "
03/10/2024 14:32:42,Position closed,NSDQ100/USD," 99,69 ",0.101155,"(0,30)"," 5.014,51 "," 3.954,54 ",2824278859,CFD," 0,00 "
03/10/2024 14:33:26,Position closed,NSDQ100/USD," 250,41 ",0.252463," 0,41 "," 5.014,92 "," 4.204,95 ",2824259274,CFD," 0,00 "
03/10/2024 14:34:37,Position closed,NSDQ100/USD," 148,92 ",0.151393,"(1,07)"," 5.013,85 "," 4.353,87 ",2824259861,CFD," 0,00 "
03/10/2024 14:36:47,Open Position,NSDQ100/USD," 149,99 ",0.151626," 0,00 "," 5.013,85 "," 4.203,88 ",2824284939,CFD," 0,00 "
03/10/2024 14:46:01,Open Position,NSDQ100/USD," 350,00 ",0.354544," 0,00 "," 5.013,85 "," 3.853,88 ",2824299236,CFD," 0,00 "
03/10/2024 14:46:53,Position closed,NSDQ100/USD," 362,00 ",0.354544," 12,00 "," 5.025,85 "," 4.215,88 ",2824299236,CFD," 0,00 "
03/10/2024 14:47:49,Position closed,NSDQ100/USD," 152,48 ",0.151626," 2,49 "," 5.028,34 "," 4.368,36 ",2824284939,CFD," 0,00 "
03/10/2024 14:53:40,Position closed,NSDQ100/USD," 201,36 ",0.201858," 1,36 "," 5.029,70 "," 4.569,72 ",2824090841,CFD," 0,00 "
03/10/2024 14:54:14,Open Position,NSDQ100/USD," 149,99 ",0.151399," 0,00 "," 5.029,70 "," 4.419,73 ",2824312385,CFD," 0,00 "
03/10/2024 14:59:46,Open Position,NSDQ100/USD," 350,00 ",0.354433," 0,00 "," 5.029,70 "," 4.069,73 ",2824317758,CFD," 0,00 "
03/10/2024 15:00:50,Open Position,NSDQ100/USD," 299,99 ",0.303800," 0,00 "," 5.029,70 "," 3.769,74 ",2824319930,CFD," 0,00 "
03/10/2024 15:01:13,Open Position,NSDQ100/USD," 99,99 ",0.101256," 0,00 "," 5.029,70 "," 3.669,75 ",2824321275,CFD," 0,00 "
03/10/2024 15:06:26,Position closed,NSDQ100/USD," 357,49 ",0.354433," 7,49 "," 5.037,19 "," 4.027,24 ",2824317758,CFD," 0,00 "
03/10/2024 15:06:37,Position closed,NSDQ100/USD," 305,53 ",0.303800," 5,54 "," 5.042,73 "," 4.332,77 ",2824319930,CFD," 0,00 "
03/10/2024 15:07:00,Open Position,NSDQ100/USD," 99,99 ",0.101119," 0,00 "," 5.042,73 "," 4.232,78 ",2824331374,CFD," 0,00 "
03/10/2024 15:07:20,Position closed,NSDQ100/USD," 101,69 ",0.101256," 1,70 "," 5.044,43 "," 4.334,47 ",2824321275,CFD," 0,00 "
03/10/2024 15:08:11,Open Position,NSDQ100/USD," 299,99 ",0.303797," 0,00 "," 5.044,43 "," 4.034,48 ",2824332625,CFD," 0,00 "
03/10/2024 15:08:24,Open Position,NSDQ100/USD," 200,00 ",0.202473," 0,00 "," 5.044,43 "," 3.834,48 ",2824333367,CFD," 0,00 "
03/10/2024 15:09:09,Position closed,NSDQ100/USD," 305,32 ",0.303797," 5,33 "," 5.049,76 "," 4.139,80 ",2824332625,CFD," 0,00 "
03/10/2024 15:09:26,Position closed,NSDQ100/USD," 201,53 ",0.202473," 1,53 "," 5.051,29 "," 4.341,33 ",2824333367,CFD," 0,00 "
03/10/2024 15:25:13,Position closed,NSDQ100/USD," 101,51 ",0.101119," 1,52 "," 5.052,81 "," 4.442,84 ",2824331374,CFD," 0,00 "
03/10/2024 15:41:17,Position closed,NSDQ100/USD," 153,78 ",0.151399," 3,79 "," 5.056,60 "," 4.596,62 ",2824312385,CFD," 0,00 "
03/10/2024 15:41:42,Open Position,NSDQ100/USD," 200,00 ",0.201663," 0,00 "," 5.056,60 "," 4.396,62 ",2824361128,CFD," 0,00 "
03/10/2024 15:43:44,Position closed,NSDQ100/USD," 198,37 ",0.201663,"(1,63)"," 5.054,97 "," 4.594,99 ",2824361128,CFD," 0,00 "
03/10/2024 15:44:10,Open Position,NSDQ100/USD," 149,99 ",0.151275," 0,00 "," 5.054,97 "," 4.445,00 ",2824362868,CFD," 0,00 "
03/10/2024 15:48:02,Position closed,NSDQ100/USD," 151,63 ",0.151275," 1,64 "," 5.056,61 "," 4.596,63 ",2824362868,CFD," 0,00 "
03/10/2024 15:48:42,Open Position,NSDQ100/USD," 149,99 ",0.151200," 0,00 "," 5.056,61 "," 4.446,64 ",2824366462,CFD," 0,00 "
03/10/2024 16:01:18,Open Position,XAU/USD," 150,00 ",1.132464," 0,00 "," 5.056,61 "," 4.296,64 ",2824377840,CFD," 0,00 "
03/10/2024 16:12:11,Position closed,XAU/USD," 153,01 ",1.132464," 3,01 "," 5.059,62 "," 4.449,65 ",2824377840,CFD," 0,00 "
03/10/2024 16:12:50,Position closed,NSDQ100/USD," 149,37 ",0.151200,"(0,62)"," 5.059,00 "," 4.599,02 ",2824366462,CFD," 0,00 "
03/10/2024 16:24:02,Open Position,NSDQ100/USD," 149,99 ",0.151233," 0,00 "," 5.059,00 "," 4.449,03 ",2824390488,CFD," 0,00 "
03/10/2024 16:31:50,Open Position,NSDQ100/USD," 149,98 ",0.151368," 0,00 "," 5.059,00 "," 4.299,05 ",2824394459,CFD," 0,00 "
03/10/2024 16:35:52,Open Position,NSDQ100/USD," 149,99 ",0.151426," 0,00 "," 5.059,00 "," 4.149,06 ",2824396823,CFD," 0,00 "
03/10/2024 16:42:40,Position closed,NSDQ100/USD," 145,91 ",0.151426,"(4,08)"," 5.054,92 "," 4.294,97 ",2824396823,CFD," 0,00 "
03/10/2024 16:42:51,Open Position,NSDQ100/USD," 99,99 ",0.101089," 0,00 "," 5.054,92 "," 4.194,98 ",2824400929,CFD," 0,00 "
03/10/2024 16:49:21,Open Position,NSDQ100/USD," 350,00 ",0.354438," 0,00 "," 5.054,92 "," 3.844,98 ",2824405928,CFD," 0,00 "
03/10/2024 16:49:32,Open Position,NSDQ100/USD," 149,99 ",0.151953," 0,00 "," 5.054,92 "," 3.694,99 ",2824406029,CFD," 0,00 "
03/10/2024 16:51:41,Open Position,NSDQ100/USD," 249,99 ",0.253325," 0,00 "," 5.054,92 "," 3.445,00 ",2824407772,CFD," 0,00 "
03/10/2024 17:11:45,Open Position,NSDQ100/USD," 350,00 ",0.354852," 0,00 "," 5.054,92 "," 3.095,00 ",2824424736,CFD," 0,00 "
03/10/2024 18:12:13,Position closed,NSDQ100/USD," 362,29 ",0.354852," 12,29 "," 5.067,21 "," 3.457,29 ",2824424736,CFD," 0,00 "
03/10/2024 18:12:25,Position closed,NSDQ100/USD," 255,98 ",0.253325," 5,99 "," 5.073,20 "," 3.713,27 ",2824407772,CFD," 0,00 "
03/10/2024 18:13:18,Position closed,NSDQ100/USD," 151,73 ",0.151953," 1,74 "," 5.074,94 "," 3.865,00 ",2824406029,CFD," 0,00 "
03/10/2024 18:13:26,Position closed,NSDQ100/USD," 351,64 ",0.354438," 1,64 "," 5.076,58 "," 4.216,64 ",2824405928,CFD," 0,00 "
03/10/2024 18:13:40,Open Position,NSDQ100/USD," 250,00 ",0.253115," 0,00 "," 5.076,58 "," 3.966,64 ",2824456984,CFD," 0,00 "
03/10/2024 18:21:11,Open Position,NSDQ100/USD," 200,00 ",0.202399," 0,00 "," 5.076,58 "," 3.766,64 ",2824467974,CFD," 0,00 "
03/10/2024 19:45:58,Open Position,NSDQ100/USD," 200,00 ",0.202574," 0,00 "," 5.076,58 "," 3.566,64 ",2824510618,CFD," 0,00 "
03/10/2024 19:54:42,Position closed,NSDQ100/USD," 203,72 ",0.202574," 3,72 "," 5.080,30 "," 3.770,36 ",2824510618,CFD," 0,00 "
03/10/2024 19:55:01,Position closed,NSDQ100/USD," 202,11 ",0.202399," 2,11 "," 5.082,41 "," 3.972,47 ",2824467974,CFD," 0,00 "
03/10/2024 19:55:16,Position closed,NSDQ100/USD," 255,78 ",0.253115," 5,78 "," 5.088,19 "," 4.228,25 ",2824456984,CFD," 0,00 "
03/10/2024 19:55:29,Position closed,NSDQ100/USD," 99,22 ",0.101089,"(0,77)"," 5.087,42 "," 4.327,47 ",2824400929,CFD," 0,00 "
03/10/2024 20:07:23,Position closed,NSDQ100/USD," 148,80 ",0.151368,"(1,18)"," 5.086,24 "," 4.476,27 ",2824394459,CFD," 0,00 "
03/10/2024 22:05:37,Open Position,NSDQ100/USD," 199,99 ",0.202452," 0,00 "," 5.086,24 "," 4.276,28 ",2824527710,CFD," 0,00 "
04/10/2024 00:48:21,Overnight fee,Daily,"(0,78)",-,"(0,78)"," 5.085,46 "," 4.275,50 ",2824390488,CFD," 0,00 "
04/10/2024 00:48:21,Overnight fee,Daily,"(0,82)",-,"(0,82)"," 5.084,64 "," 4.274,68 ",2824052639,CFD," 0,00 "
04/10/2024 00:48:21,Overnight fee,Daily,"(1,54)",-,"(1,54)"," 5.083,10 "," 4.273,14 ",2824054464,CFD," 0,00 "
04/10/2024 06:06:11,Position closed,NSDQ100/USD," 211,48 ",0.202452," 11,49 "," 5.094,59 "," 4.484,62 ",2824527710,CFD," 0,00 "
04/10/2024 06:06:19,Position closed,NSDQ100/USD," 146,69 ",0.151233,"(3,30)"," 5.091,29 "," 4.631,31 ",2824390488,CFD," 0,00 "
04/10/2024 07:36:26,Open Position,NSDQ100/USD," 149,99 ",0.151285," 0,00 "," 5.091,29 "," 4.481,32 ",2824611894,CFD," 0,00 "
04/10/2024 07:51:43,Position closed,NSDQ100/USD," 151,43 ",0.151285," 1,44 "," 5.092,73 "," 4.632,75 ",2824611894,CFD," 0,00 "
04/10/2024 07:52:47,Open Position,NSDQ100/USD," 249,99 ",0.252042," 0,00 "," 5.092,73 "," 4.382,76 ",2824617175,CFD," 0,00 "
04/10/2024 07:54:45,Position closed,NSDQ100/USD," 252,11 ",0.252042," 2,12 "," 5.094,85 "," 4.634,87 ",2824617175,CFD," 0,00 "
04/10/2024 08:09:13,Open Position,NSDQ100/USD," 169,99 ",0.171498," 0,00 "," 5.094,85 "," 4.464,88 ",2824620728,CFD," 0,00 "
04/10/2024 08:52:06,Position closed,NSDQ100/USD," 170,87 ",0.171498," 0,88 "," 5.095,73 "," 4.635,75 ",2824620728,CFD," 0,00 "
04/10/2024 08:53:41,Open Position,NSDQ100/USD," 249,99 ",0.252162," 0,00 "," 5.095,73 "," 4.385,76 ",2824629740,CFD," 0,00 "
04/10/2024 09:44:28,Position closed,NSDQ100/USD," 250,60 ",0.252162," 0,61 "," 5.096,34 "," 4.636,36 ",2824629740,CFD," 0,00 "
04/10/2024 10:00:31,Position closed,NSDQ100/USD," 152,04 ",0.160800,"(7,95)"," 5.088,39 "," 4.788,40 ",2824052639,CFD," 0,00 "
04/10/2024 10:17:33,Position closed,NSDQ100/USD," 291,93 ",0.301461,"(8,06)"," 5.080,33 "," 5.080,33 ",2824054464,CFD," 0,00 "
04/10/2024 10:51:31,Open Position,NSDQ100/USD," 300,00 ",0.302079," 0,00 "," 5.080,33 "," 4.780,33 ",2824653303,CFD," 0,00 "
04/10/2024 11:13:06,Position closed,NSDQ100/USD," 300,10 ",0.302079," 0,10 "," 5.080,43 "," 5.080,43 ",2824653303,CFD," 0,00 "
04/10/2024 12:09:56,Open Position,NSDQ100/USD," 149,99 ",0.150992," 0,00 "," 5.080,43 "," 4.930,44 ",2824696501,CFD," 0,00 "
04/10/2024 12:30:27,Position closed,NSDQ100/USD," 161,74 ",0.150992," 11,75 "," 5.092,18 "," 5.092,18 ",2824696501,CFD," 0,00 "
04/10/2024 12:31:09,Open Position,NSDQ100/USD," 299,99 ",0.301250," 0,00 "," 5.092,18 "," 4.792,19 ",2824794853,CFD," 0,00 "
04/10/2024 12:32:02,Position closed,NSDQ100/USD," 299,36 ",0.301250,"(0,63)"," 5.091,55 "," 5.091,55 ",2824794853,CFD," 0,00 "
04/10/2024 12:32:39,Open Position,NSDQ100/USD," 299,99 ",0.301116," 0,00 "," 5.091,55 "," 4.791,56 ",2824796469,CFD," 0,00 "
04/10/2024 12:32:55,Position closed,NSDQ100/USD," 303,31 ",0.301116," 3,32 "," 5.094,87 "," 5.094,87 ",2824796469,CFD," 0,00 "
04/10/2024 12:33:16,Open Position,NSDQ100/USD," 299,98 ",0.301447," 0,00 "," 5.094,87 "," 4.794,89 ",2824797042,CFD," 0,00 "
04/10/2024 12:34:40,Position closed,NSDQ100/USD," 293,77 ",0.301447,"(6,21)"," 5.088,66 "," 5.088,66 ",2824797042,CFD," 0,00 "
04/10/2024 12:37:15,Open Position,NSDQ100/USD," 300,00 ",0.300247," 0,00 "," 5.088,66 "," 4.788,66 ",2824800301,CFD," 0,00 "
04/10/2024 12:38:32,Open Position,NSDQ100/USD," 300,00 ",0.300235," 0,00 "," 5.088,66 "," 4.488,66 ",2824801136,CFD," 0,00 "
04/10/2024 12:39:06,Position closed,NSDQ100/USD," 302,82 ",0.300247," 2,82 "," 5.091,48 "," 4.791,48 ",2824800301,CFD," 0,00 "
04/10/2024 12:39:10,Position closed,NSDQ100/USD," 302,19 ",0.300235," 2,19 "," 5.093,67 "," 5.093,67 ",2824801136,CFD," 0,00 "
04/10/2024 12:39:29,Open Position,NSDQ100/USD," 250,00 ",0.250087," 0,00 "," 5.093,67 "," 4.843,67 ",2824801785,CFD," 0,00 "
04/10/2024 12:47:54,Position closed,NSDQ100/USD," 254,78 ",0.250087," 4,78 "," 5.098,45 "," 5.098,45 ",2824801785,CFD," 0,00 "
04/10/2024 12:48:20,Open Position,NSDQ100/USD," 300,00 ",0.299781," 0,00 "," 5.098,45 "," 4.798,45 ",2824807028,CFD," 0,00 "
04/10/2024 12:50:17,Position closed,NSDQ100/USD," 301,47 ",0.299781," 1,47 "," 5.099,92 "," 5.099,92 ",2824807028,CFD," 0,00 "
04/10/2024 12:50:50,Open Position,NSDQ100/USD," 199,99 ",0.199744," 0,00 "," 5.099,92 "," 4.899,93 ",2824808580,CFD," 0,00 "
04/10/2024 12:52:06,Position closed,NSDQ100/USD," 200,73 ",0.199744," 0,74 "," 5.100,66 "," 5.100,66 ",2824808580,CFD," 0,00 "
04/10/2024 12:52:37,Open Position,NSDQ100/USD," 199,99 ",0.199602," 0,00 "," 5.100,66 "," 4.900,67 ",2824809775,CFD," 0,00 "
04/10/2024 12:53:08,Position closed,NSDQ100/USD," 198,55 ",0.199602,"(1,44)"," 5.099,22 "," 5.099,22 ",2824809775,CFD," 0,00 "
04/10/2024 13:22:12,Open Position,NSDQ100/USD," 199,99 ",0.199528," 0,00 "," 5.099,22 "," 4.899,23 ",2824822899,CFD," 0,00 "
04/10/2024 13:34:14,Open Position,NSDQ100/USD," 249,99 ",0.249785," 0,00 "," 5.099,22 "," 4.649,24 ",2824928007,CFD," 0,00 "
04/10/2024 13:35:15,Position closed,NSDQ100/USD," 252,24 ",0.249785," 2,25 "," 5.101,47 "," 4.901,48 ",2824928007,CFD," 0,00 "
04/10/2024 13:35:34,Open Position,NSDQ100/USD," 149,99 ",0.149819," 0,00 "," 5.101,47 "," 4.751,49 ",2824948146,CFD," 0,00 "
04/10/2024 13:45:01,Open Position,NSDQ100/USD," 99,99 ",0.099952," 0,00 "," 5.101,47 "," 4.651,50 ",2824966112,CFD," 0,00 "
04/10/2024 13:45:12,Open Position,NSDQ100/USD," 99,99 ",0.099936," 0,00 "," 5.101,47 "," 4.551,51 ",2824966380,CFD," 0,00 "
04/10/2024 13:51:49,Position closed,NSDQ100/USD," 97,46 ",0.099952,"(2,53)"," 5.098,94 "," 4.648,97 ",2824966112,CFD," 0,00 "
04/10/2024 13:52:38,Position closed,NSDQ100/USD," 98,30 ",0.099936,"(1,69)"," 5.097,25 "," 4.747,27 ",2824966380,CFD," 0,00 "
04/10/2024 13:53:10,Open Position,NSDQ100/USD," 199,99 ",0.200123," 0,00 "," 5.097,25 "," 4.547,28 ",2825061403,CFD," 0,00 "
04/10/2024 14:15:39,Position closed,NSDQ100/USD," 222,11 ",0.200123," 22,12 "," 5.119,37 "," 4.769,39 ",2825061403,CFD," 0,00 "
04/10/2024 14:16:18,Open Position,NSDQ100/USD," 499,99 ",0.503138," 0,00 "," 5.119,37 "," 4.269,40 ",2825184774,CFD," 0,00 "
04/10/2024 14:17:08,Position closed,NSDQ100/USD," 510,26 ",0.503138," 10,27 "," 5.129,64 "," 4.779,66 ",2825184774,CFD," 0,00 "
04/10/2024 14:17:37,Open Position,NSDQ100/USD," 149,99 ",0.150654," 0,00 "," 5.129,64 "," 4.629,67 ",2825189924,CFD," 0,00 "
04/10/2024 14:18:31,Open Position,NSDQ100/USD," 300,00 ",0.301424," 0,00 "," 5.129,64 "," 4.329,67 ",2825190885,CFD," 0,00 "
04/10/2024 14:24:38,Position closed,NSDQ100/USD," 312,48 ",0.301424," 12,48 "," 5.142,12 "," 4.642,15 ",2825190885,CFD," 0,00 "
04/10/2024 14:25:22,Open Position,NSDQ100/USD," 199,99 ",0.201398," 0,00 "," 5.142,12 "," 4.442,16 ",2825205713,CFD," 0,00 "
04/10/2024 14:26:56,Position closed,NSDQ100/USD," 200,72 ",0.201398," 0,73 "," 5.142,85 "," 4.642,88 ",2825205713,CFD," 0,00 "
04/10/2024 14:27:13,Open Position,NSDQ100/USD," 300,00 ",0.302445," 0,00 "," 5.142,85 "," 4.342,88 ",2825208622,CFD," 0,00 "
04/10/2024 14:29:01,Position closed,NSDQ100/USD," 300,79 ",0.302445," 0,79 "," 5.143,64 "," 4.643,67 ",2825208622,CFD," 0,00 "
04/10/2024 14:29:29,Open Position,NSDQ100/USD," 150,00 ",0.151227," 0,00 "," 5.143,64 "," 4.493,67 ",2825211682,CFD," 0,00 "
04/10/2024 14:30:59,Position closed,NSDQ100/USD," 149,84 ",0.151227,"(0,16)"," 5.143,48 "," 4.643,51 ",2825211682,CFD," 0,00 "
04/10/2024 14:31:09,Open Position,NSDQ100/USD," 350,00 ",0.352830," 0,00 "," 5.143,48 "," 4.293,51 ",2825214115,CFD," 0,00 "
04/10/2024 14:32:54,Position closed,NSDQ100/USD," 353,89 ",0.352830," 3,89 "," 5.147,37 "," 4.647,40 ",2825214115,CFD," 0,00 "
04/10/2024 14:33:24,Open Position,NSDQ100/USD," 299,98 ",0.302144," 0,00 "," 5.147,37 "," 4.347,42 ",2825215758,CFD," 0,00 "
04/10/2024 14:34:02,Open Position,NSDQ100/USD," 300,00 ",0.302346," 0,00 "," 5.147,37 "," 4.047,42 ",2825217053,CFD," 0,00 "
04/10/2024 14:37:02,Open Position,NSDQ100/USD," 299,99 ",0.302184," 0,00 "," 5.147,37 "," 3.747,43 ",2825220796,CFD," 0,00 "
04/10/2024 14:40:23,Open Position,NSDQ100/USD," 200,00 ",0.201301," 0,00 "," 5.147,37 "," 3.547,43 ",2825224903,CFD," 0,00 "
04/10/2024 14:40:55,Position closed,NSDQ100/USD," 307,13 ",0.302184," 7,14 "," 5.154,51 "," 3.854,56 ",2825220796,CFD," 0,00 "
04/10/2024 14:41:10,Position closed,NSDQ100/USD," 200,95 ",0.201301," 0,95 "," 5.155,46 "," 4.055,51 ",2825224903,CFD," 0,00 "
04/10/2024 14:41:18,Position closed,NSDQ100/USD," 286,10 ",0.302346,"(13,90)"," 5.141,56 "," 4.341,61 ",2825217053,CFD," 0,00 "
04/10/2024 14:41:25,Position closed,NSDQ100/USD," 307,15 ",0.302144," 7,17 "," 5.148,73 "," 4.648,76 ",2825215758,CFD," 0,00 "
04/10/2024 14:41:50,Open Position,NSDQ100/USD," 249,99 ",0.251595," 0,00 "," 5.148,73 "," 4.398,77 ",2825226903,CFD," 0,00 "
04/10/2024 14:43:54,Position closed,NSDQ100/USD," 252,46 ",0.251595," 2,47 "," 5.151,20 "," 4.651,23 ",2825226903,CFD," 0,00 "
04/10/2024 14:44:10,Open Position,NSDQ100/USD," 299,99 ",0.301713," 0,00 "," 5.151,20 "," 4.351,24 ",2825229958,CFD," 0,00 "
04/10/2024 14:45:25,Position closed,NSDQ100/USD," 303,01 ",0.301713," 3,02 "," 5.154,22 "," 4.654,25 ",2825229958,CFD," 0,00 "
04/10/2024 14:45:52,Open Position,NSDQ100/USD," 250,00 ",0.251468," 0,00 "," 5.154,22 "," 4.404,25 ",2825232184,CFD," 0,00 "
04/10/2024 14:46:31,Open Position,NSDQ100/USD," 299,99 ",0.301755," 0,00 "," 5.154,22 "," 4.104,26 ",2825232548,CFD," 0,00 "
04/10/2024 14:47:19,Position closed,NSDQ100/USD," 250,26 ",0.251468," 0,26 "," 5.154,48 "," 4.354,52 ",2825232184,CFD," 0,00 "
04/10/2024 14:47:39,Open Position,NSDQ100/USD," 299,99 ",0.301928," 0,00 "," 5.154,48 "," 4.054,53 ",2825233594,CFD," 0,00 "
04/10/2024 14:48:56,Position closed,NSDQ100/USD," 305,37 ",0.301928," 5,38 "," 5.159,86 "," 4.359,90 ",2825233594,CFD," 0,00 "
04/10/2024 14:49:11,Position closed,NSDQ100/USD," 303,19 ",0.301755," 3,20 "," 5.163,06 "," 4.663,09 ",2825232548,CFD," 0,00 "
04/10/2024 14:49:29,Open Position,NSDQ100/USD," 299,98 ",0.301602," 0,00 "," 5.163,06 "," 4.363,11 ",2825234892,CFD," 0,00 "
04/10/2024 14:49:58,Open Position,NSDQ100/USD," 149,99 ",0.150797," 0,00 "," 5.163,06 "," 4.213,12 ",2825235273,CFD," 0,00 "
04/10/2024 14:50:53,Position closed,NSDQ100/USD," 150,97 ",0.150797," 0,98 "," 5.164,04 "," 4.364,09 ",2825235273,CFD," 0,00 "
04/10/2024 14:51:05,Position closed,NSDQ100/USD," 301,71 ",0.301602," 1,73 "," 5.165,77 "," 4.665,80 ",2825234892,CFD," 0,00 "
04/10/2024 14:51:21,Open Position,NSDQ100/USD," 249,99 ",0.251126," 0,00 "," 5.165,77 "," 4.415,81 ",2825236505,CFD," 0,00 "
04/10/2024 14:52:41,Position closed,NSDQ100/USD," 150,73 ",0.150654," 0,74 "," 5.166,51 "," 4.566,54 ",2825189924,CFD," 0,00 "
04/10/2024 14:52:56,Position closed,NSDQ100/USD," 251,50 ",0.251126," 1,51 "," 5.168,02 "," 4.818,04 ",2825236505,CFD," 0,00 "
04/10/2024 14:53:17,Open Position,NSDQ100/USD," 249,98 ",0.251034," 0,00 "," 5.168,02 "," 4.568,06 ",2825237965,CFD," 0,00 "
04/10/2024 14:54:54,Open Position,NSDQ100/USD," 200,00 ",0.200887," 0,00 "," 5.168,02 "," 4.368,06 ",2825239544,CFD," 0,00 "
04/10/2024 14:57:23,Position closed,NSDQ100/USD," 199,12 ",0.200887,"(0,88)"," 5.167,14 "," 4.567,18 ",2825239544,CFD," 0,00 "
04/10/2024 14:57:40,Open Position,NSDQ100/USD," 299,99 ",0.301491," 0,00 "," 5.167,14 "," 4.267,19 ",2825243493,CFD," 0,00 "
04/10/2024 14:59:57,Position closed,NSDQ100/USD," 252,07 ",0.251034," 2,09 "," 5.169,23 "," 4.519,26 ",2825237965,CFD," 0,00 "
04/10/2024 15:00:04,Position closed,NSDQ100/USD," 290,50 ",0.301491,"(9,49)"," 5.159,74 "," 4.809,76 ",2825243493,CFD," 0,00 "
04/10/2024 15:00:54,Open Position,NSDQ100/USD," 249,99 ",0.250797," 0,00 "," 5.159,74 "," 4.559,77 ",2825245607,CFD," 0,00 "
04/10/2024 15:03:26,Position closed,NSDQ100/USD," 253,15 ",0.250797," 3,16 "," 5.162,90 "," 4.812,92 ",2825245607,CFD," 0,00 "
04/10/2024 15:04:14,Open Position,NSDQ100/USD," 249,99 ",0.250592," 0,00 "," 5.162,90 "," 4.562,93 ",2825251306,CFD," 0,00 "
04/10/2024 15:12:40,Open Position,NSDQ100/USD," 159,99 ",0.160516," 0,00 "," 5.162,90 "," 4.402,94 ",2825263493,CFD," 0,00 "
04/10/2024 15:20:49,Open Position,NSDQ100/USD," 249,99 ",0.251342," 0,00 "," 5.162,90 "," 4.152,95 ",2825279704,CFD," 0,00 "
04/10/2024 15:26:41,Open Position,NSDQ100/USD," 350,00 ",0.352267," 0,00 "," 5.162,90 "," 3.802,95 ",2825293791,CFD," 0,00 "
04/10/2024 15:28:45,Open Position,NSDQ100/USD," 299,99 ",0.302080," 0,00 "," 5.162,90 "," 3.502,96 ",2825297024,CFD," 0,00 "
04/10/2024 15:30:01,Open Position,NSDQ100/USD," 199,99 ",0.201443," 0,00 "," 5.162,90 "," 3.302,97 ",2825298393,CFD," 0,00 "
04/10/2024 15:59:59,Position closed,NSDQ100/USD," 261,93 ",0.251342," 11,94 "," 5.174,84 "," 3.564,90 ",2825279704,CFD," 0,00 "
04/10/2024 16:00:00,Position closed,NSDQ100/USD," 323,71 ",0.302080," 23,72 "," 5.198,56 "," 3.888,61 ",2825297024,CFD," 0,00 "
04/10/2024 16:00:00,Position closed,NSDQ100/USD," 161,05 ",0.160516," 1,06 "," 5.199,62 "," 4.049,66 ",2825263493,CFD," 0,00 "
04/10/2024 16:00:00,Position closed,NSDQ100/USD," 375,01 ",0.352267," 25,01 "," 5.224,63 "," 4.424,67 ",2825293791,CFD," 0,00 "
04/10/2024 16:03:36,Position closed,NSDQ100/USD," 184,32 ",0.201443,"(15,67)"," 5.208,96 "," 4.608,99 ",2825298393,CFD," 0,00 "
04/10/2024 16:03:59,Open Position,NSDQ100/USD," 200,00 ",0.200611," 0,00 "," 5.208,96 "," 4.408,99 ",2825326755,CFD," 0,00 "
04/10/2024 16:04:30,Open Position,NSDQ100/USD," 199,99 ",0.200652," 0,00 "," 5.208,96 "," 4.209,00 ",2825326977,CFD," 0,00 "
04/10/2024 16:20:49,Position closed,NSDQ100/USD," 204,16 ",0.200652," 4,17 "," 5.213,13 "," 4.413,16 ",2825326977,CFD," 0,00 "
04/10/2024 17:03:05,Position closed,NSDQ100/USD," 201,79 ",0.200611," 1,79 "," 5.214,92 "," 4.614,95 ",2825326755,CFD," 0,00 "
04/10/2024 17:07:08,Open Position,NSDQ100/USD," 149,99 ",0.150384," 0,00 "," 5.214,92 "," 4.464,96 ",2825378276,CFD," 0,00 "
04/10/2024 17:17:21,Position closed,NSDQ100/USD," 252,60 ",0.250592," 2,61 "," 5.217,53 "," 4.717,56 ",2825251306,CFD," 0,00 "
04/10/2024 17:23:38,Position closed,NSDQ100/USD," 151,48 ",0.150384," 1,49 "," 5.219,02 "," 4.869,04 ",2825378276,CFD," 0,00 "
04/10/2024 17:31:45,Open Position,NSDQ100/USD," 200,00 ",0.200418," 0,00 "," 5.219,02 "," 4.669,04 ",2825393699,CFD," 0,00 "
04/10/2024 17:36:23,Open Position,NSDQ100/USD," 149,99 ",0.150504," 0,00 "," 5.219,02 "," 4.519,05 ",2825397063,CFD," 0,00 "
04/10/2024 18:02:48,Open Position,NSDQ100/USD," 149,99 ",0.150620," 0,00 "," 5.219,02 "," 4.369,06 ",2825410787,CFD," 0,00 "
04/10/2024 18:38:48,Position closed,NSDQ100/USD," 153,50 ",0.150620," 3,51 "," 5.222,53 "," 4.522,56 ",2825410787,CFD," 0,00 "
04/10/2024 18:38:56,Position closed,NSDQ100/USD," 151,50 ",0.150504," 1,51 "," 5.224,04 "," 4.674,06 ",2825397063,CFD," 0,00 "
04/10/2024 18:56:05,Position closed,NSDQ100/USD," 199,98 ",0.200418,"(0,02)"," 5.224,02 "," 4.874,04 ",2825393699,CFD," 0,00 "
04/10/2024 19:07:55,Position closed,NSDQ100/USD," 184,20 ",0.199528,"(15,79)"," 5.208,23 "," 5.058,24 ",2824822899,CFD," 0,00 "
04/10/2024 19:07:55,Position closed,NSDQ100/USD," 141,60 ",0.149819,"(8,39)"," 5.199,84 "," 5.199,84 ",2824948146,CFD," 0,00 "
04/10/2024 19:16:01,Open Position,NSDQ100/USD," 399,98 ",0.400722," 0,00 "," 5.199,84 "," 4.799,86 ",2825446546,CFD," 0,00 "
04/10/2024 19:27:14,Position closed,NSDQ100/USD," 389,24 ",0.400722,"(10,74)"," 5.189,10 "," 5.189,10 ",2825446546,CFD," 0,00 "
05/10/2024 20:37:40,Open Position,SOL/USD," 100,00 ",1.397573," 0,00 "," 5.189,10 "," 5.089,10 ",2825502255,CFD," 0,00 "
06/10/2024 00:46:47,Overnight fee,Daily,"(0,12)",-,"(0,12)"," 5.188,98 "," 5.088,98 ",2825502255,CFD," 0,00 "
06/10/2024 14:26:57,Position closed,SOL/USD," 100,98 ",1.397573," 0,98 "," 5.189,96 "," 5.189,96 ",2825502255,CFD," 0,00 "
06/10/2024 22:45:28,Open Position,NSDQ100/USD," 300,00 ",0.299211," 0,00 "," 5.189,96 "," 4.889,96 ",2825527546,CFD," 0,00 "
06/10/2024 22:46:17,Open Position,NSDQ100/USD," 354,99 ",0.354135," 0,00 "," 5.189,96 "," 4.534,97 ",2825527569,CFD," 0,00 "
06/10/2024 23:05:07,Position closed,NSDQ100/USD," 304,06 ",0.299211," 4,06 "," 5.194,02 "," 4.839,03 ",2825527546,CFD," 0,00 "
06/10/2024 23:06:36,Position closed,NSDQ100/USD," 349,82 ",0.354135,"(5,17)"," 5.188,85 "," 5.188,85 ",2825527569,CFD," 0,00 "
06/10/2024 23:07:16,Open Position,NSDQ100/USD," 299,99 ",0.299086," 0,00 "," 5.188,85 "," 4.888,86 ",2825528779,CFD," 0,00 "
06/10/2024 23:08:25,Open Position,NSDQ100/USD," 119,99 ",0.119626," 0,00 "," 5.188,85 "," 4.768,87 ",2825528825,CFD," 0,00 "
07/10/2024 00:05:48,Position closed,NSDQ100/USD," 312,52 ",0.299086," 12,53 "," 5.201,38 "," 5.081,39 ",2825528779,CFD," 0,00 "
07/10/2024 00:06:42,Open Position,NSDQ100/USD," 199,99 ",0.199773," 0,00 "," 5.201,38 "," 4.881,40 ",2825534124,CFD," 0,00 "
07/10/2024 00:07:26,Position closed,NSDQ100/USD," 199,49 ",0.199773,"(0,50)"," 5.200,88 "," 5.080,89 ",2825534124,CFD," 0,00 "
07/10/2024 05:27:15,Open Position,NSDQ100/USD," 300,00 ",0.299787," 0,00 "," 5.200,88 "," 4.780,89 ",2825567058,CFD," 0,00 "
07/10/2024 07:46:25,Open Position,NSDQ100/USD," 499,99 ",0.501057," 0,00 "," 5.200,88 "," 4.280,90 ",2825658100,CFD," 0,00 "
07/10/2024 08:06:39,Open Position,NSDQ100/USD," 249,99 ",0.250503," 0,00 "," 5.200,88 "," 4.030,91 ",2825688052,CFD," 0,00 "
07/10/2024 09:27:08,Open Position,NSDQ100/USD," 300,00 ",0.301987," 0,00 "," 5.200,88 "," 3.730,91 ",2825756314,CFD," 0,00 "
07/10/2024 09:55:00,Open Position,NSDQ100/USD," 249,99 ",0.251365," 0,00 "," 5.200,88 "," 3.480,92 ",2825764881,CFD," 0,00 "
07/10/2024 09:58:14,Position closed,NSDQ100/USD," 307,56 ",0.301987," 7,56 "," 5.208,44 "," 3.788,48 ",2825756314,CFD," 0,00 "
07/10/2024 10:04:56,Open Position,NSDQ100/USD," 300,00 ",0.301550," 0,00 "," 5.208,44 "," 3.488,48 ",2825767102,CFD," 0,00 "
07/10/2024 10:13:25,Open Position,NSDQ100/USD," 199,99 ",0.201173," 0,00 "," 5.208,44 "," 3.288,49 ",2825768936,CFD," 0,00 "
07/10/2024 10:38:53,Position closed,NSDQ100/USD," 252,33 ",0.251365," 2,34 "," 5.210,78 "," 3.540,82 ",2825764881,CFD," 0,00 "
07/10/2024 10:39:42,Position closed,NSDQ100/USD," 203,21 ",0.201173," 3,22 "," 5.214,00 "," 3.744,03 ",2825768936,CFD," 0,00 "
07/10/2024 10:39:49,Position closed,NSDQ100/USD," 300,46 ",0.301550," 0,46 "," 5.214,46 "," 4.044,49 ",2825767102,CFD," 0,00 "
07/10/2024 10:40:30,Open Position,NSDQ100/USD," 300,00 ",0.301480," 0,00 "," 5.214,46 "," 3.744,49 ",2825783883,CFD," 0,00 "
07/10/2024 11:39:00,Open Position,NSDQ100/USD," 199,99 ",0.200971," 0,00 "," 5.214,46 "," 3.544,50 ",2825797852,CFD," 0,00 "
07/10/2024 12:51:51,Position closed,NSDQ100/USD," 206,18 ",0.200971," 6,19 "," 5.220,65 "," 3.750,68 ",2825797852,CFD," 0,00 "
07/10/2024 12:51:58,Position closed,NSDQ100/USD," 309,59 ",0.301480," 9,59 "," 5.230,24 "," 4.060,27 ",2825783883,CFD," 0,00 "
07/10/2024 12:53:33,Open Position,NSDQ100/USD," 300,00 ",0.300967," 0,00 "," 5.230,24 "," 3.760,27 ",2825828480,CFD," 0,00 "
07/10/2024 13:23:42,Open Position,NSDQ100/USD," 300,00 ",0.300859," 0,00 "," 5.230,24 "," 3.460,27 ",2825838166,CFD," 0,00 "
07/10/2024 13:27:44,Position closed,NSDQ100/USD," 301,54 ",0.300967," 1,54 "," 5.231,78 "," 3.761,81 ",2825828480,CFD," 0,00 "
07/10/2024 13:30:06,Open Position,NSDQ100/USD," 249,99 ",0.250614," 0,00 "," 5.231,78 "," 3.511,82 ",2825840539,CFD," 0,00 "
07/10/2024 13:30:24,Position closed,NSDQ100/USD," 304,71 ",0.300859," 4,71 "," 5.236,49 "," 3.816,53 ",2825838166,CFD," 0,00 "
07/10/2024 13:30:42,Position closed,NSDQ100/USD," 501,52 ",0.501057," 1,53 "," 5.238,02 "," 4.318,05 ",2825658100,CFD," 0,00 "
07/10/2024 13:30:48,Position closed,NSDQ100/USD," 249,59 ",0.250614,"(0,40)"," 5.237,62 "," 4.567,64 ",2825840539,CFD," 0,00 "
07/10/2024 13:31:45,Open Position,NSDQ100/USD," 299,98 ",0.300762," 0,00 "," 5.237,62 "," 4.267,66 ",2825910828,CFD," 0,00 "
07/10/2024 13:32:33,Open Position,NSDQ100/USD," 200,00 ",0.200588," 0,00 "," 5.237,62 "," 4.067,66 ",2825953516,CFD," 0,00 "
07/10/2024 13:33:51,Open Position,NSDQ100/USD," 299,99 ",0.300828," 0,00 "," 5.237,62 "," 3.767,67 ",2826006721,CFD," 0,00 "
07/10/2024 13:34:52,Position closed,NSDQ100/USD," 200,02 ",0.200588," 0,02 "," 5.237,64 "," 3.967,69 ",2825953516,CFD," 0,00 "
07/10/2024 13:35:06,Position closed,NSDQ100/USD," 300,96 ",0.300828," 0,97 "," 5.238,61 "," 4.268,65 ",2826006721,CFD," 0,00 "
07/10/2024 13:35:55,Open Position,NSDQ100/USD," 200,00 ",0.200479," 0,00 "," 5.238,61 "," 4.068,65 ",2826015906,CFD," 0,00 "
07/10/2024 13:36:18,Position closed,NSDQ100/USD," 303,68 ",0.300762," 3,70 "," 5.242,31 "," 4.372,33 ",2825910828,CFD," 0,00 "
07/10/2024 13:36:56,Open Position,NSDQ100/USD," 299,99 ",0.300674," 0,00 "," 5.242,31 "," 4.072,34 ",2826020940,CFD," 0,00 "
07/10/2024 13:38:43,Position closed,NSDQ100/USD," 202,55 ",0.200479," 2,55 "," 5.244,86 "," 4.274,89 ",2826015906,CFD," 0,00 "
07/10/2024 13:38:58,Position closed,NSDQ100/USD," 300,23 ",0.300674," 0,24 "," 5.245,10 "," 4.575,12 ",2826020940,CFD," 0,00 "
07/10/2024 13:39:31,Open Position,NSDQ100/USD," 400,00 ",0.400838," 0,00 "," 5.245,10 "," 4.175,12 ",2826028783,CFD," 0,00 "
07/10/2024 13:40:12,Open Position,NSDQ100/USD," 250,00 ",0.250618," 0,00 "," 5.245,10 "," 3.925,12 ",2826032358,CFD," 0,00 "
07/10/2024 13:43:06,Open Position,NSDQ100/USD," 299,99 ",0.301052," 0,00 "," 5.245,10 "," 3.625,13 ",2826058824,CFD," 0,00 "
07/10/2024 13:45:59,Open Position,NSDQ100/USD," 299,99 ",0.301279," 0,00 "," 5.245,10 "," 3.325,14 ",2826065130,CFD," 0,00 "
07/10/2024 13:46:45,Position closed,NSDQ100/USD," 304,39 ",0.301279," 4,40 "," 5.249,50 "," 3.629,53 ",2826065130,CFD," 0,00 "
07/10/2024 13:47:41,Position closed,NSDQ100/USD," 304,20 ",0.301052," 4,21 "," 5.253,71 "," 3.933,73 ",2826058824,CFD," 0,00 "
07/10/2024 13:47:56,Open Position,NSDQ100/USD," 400,00 ",0.401361," 0,00 "," 5.253,71 "," 3.533,73 ",2826070416,CFD," 0,00 "
07/10/2024 13:49:39,Position closed,NSDQ100/USD," 402,73 ",0.401361," 2,73 "," 5.256,44 "," 3.936,46 ",2826070416,CFD," 0,00 "
07/10/2024 13:50:06,Open Position,NSDQ100/USD," 400,00 ",0.401325," 0,00 "," 5.256,44 "," 3.536,46 ",2826073449,CFD," 0,00 "
07/10/2024 13:54:39,Open Position,NSDQ100/USD," 499,99 ",0.502284," 0,00 "," 5.256,44 "," 3.036,47 ",2826235332,CFD," 0,00 "
07/10/2024 13:55:16,Position closed,NSDQ100/USD," 503,46 ",0.502284," 3,47 "," 5.259,91 "," 3.539,93 ",2826235332,CFD," 0,00 "
07/10/2024 13:55:56,Open Position,NSDQ100/USD," 299,99 ",0.301296," 0,00 "," 5.259,91 "," 3.239,94 ",2826256327,CFD," 0,00 "
07/10/2024 13:56:52,Position closed,NSDQ100/USD," 304,54 ",0.301296," 4,55 "," 5.264,46 "," 3.544,48 ",2826256327,CFD," 0,00 "
07/10/2024 13:57:40,Open Position,NSDQ100/USD," 299,99 ",0.301225," 0,00 "," 5.264,46 "," 3.244,49 ",2826274202,CFD," 0,00 "
07/10/2024 14:03:59,Position closed,NSDQ100/USD," 301,32 ",0.301225," 1,33 "," 5.265,79 "," 3.545,81 ",2826274202,CFD," 0,00 "
07/10/2024 14:04:46,Position closed,NSDQ100/USD," 401,77 ",0.401325," 1,77 "," 5.267,56 "," 3.947,58 ",2826073449,CFD," 0,00 "
07/10/2024 14:05:08,Open Position,NSDQ100/USD," 350,00 ",0.351078," 0,00 "," 5.267,56 "," 3.597,58 ",2826293483,CFD," 0,00 "
07/10/2024 14:05:32,Position closed,NSDQ100/USD," 353,55 ",0.351078," 3,55 "," 5.271,11 "," 3.951,13 ",2826293483,CFD," 0,00 "
07/10/2024 14:05:44,Open Position,NSDQ100/USD," 350,00 ",0.350992," 0,00 "," 5.271,11 "," 3.601,13 ",2826295287,CFD," 0,00 "
07/10/2024 14:08:52,Open Position,NSDQ100/USD," 400,00 ",0.401593," 0,00 "," 5.271,11 "," 3.201,13 ",2826301572,CFD," 0,00 "
07/10/2024 14:10:02,Position closed,NSDQ100/USD," 402,49 ",0.401593," 2,49 "," 5.273,60 "," 3.603,62 ",2826301572,CFD," 0,00 "
07/10/2024 14:10:15,Open Position,NSDQ100/USD," 299,99 ",0.301037," 0,00 "," 5.273,60 "," 3.303,63 ",2826304343,CFD," 0,00 "
07/10/2024 14:17:57,Position closed,NSDQ100/USD," 309,89 ",0.301037," 9,90 "," 5.283,50 "," 3.613,52 ",2826304343,CFD," 0,00 "
07/10/2024 14:18:10,Position closed,NSDQ100/USD," 253,04 ",0.250503," 3,05 "," 5.286,55 "," 3.866,56 ",2825688052,CFD," 0,00 "
07/10/2024 14:18:28,Position closed,NSDQ100/USD," 403,37 ",0.400838," 3,37 "," 5.289,92 "," 4.269,93 ",2826028783,CFD," 0,00 "
07/10/2024 14:18:55,Position closed,NSDQ100/USD," 358,22 ",0.350992," 8,22 "," 5.298,14 "," 4.628,15 ",2826295287,CFD," 0,00 "
07/10/2024 14:19:53,Position closed,NSDQ100/USD," 254,21 ",0.250618," 4,21 "," 5.302,35 "," 4.882,36 ",2826032358,CFD," 0,00 "
07/10/2024 14:20:23,Open Position,NSDQ100/USD," 299,99 ",0.300419," 0,00 "," 5.302,35 "," 4.582,37 ",2826319308,CFD," 0,00 "
07/10/2024 14:30:05,Position closed,NSDQ100/USD," 302,09 ",0.300419," 2,10 "," 5.304,45 "," 4.884,46 ",2826319308,CFD," 0,00 "
07/10/2024 14:30:31,Open Position,NSDQ100/USD," 299,99 ",0.300267," 0,00 "," 5.304,45 "," 4.584,47 ",2826386036,CFD," 0,00 "
07/10/2024 14:31:40,Open Position,NSDQ100/USD," 299,99 ",0.300338," 0,00 "," 5.304,45 "," 4.284,48 ",2826388095,CFD," 0,00 "
07/10/2024 14:37:25,Open Position,NSDQ100/USD," 299,99 ",0.300437," 0,00 "," 5.304,45 "," 3.984,49 ",2826401560,CFD," 0,00 "
07/10/2024 14:39:10,Open Position,NSDQ100/USD," 200,00 ",0.200331," 0,00 "," 5.304,45 "," 3.784,49 ",2826403908,CFD," 0,00 "
07/10/2024 14:45:32,Open Position,NSDQ100/USD," 250,00 ",0.250588," 0,00 "," 5.304,45 "," 3.534,49 ",2826417617,CFD," 0,00 "
07/10/2024 15:06:50,Open Position,NSDQ100/USD," 400,00 ",0.401448," 0,00 "," 5.304,45 "," 3.134,49 ",2826448507,CFD," 0,00 "
07/10/2024 15:54:05,Position closed,NSDQ100/USD," 410,64 ",0.401448," 10,64 "," 5.315,09 "," 3.545,13 ",2826448507,CFD," 0,00 "
07/10/2024 15:54:14,Position closed,NSDQ100/USD," 251,38 ",0.250588," 1,38 "," 5.316,47 "," 3.796,51 ",2826417617,CFD," 0,00 "
07/10/2024 15:54:42,Open Position,NSDQ100/USD," 349,99 ",0.350570," 0,00 "," 5.316,47 "," 3.446,52 ",2826501554,CFD," 0,00 "
07/10/2024 16:34:26,Open Position,NSDQ100/USD," 200,00 ",0.200469," 0,00 "," 5.316,47 "," 3.246,52 ",2826540795,CFD," 0,00 "
07/10/2024 16:46:46,Open Position,NSDQ100/USD," 870,00 ",0.872970," 0,00 "," 5.316,47 "," 2.376,52 ",2826550215,CFD," 0,00 "
07/10/2024 17:12:58,Position closed,NSDQ100/USD," 895,14 ",0.872970," 25,14 "," 5.341,61 "," 3.271,66 ",2826550215,CFD," 0,00 "
07/10/2024 17:13:06,Position closed,NSDQ100/USD," 201,31 ",0.200469," 1,31 "," 5.342,92 "," 3.472,97 ",2826540795,CFD," 0,00 "
07/10/2024 17:31:55,Open Position,NSDQ100/USD," 869,99 ",0.872773," 0,00 "," 5.342,92 "," 2.602,98 ",2826622419,CFD," 0,00 "
07/10/2024 17:45:45,Open Position,NSDQ100/USD," 200,00 ",0.200544," 0,00 "," 5.342,92 "," 2.402,98 ",2826633637,CFD," 0,00 "
07/10/2024 18:31:47,Open Position,NSDQ100/USD," 609,98 ",0.613331," 0,00 "," 5.342,92 "," 1.793,00 ",2826668052,CFD," 0,00 "
07/10/2024 18:32:24,Open Position,NSDQ100/USD," 320,27 ",0.301729," 0,00 "," 5.342,92 "," 1.493,01 ",2826668565,CFD," 0,00 "
07/10/2024 18:34:12,Open Position,NSDQ100/USD," 380,00 ",0.382310," 0,00 "," 5.342,92 "," 1.113,01 ",2826671123,CFD," 0,00 "
07/10/2024 18:51:30,Open Position,NSDQ100/USD," 400,00 ",0.404115," 0,00 "," 5.342,92 "," 713,01 ",2826691966,CFD," 0,00 "
07/10/2024 18:57:47,Open Position,NSDQ100/USD," 200,00 ",0.201928," 0,00 "," 5.342,92 "," 513,01 ",2826697736,CFD," 0,00 "
07/10/2024 19:14:23,Position closed,NSDQ100/USD," 402,96 ",0.404115," 2,96 "," 5.345,88 "," 915,97 ",2826691966,CFD," 0,00 "
07/10/2024 19:18:02,Open Position,NSDQ100/USD," 349,99 ",0.353365," 0,00 "," 5.345,88 "," 565,98 ",2826712169,CFD," 0,00 "
07/10/2024 19:51:34,Position closed,NSDQ100/USD," 200,11 ",0.201928," 0,11 "," 5.345,99 "," 766,09 ",2826697736,CFD," 0,00 "
07/10/2024 19:52:01,Position closed,NSDQ100/USD," 351,48 ",0.353365," 1,49 "," 5.347,48 "," 1.117,57 ",2826712169,CFD," 0,00 "
07/10/2024 19:52:18,Open Position,NSDQ100/USD," 299,99 ",0.302717," 0,00 "," 5.347,48 "," 817,58 ",2826740896,CFD," 0,00 "
07/10/2024 20:38:46,Position closed,NSDQ100/USD," 303,43 ",0.302717," 3,44 "," 5.350,92 "," 1.121,01 ",2826740896,CFD," 0,00 "
07/10/2024 22:36:11,Open Position,NSDQ100/USD," 350,00 ",0.353959," 0,00 "," 5.350,92 "," 771,01 ",2826759532,CFD," 0,00 "
07/10/2024 22:36:46,Position closed,NSDQ100/USD," 357,87 ",0.353959," 7,87 "," 5.358,79 "," 1.128,88 ",2826759532,CFD," 0,00 "
07/10/2024 22:38:06,Open Position,NSDQ100/USD," 300,00 ",0.303051," 0,00 "," 5.358,79 "," 828,88 ",2826759864,CFD," 0,00 "
07/10/2024 22:41:18,Open Position,NSDQ100/USD," 199,99 ",0.202100," 0,00 "," 5.358,79 "," 628,89 ",2826760154,CFD," 0,00 "
08/10/2024 00:18:19,Index price adjustment,NSDQ100/USD," 0,01 ",-," 0,01 "," 5.358,80 "," 628,90 ",2825528825,CFD," 0,00 "
08/10/2024 00:18:19,Index price adjustment,NSDQ100/USD," 0,03 ",-," 0,03 "," 5.358,83 "," 628,93 ",2825567058,CFD," 0,00 "
08/10/2024 00:18:19,Index price adjustment,NSDQ100/USD," 0,03 ",-," 0,03 "," 5.358,86 "," 628,96 ",2826386036,CFD," 0,00 "
08/10/2024 00:18:19,Index price adjustment,NSDQ100/USD," 0,03 ",-," 0,03 "," 5.358,89 "," 628,99 ",2826388095,CFD," 0,00 "
08/10/2024 00:18:19,Index price adjustment,NSDQ100/USD," 0,03 ",-," 0,03 "," 5.358,92 "," 629,02 ",2826401560,CFD," 0,00 "
08/10/2024 00:18:19,Index price adjustment,NSDQ100/USD," 0,02 ",-," 0,02 "," 5.358,94 "," 629,04 ",2826403908,CFD," 0,00 "
08/10/2024 00:18:19,Index price adjustment,NSDQ100/USD," 0,04 ",-," 0,04 "," 5.358,98 "," 629,08 ",2826501554,CFD," 0,00 "
08/10/2024 00:18:19,Index price adjustment,NSDQ100/USD," 0,09 ",-," 0,09 "," 5.359,07 "," 629,17 ",2826622419,CFD," 0,00 "
08/10/2024 00:18:19,Index price adjustment,NSDQ100/USD," 0,02 ",-," 0,02 "," 5.359,09 "," 629,19 ",2826633637,CFD," 0,00 "
08/10/2024 00:18:19,Index price adjustment,NSDQ100/USD," 0,07 ",-," 0,07 "," 5.359,16 "," 629,26 ",2826668052,CFD," 0,00 "
08/10/2024 00:18:19,Index price adjustment,NSDQ100/USD," 0,03 ",-," 0,03 "," 5.359,19 "," 629,29 ",2826668565,CFD," 0,00 "
08/10/2024 00:18:19,Index price adjustment,NSDQ100/USD," 0,04 ",-," 0,04 "," 5.359,23 "," 629,33 ",2826671123,CFD," 0,00 "
08/10/2024 00:18:19,Index price adjustment,NSDQ100/USD," 0,03 ",-," 0,03 "," 5.359,26 "," 629,36 ",2826740896,CFD," 0,00 "
08/10/2024 00:48:21,Overnight fee,Daily,"(0,61)",-,"(0,61)"," 5.358,65 "," 628,75 ",2825528825,CFD," 0,00 "
08/10/2024 00:48:21,Overnight fee,Daily,"(1,03)",-,"(1,03)"," 5.357,62 "," 627,72 ",2826633637,CFD," 0,00 "
08/10/2024 00:48:21,Overnight fee,Daily,"(1,03)",-,"(1,03)"," 5.356,59 "," 626,69 ",2826403908,CFD," 0,00 "
08/10/2024 00:48:21,Overnight fee,Daily,"(1,53)",-,"(1,53)"," 5.355,06 "," 625,16 ",2825567058,CFD," 0,00 "
08/10/2024 00:48:21,Overnight fee,Daily,"(1,54)",-,"(1,54)"," 5.353,52 "," 623,62 ",2826401560,CFD," 0,00 "
08/10/2024 00:48:21,Overnight fee,Daily,"(1,54)",-,"(1,54)"," 5.351,98 "," 622,08 ",2826386036,CFD," 0,00 "
08/10/2024 00:48:21,Overnight fee,Daily,"(1,54)",-,"(1,54)"," 5.350,44 "," 620,54 ",2826388095,CFD," 0,00 "
08/10/2024 00:48:21,Overnight fee,Daily,"(1,54)",-,"(1,54)"," 5.348,90 "," 619,00 ",2826668565,CFD," 0,00 "
08/10/2024 00:48:21,Overnight fee,Daily,"(1,79)",-,"(1,79)"," 5.347,11 "," 617,21 ",2826501554,CFD," 0,00 "
08/10/2024 00:48:21,Overnight fee,Daily,"(1,96)",-,"(1,96)"," 5.345,15 "," 615,25 ",2826671123,CFD," 0,00 "
08/10/2024 00:48:21,Overnight fee,Daily,"(3,14)",-,"(3,14)"," 5.342,01 "," 612,11 ",2826668052,CFD," 0,00 "
08/10/2024 00:48:21,Overnight fee,Daily,"(4,47)",-,"(4,47)"," 5.337,54 "," 607,64 ",2826622419,CFD," 0,00 "
08/10/2024 04:53:07,Position closed,NSDQ100/USD," 204,20 ",0.202100," 4,21 "," 5.341,75 "," 811,84 ",2826760154,CFD," 0,00 "
08/10/2024 04:53:16,Position closed,NSDQ100/USD," 304,55 ",0.303051," 4,55 "," 5.346,30 "," 1.116,39 ",2826759864,CFD," 0,00 "
08/10/2024 06:13:08,Open Position,NSDQ100/USD," 299,99 ",0.303238," 0,00 "," 5.346,30 "," 816,40 ",2826813838,CFD," 0,00 "
08/10/2024 07:05:18,Open Position,NSDQ100/USD," 209,99 ",0.212357," 0,00 "," 5.346,30 "," 606,41 ",2826853765,CFD," 0,00 "
08/10/2024 07:11:15,Position closed,NSDQ100/USD," 214,01 ",0.212357," 4,02 "," 5.350,32 "," 820,42 ",2826853765,CFD," 0,00 "
08/10/2024 07:11:20,Position closed,NSDQ100/USD," 303,40 ",0.303238," 3,41 "," 5.353,73 "," 1.123,82 ",2826813838,CFD," 0,00 "
08/10/2024 07:12:32,Open Position,NSDQ100/USD," 290,00 ",0.292900," 0,00 "," 5.353,73 "," 833,82 ",2826857879,CFD," 0,00 "
08/10/2024 07:15:32,Open Position,NSDQ100/USD," 209,99 ",0.212270," 0,00 "," 5.353,73 "," 623,83 ",2826858731,CFD," 0,00 "
08/10/2024 07:27:54,Open Position,NSDQ100/USD," 249,99 ",0.253044," 0,00 "," 5.353,73 "," 373,84 ",2826884028,CFD," 0,00 "
08/10/2024 07:30:52,Position closed,NSDQ100/USD," 254,10 ",0.253044," 4,11 "," 5.357,84 "," 627,94 ",2826884028,CFD," 0,00 "
08/10/2024 07:41:22,Position closed,NSDQ100/USD," 294,11 ",0.292900," 4,11 "," 5.361,95 "," 922,05 ",2826857879,CFD," 0,00 "
08/10/2024 07:41:29,Position closed,NSDQ100/USD," 216,30 ",0.212270," 6,31 "," 5.368,26 "," 1.138,35 ",2826858731,CFD," 0,00 "
08/10/2024 07:44:26,Open Position,NSDQ100/USD," 200,00 ",0.201738," 0,00 "," 5.368,26 "," 938,35 ",2826891176,CFD," 0,00 "
08/10/2024 07:47:27,Position closed,NSDQ100/USD," 201,44 ",0.201738," 1,44 "," 5.369,70 "," 1.139,79 ",2826891176,CFD," 0,00 "
08/10/2024 07:48:10,Edit Stop Loss,-,"(20,28)",-," 0,00 "," 5.369,70 "," 1.119,51 ",2826668565,-," 0,00 "
08/10/2024 07:50:33,Open Position,NSDQ100/USD," 150,00 ",0.151430," 0,00 "," 5.369,70 "," 969,51 ",2826893220,CFD," 0,00 "
08/10/2024 07:55:56,Position closed,NSDQ100/USD," 149,16 ",0.151430,"(0,84)"," 5.368,86 "," 1.118,67 ",2826893220,CFD," 0,00 "
08/10/2024 07:56:07,Open Position,NSDQ100/USD," 149,99 ",0.151378," 0,00 "," 5.368,86 "," 968,68 ",2826894586,CFD," 0,00 "
08/10/2024 08:25:49,Open Position,NSDQ100/USD," 249,99 ",0.252366," 0,00 "," 5.368,86 "," 718,69 ",2826920625,CFD," 0,00 "
08/10/2024 08:26:06,Position closed,NSDQ100/USD," 250,63 ",0.252366," 0,64 "," 5.369,50 "," 969,32 ",2826920625,CFD," 0,00 "
08/10/2024 08:55:37,Position closed,NSDQ100/USD," 151,04 ",0.151378," 1,05 "," 5.370,55 "," 1.120,36 ",2826894586,CFD," 0,00 "
08/10/2024 08:58:17,Open Position,NSDQ100/USD," 100,00 ",0.100862," 0,00 "," 5.370,55 "," 1.020,36 ",2826946440,CFD," 0,00 "
08/10/2024 09:04:46,Position closed,NSDQ100/USD," 102,43 ",0.100862," 2,43 "," 5.372,98 "," 1.122,79 ",2826946440,CFD," 0,00 "
08/10/2024 09:04:55,Position closed,NSDQ100/USD," 369,82 ",0.382310,"(10,18)"," 5.362,80 "," 1.492,61 ",2826671123,CFD," 0,00 "
08/10/2024 09:06:08,Open Position,NSDQ100/USD," 250,00 ",0.251872," 0,00 "," 5.362,80 "," 1.242,61 ",2826949413,CFD," 0,00 "
08/10/2024 09:09:22,Position closed,NSDQ100/USD," 310,64 ",0.301729,"(9,63)"," 5.353,17 "," 1.553,25 ",2826668565,CFD," 0,00 "
08/10/2024 09:11:26,Position closed,NSDQ100/USD," 582,85 ",0.613331,"(27,13)"," 5.326,04 "," 2.136,10 ",2826668052,CFD," 0,00 "
08/10/2024 09:12:41,Position closed,NSDQ100/USD," 250,58 ",0.251872," 0,58 "," 5.326,62 "," 2.386,68 ",2826949413,CFD," 0,00 "
08/10/2024 09:13:05,Open Position,NSDQ100/USD," 299,99 ",0.302335," 0,00 "," 5.326,62 "," 2.086,69 ",2826951573,CFD," 0,00 "
08/10/2024 09:13:26,Open Position,NSDQ100/USD," 249,99 ",0.251896," 0,00 "," 5.326,62 "," 1.836,70 ",2826951745,CFD," 0,00 "
08/10/2024 09:18:29,Position closed,NSDQ100/USD," 257,00 ",0.251896," 7,01 "," 5.333,63 "," 2.093,70 ",2826951745,CFD," 0,00 "
08/10/2024 09:20:06,Open Position,NSDQ100/USD," 250,00 ",0.251631," 0,00 "," 5.333,63 "," 1.843,70 ",2826953564,CFD," 0,00 "
08/10/2024 09:24:48,Open Position,NSDQ100/USD," 249,99 ",0.251497," 0,00 "," 5.333,63 "," 1.593,71 ",2826956385,CFD," 0,00 "
08/10/2024 09:27:30,Position closed,NSDQ100/USD," 250,27 ",0.251497," 0,28 "," 5.333,91 "," 1.843,98 ",2826956385,CFD," 0,00 "
08/10/2024 09:29:21,Position closed,NSDQ100/USD," 820,22 ",0.872773,"(49,77)"," 5.284,14 "," 2.664,20 ",2826622419,CFD," 0,00 "
08/10/2024 09:30:20,Open Position,NSDQ100/USD," 300,00 ",0.301695," 0,00 "," 5.284,14 "," 2.364,20 ",2826958053,CFD," 0,00 "
08/10/2024 09:30:28,Open Position,NSDQ100/USD," 250,00 ",0.251463," 0,00 "," 5.284,14 "," 2.114,20 ",2826958100,CFD," 0,00 "
08/10/2024 09:38:37,Position closed,NSDQ100/USD," 250,91 ",0.251463," 0,91 "," 5.285,05 "," 2.365,11 ",2826958100,CFD," 0,00 "
08/10/2024 09:39:36,Open Position,NSDQ100/USD," 250,00 ",0.251572," 0,00 "," 5.285,05 "," 2.115,11 ",2826959902,CFD," 0,00 "
08/10/2024 09:47:56,Position closed,NSDQ100/USD," 300,13 ",0.301695," 0,13 "," 5.285,18 "," 2.415,24 ",2826958053,CFD," 0,00 "
08/10/2024 09:48:51,Open Position,NSDQ100/USD," 250,00 ",0.251508," 0,00 "," 5.285,18 "," 2.165,24 ",2826961847,CFD," 0,00 "
08/10/2024 09:59:15,Open Position,NSDQ100/USD," 249,99 ",0.251409," 0,00 "," 5.285,18 "," 1.915,25 ",2826964411,CFD," 0,00 "
08/10/2024 10:39:34,Position closed,NSDQ100/USD," 251,04 ",0.251508," 1,04 "," 5.286,22 "," 2.166,29 ",2826961847,CFD," 0,00 "
08/10/2024 10:40:22,Open Position,NSDQ100/USD," 249,99 ",0.251692," 0,00 "," 5.286,22 "," 1.916,30 ",2826972939,CFD," 0,00 "
08/10/2024 10:42:16,Position closed,NSDQ100/USD," 251,04 ",0.251572," 1,04 "," 5.287,26 "," 2.167,34 ",2826959902,CFD," 0,00 "
08/10/2024 10:43:03,Open Position,NSDQ100/USD," 149,99 ",0.150957," 0,00 "," 5.287,26 "," 2.017,35 ",2826973520,CFD," 0,00 "
08/10/2024 10:56:03,Position closed,NSDQ100/USD," 250,60 ",0.251409," 0,61 "," 5.287,87 "," 2.267,95 ",2826964411,CFD," 0,00 "
08/10/2024 10:57:03,Position closed,NSDQ100/USD," 152,56 ",0.150957," 2,57 "," 5.290,44 "," 2.420,51 ",2826973520,CFD," 0,00 "
08/10/2024 10:58:59,Open Position,NSDQ100/USD," 250,00 ",0.251378," 0,00 "," 5.290,44 "," 2.170,51 ",2826976288,CFD," 0,00 "
08/10/2024 11:35:49,Open Position,NSDQ100/USD," 200,00 ",0.200963," 0,00 "," 5.290,44 "," 1.970,51 ",2826983482,CFD," 0,00 "
08/10/2024 12:23:32,Open Position,NSDQ100/USD," 299,99 ",0.301848," 0,00 "," 5.290,44 "," 1.670,52 ",2827000259,CFD," 0,00 "
08/10/2024 12:33:16,Position closed,NSDQ100/USD," 204,77 ",0.200963," 4,77 "," 5.295,21 "," 1.875,29 ",2826983482,CFD," 0,00 "
08/10/2024 12:33:38,Open Position,NSDQ100/USD," 249,99 ",0.251477," 0,00 "," 5.295,21 "," 1.625,30 ",2827002689,CFD," 0,00 "
08/10/2024 12:33:58,Open Position,NSDQ100/USD," 299,99 ",0.301813," 0,00 "," 5.295,21 "," 1.325,31 ",2827002802,CFD," 0,00 "
08/10/2024 12:35:34,Position closed,NSDQ100/USD," 251,76 ",0.251378," 1,76 "," 5.296,97 "," 1.577,07 ",2826976288,CFD," 0,00 "
08/10/2024 12:37:15,Open Position,NSDQ100/USD," 250,00 ",0.251565," 0,00 "," 5.296,97 "," 1.327,07 ",2827005963,CFD," 0,00 "
08/10/2024 12:49:51,Open Position,NSDQ100/USD," 200,00 ",0.201282," 0,00 "," 5.296,97 "," 1.127,07 ",2827008807,CFD," 0,00 "
08/10/2024 12:51:12,Position closed,NSDQ100/USD," 302,08 ",0.301813," 2,09 "," 5.299,06 "," 1.429,15 ",2827002802,CFD," 0,00 "
08/10/2024 12:52:36,Open Position,NSDQ100/USD," 250,00 ",0.251631," 0,00 "," 5.299,06 "," 1.179,15 ",2827009249,CFD," 0,00 "
08/10/2024 13:01:47,Open Position,NSDQ100/USD," 100,00 ",0.100626," 0,00 "," 5.299,06 "," 1.079,15 ",2827010935,CFD," 0,00 "
08/10/2024 13:07:29,Position closed,NSDQ100/USD," 98,99 ",0.100626,"(1,01)"," 5.298,05 "," 1.178,14 ",2827010935,CFD," 0,00 "
08/10/2024 13:21:28,Position closed,NSDQ100/USD," 253,42 ",0.251477," 3,43 "," 5.301,48 "," 1.431,56 ",2827002689,CFD," 0,00 "
08/10/2024 13:22:40,Open Position,NSDQ100/USD," 199,99 ",0.200983," 0,00 "," 5.301,48 "," 1.231,57 ",2827019962,CFD," 0,00 "
08/10/2024 13:26:13,Open Position,NSDQ100/USD," 250,00 ",0.251357," 0,00 "," 5.301,48 "," 981,57 ",2827021234,CFD," 0,00 "
08/10/2024 13:30:09,Position closed,NSDQ100/USD," 199,94 ",0.200983,"(0,05)"," 5.301,43 "," 1.181,51 ",2827019962,CFD," 0,00 "
08/10/2024 13:31:02,Open Position,NSDQ100/USD," 300,00 ",0.301665," 0,00 "," 5.301,43 "," 881,51 ",2827073507,CFD," 0,00 "
08/10/2024 13:42:39,Open Position,NSDQ100/USD," 200,00 ",0.200865," 0,00 "," 5.301,43 "," 681,51 ",2827179044,CFD," 0,00 "
08/10/2024 13:44:19,Open Position,NSDQ100/USD," 300,00 ",0.301456," 0,00 "," 5.301,43 "," 381,51 ",2827181713,CFD," 0,00 "
08/10/2024 14:00:50,Position closed,NSDQ100/USD," 303,29 ",0.300267," 3,30 "," 5.304,73 "," 684,80 ",2826386036,CFD," 0,00 "
08/10/2024 14:01:09,Position closed,NSDQ100/USD," 215,57 ",0.200865," 15,57 "," 5.320,30 "," 900,37 ",2827179044,CFD," 0,00 "
08/10/2024 14:01:38,Position closed,NSDQ100/USD," 306,45 ",0.300338," 6,46 "," 5.326,76 "," 1.206,82 ",2826388095,CFD," 0,00 "
08/10/2024 14:02:02,Position closed,NSDQ100/USD," 310,51 ",0.300437," 10,52 "," 5.337,28 "," 1.517,33 ",2826401560,CFD," 0,00 "
08/10/2024 14:03:42,Position closed,NSDQ100/USD," 211,47 ",0.200544," 11,47 "," 5.348,75 "," 1.728,80 ",2826633637,CFD," 0,00 "
08/10/2024 14:04:50,Position closed,NSDQ100/USD," 360,69 ",0.350570," 10,70 "," 5.359,45 "," 2.089,49 ",2826501554,CFD," 0,00 "
08/10/2024 14:05:24,Position closed,NSDQ100/USD," 205,17 ",0.200331," 5,17 "," 5.364,62 "," 2.294,66 ",2826403908,CFD," 0,00 "
08/10/2024 14:07:35,Position closed,NSDQ100/USD," 292,79 ",0.299787,"(7,21)"," 5.357,41 "," 2.587,45 ",2825567058,CFD," 0,00 "
08/10/2024 14:07:47,Open Position,NSDQ100/USD," 300,00 ",0.300203," 0,00 "," 5.357,41 "," 2.287,45 ",2827322220,CFD," 0,00 "
08/10/2024 14:08:08,Open Position,NSDQ100/USD," 149,99 ",0.150061," 0,00 "," 5.357,41 "," 2.137,46 ",2827322553,CFD," 0,00 "
08/10/2024 14:13:09,Open Position,NSDQ100/USD," 149,99 ",0.149998," 0,00 "," 5.357,41 "," 1.987,47 ",2827329057,CFD," 0,00 "
08/10/2024 14:25:30,Position closed,NSDQ100/USD," 302,85 ",0.300203," 2,85 "," 5.360,26 "," 2.290,32 ",2827322220,CFD," 0,00 "
08/10/2024 14:25:38,Open Position,NSDQ100/USD," 579,99 ",0.580730," 0,00 "," 5.360,26 "," 1.710,33 ",2827348937,CFD," 0,00 "
08/10/2024 14:26:28,Open Position,NSDQ100/USD," 249,99 ",0.250129," 0,00 "," 5.360,26 "," 1.460,34 ",2827350562,CFD," 0,00 "
08/10/2024 14:48:53,Position closed,NSDQ100/USD," 120,04 ",0.119626," 0,05 "," 5.360,31 "," 1.580,38 ",2825528825,CFD," 0,00 "
08/10/2024 14:48:58,Position closed,NSDQ100/USD," 159,92 ",0.149998," 9,93 "," 5.370,24 "," 1.740,30 ",2827329057,CFD," 0,00 "
08/10/2024 14:49:03,Position closed,NSDQ100/USD," 160,93 ",0.150061," 10,94 "," 5.381,18 "," 1.901,23 ",2827322553,CFD," 0,00 "
08/10/2024 14:50:27,Open Position,NSDQ100/USD," 349,99 ",0.348954," 0,00 "," 5.381,18 "," 1.551,24 ",2827407403,CFD," 0,00 "
08/10/2024 14:52:13,Position closed,NSDQ100/USD," 350,54 ",0.348954," 0,55 "," 5.381,73 "," 1.901,78 ",2827407403,CFD," 0,00 "
08/10/2024 14:52:40,Open Position,NSDQ100/USD," 349,99 ",0.348974," 0,00 "," 5.381,73 "," 1.551,79 ",2827410518,CFD," 0,00 "
08/10/2024 14:53:43,Open Position,NSDQ100/USD," 150,00 ",0.149551," 0,00 "," 5.381,73 "," 1.401,79 ",2827411657,CFD," 0,00 "
08/10/2024 15:21:34,Position closed,NSDQ100/USD," 151,87 ",0.149551," 1,87 "," 5.383,60 "," 1.553,66 ",2827411657,CFD," 0,00 "
08/10/2024 15:22:03,Position closed,NSDQ100/USD," 352,88 ",0.348974," 2,89 "," 5.386,49 "," 1.906,54 ",2827410518,CFD," 0,00 "
08/10/2024 15:22:39,Open Position,NSDQ100/USD," 300,00 ",0.299301," 0,00 "," 5.386,49 "," 1.606,54 ",2827448327,CFD," 0,00 "
08/10/2024 15:24:26,Position closed,NSDQ100/USD," 303,71 ",0.299301," 3,71 "," 5.390,20 "," 1.910,25 ",2827448327,CFD," 0,00 "
08/10/2024 15:26:21,Open Position,NSDQ100/USD," 200,00 ",0.199676," 0,00 "," 5.390,20 "," 1.710,25 ",2827453727,CFD," 0,00 "
08/10/2024 15:27:30,Open Position,NSDQ100/USD," 200,00 ",0.199548," 0,00 "," 5.390,20 "," 1.510,25 ",2827454511,CFD," 0,00 "
08/10/2024 15:27:43,Position closed,NSDQ100/USD," 201,46 ",0.199676," 1,46 "," 5.391,66 "," 1.711,71 ",2827453727,CFD," 0,00 "
08/10/2024 15:28:00,Open Position,NSDQ100/USD," 249,99 ",0.249466," 0,00 "," 5.391,66 "," 1.461,72 ",2827454851,CFD," 0,00 "
08/10/2024 15:28:54,Open Position,NSDQ100/USD," 199,99 ",0.199663," 0,00 "," 5.391,66 "," 1.261,73 ",2827456050,CFD," 0,00 "
08/10/2024 15:55:42,Position closed,NSDQ100/USD," 253,70 ",0.249466," 3,71 "," 5.395,37 "," 1.515,43 ",2827454851,CFD," 0,00 "
08/10/2024 15:55:49,Position closed,NSDQ100/USD," 202,25 ",0.199548," 2,25 "," 5.397,62 "," 1.717,68 ",2827454511,CFD," 0,00 "
08/10/2024 16:06:55,Position closed,NSDQ100/USD," 201,47 ",0.199663," 1,48 "," 5.399,10 "," 1.919,15 ",2827456050,CFD," 0,00 "
08/10/2024 16:09:16,Open Position,NSDQ100/USD," 149,99 ",0.149881," 0,00 "," 5.399,10 "," 1.769,16 ",2827520097,CFD," 0,00 "
08/10/2024 16:12:56,Position closed,NSDQ100/USD," 151,82 ",0.149881," 1,83 "," 5.400,93 "," 1.920,98 ",2827520097,CFD," 0,00 "
08/10/2024 16:29:19,Open Position,NSDQ100/USD," 149,99 ",0.149683," 0,00 "," 5.400,93 "," 1.770,99 ",2827565786,CFD," 0,00 "
08/10/2024 16:49:18,Position closed,NSDQ100/USD," 147,79 ",0.149683,"(2,20)"," 5.398,73 "," 1.918,78 ",2827565786,CFD," 0,00 "
08/10/2024 16:53:03,Open Position,NSDQ100/USD," 199,99 ",0.199712," 0,00 "," 5.398,73 "," 1.718,79 ",2827584292,CFD," 0,00 "
08/10/2024 17:23:38,Position closed,NSDQ100/USD," 204,74 ",0.199712," 4,75 "," 5.403,48 "," 1.923,53 ",2827584292,CFD," 0,00 "
08/10/2024 17:24:14,Open Position,NSDQ100/USD," 200,00 ",0.199934," 0,00 "," 5.403,48 "," 1.723,53 ",2827694637,CFD," 0,00 "
08/10/2024 17:54:37,Position closed,NSDQ100/USD," 202,94 ",0.199934," 2,94 "," 5.406,42 "," 1.926,47 ",2827694637,CFD," 0,00 "
08/10/2024 17:55:03,Open Position,NSDQ100/USD," 199,99 ",0.199780," 0,00 "," 5.406,42 "," 1.726,48 ",2827720244,CFD," 0,00 "
08/10/2024 17:55:13,Open Position,NSDQ100/USD," 200,00 ",0.199757," 0,00 "," 5.406,42 "," 1.526,48 ",2827720299,CFD," 0,00 "
08/10/2024 17:56:43,Open Position,NSDQ100/USD," 350,00 ",0.349523," 0,00 "," 5.406,42 "," 1.176,48 ",2827720701,CFD," 0,00 "
08/10/2024 18:01:06,Position closed,NSDQ100/USD," 202,64 ",0.199757," 2,64 "," 5.409,06 "," 1.379,12 ",2827720299,CFD," 0,00 "
08/10/2024 18:01:13,Position closed,NSDQ100/USD," 353,98 ",0.349523," 3,98 "," 5.413,04 "," 1.733,10 ",2827720701,CFD," 0,00 "
08/10/2024 18:44:03,Open Position,NSDQ100/USD," 150,00 ",0.149602," 0,00 "," 5.413,04 "," 1.583,10 ",2827744236,CFD," 0,00 "
08/10/2024 19:39:01,Open Position,NSDQ100/USD," 199,99 ",0.198861," 0,00 "," 5.413,04 "," 1.383,11 ",2827778842,CFD," 0,00 "
08/10/2024 19:56:06,Open Position,NSDQ100/USD," 199,99 ",0.198787," 0,00 "," 5.413,04 "," 1.183,12 ",2827790049,CFD," 0,00 "
08/10/2024 19:58:06,Open Position,NSDQ100/USD," 399,99 ",0.397724," 0,00 "," 5.413,04 "," 783,13 ",2827791501,CFD," 0,00 "
08/10/2024 20:13:09,Position closed,NSDQ100/USD," 407,52 ",0.397724," 7,53 "," 5.420,57 "," 1.190,65 ",2827791501,CFD," 0,00 "
08/10/2024 20:13:16,Position closed,NSDQ100/USD," 205,17 ",0.198787," 5,18 "," 5.425,75 "," 1.395,82 ",2827790049,CFD," 0,00 "
08/10/2024 20:13:26,Position closed,NSDQ100/USD," 203,68 ",0.198861," 3,69 "," 5.429,44 "," 1.599,50 ",2827778842,CFD," 0,00 "
08/10/2024 20:14:04,Open Position,NSDQ100/USD," 199,99 ",0.199053," 0,00 "," 5.429,44 "," 1.399,51 ",2827794291,CFD," 0,00 "
08/10/2024 20:19:36,Open Position,NSDQ100/USD," 349,99 ",0.348432," 0,00 "," 5.429,44 "," 1.049,52 ",2827796396,CFD," 0,00 "
09/10/2024 00:48:38,Overnight fee,Daily,"(0,01)",-,"(0,01)"," 5.429,43 "," 1.049,51 ",2827000259,CFD," 0,00 "
09/10/2024 00:48:38,Overnight fee,Daily,"(0,01)",-,"(0,01)"," 5.429,42 "," 1.049,50 ",2826953564,CFD," 0,00 "
09/10/2024 00:48:38,Overnight fee,Daily,"(0,01)",-,"(0,01)"," 5.429,41 "," 1.049,49 ",2826972939,CFD," 0,00 "
09/10/2024 00:48:38,Overnight fee,Daily,"(0,01)",-,"(0,01)"," 5.429,40 "," 1.049,48 ",2827009249,CFD," 0,00 "
09/10/2024 00:48:38,Overnight fee,Daily,"(0,01)",-,"(0,01)"," 5.429,39 "," 1.049,47 ",2827181713,CFD," 0,00 "
09/10/2024 00:48:38,Overnight fee,Daily,"(0,01)",-,"(0,01)"," 5.429,38 "," 1.049,46 ",2827005963,CFD," 0,00 "
09/10/2024 00:48:38,Overnight fee,Daily,"(0,01)",-,"(0,01)"," 5.429,37 "," 1.049,45 ",2827796396,CFD," 0,00 "
09/10/2024 00:48:38,Overnight fee,Daily,"(0,01)",-,"(0,01)"," 5.429,36 "," 1.049,44 ",2827021234,CFD," 0,00 "
09/10/2024 00:48:38,Overnight fee,Daily,"(0,01)",-,"(0,01)"," 5.429,35 "," 1.049,43 ",2827720244,CFD," 0,00 "
09/10/2024 00:48:38,Overnight fee,Daily,"(0,01)",-,"(0,01)"," 5.429,34 "," 1.049,42 ",2827350562,CFD," 0,00 "
09/10/2024 00:48:38,Overnight fee,Daily,"(0,01)",-,"(0,01)"," 5.429,33 "," 1.049,41 ",2826951573,CFD," 0,00 "
09/10/2024 00:48:38,Overnight fee,Daily,"(0,01)",-,"(0,01)"," 5.429,32 "," 1.049,40 ",2827008807,CFD," 0,00 "
09/10/2024 00:48:38,Overnight fee,Daily,"(0,01)",-,"(0,01)"," 5.429,31 "," 1.049,39 ",2827073507,CFD," 0,00 "
09/10/2024 00:48:38,Overnight fee,Daily,"(0,02)",-,"(0,02)"," 5.429,29 "," 1.049,37 ",2827348937,CFD," 0,00 "
09/10/2024 00:48:38,Overnight fee,Daily,"(1,02)",-,"(1,02)"," 5.428,27 "," 1.048,35 ",2827794291,CFD," 0,00 "
09/10/2024 02:48:20,Position closed,NSDQ100/USD," 360,99 ",0.348432," 11,00 "," 5.439,27 "," 1.409,34 ",2827796396,CFD," 0,00 "
09/10/2024 02:48:29,Position closed,NSDQ100/USD," 149,06 ",0.149602,"(0,94)"," 5.438,33 "," 1.558,40 ",2827744236,CFD," 0,00 "
09/10/2024 06:49:59,Open Position,NSDQ100/USD," 300,00 ",0.299344," 0,00 "," 5.438,33 "," 1.258,40 ",2827844670,CFD," 0,00 "
09/10/2024 07:06:35,Open Position,NSDQ100/USD," 320,00 ",0.319169," 0,00 "," 5.438,33 "," 938,40 ",2827865290,CFD," 0,00 "
09/10/2024 07:22:41,Position closed,NSDQ100/USD," 201,78 ",0.199780," 1,79 "," 5.440,12 "," 1.140,18 ",2827720244,CFD," 0,00 "
09/10/2024 07:24:00,Open Position,NSDQ100/USD," 149,99 ",0.149850," 0,00 "," 5.440,12 "," 990,19 ",2827883410,CFD," 0,00 "
09/10/2024 07:25:03,Position closed,NSDQ100/USD," 148,64 ",0.149850,"(1,35)"," 5.438,77 "," 1.138,83 ",2827883410,CFD," 0,00 "
09/10/2024 07:33:07,Open Position,NSDQ100/USD," 199,99 ",0.199770," 0,00 "," 5.438,77 "," 938,84 ",2827887349,CFD," 0,00 "
09/10/2024 07:43:52,Position closed,NSDQ100/USD," 199,59 ",0.199770,"(0,40)"," 5.438,37 "," 1.138,43 ",2827887349,CFD," 0,00 "
09/10/2024 07:50:59,Open Position,NSDQ100/USD," 200,00 ",0.199791," 0,00 "," 5.438,37 "," 938,43 ",2827903368,CFD," 0,00 "
09/10/2024 07:52:57,Position closed,NSDQ100/USD," 197,90 ",0.199791,"(2,10)"," 5.436,27 "," 1.136,33 ",2827903368,CFD," 0,00 "
09/10/2024 07:55:00,Open Position,NSDQ100/USD," 199,99 ",0.199691," 0,00 "," 5.436,27 "," 936,34 ",2827904983,CFD," 0,00 "
09/10/2024 08:39:28,Position closed,NSDQ100/USD," 300,39 ",0.299344," 0,39 "," 5.436,66 "," 1.236,73 ",2827844670,CFD," 0,00 "
09/10/2024 08:39:35,Position closed,NSDQ100/USD," 202,83 ",0.199691," 2,84 "," 5.439,50 "," 1.439,56 ",2827904983,CFD," 0,00 "
09/10/2024 08:39:56,Open Position,NSDQ100/USD," 199,99 ",0.199518," 0,00 "," 5.439,50 "," 1.239,57 ",2827914321,CFD," 0,00 "
09/10/2024 08:45:34,Position closed,NSDQ100/USD," 200,39 ",0.199518," 0,40 "," 5.439,90 "," 1.439,96 ",2827914321,CFD," 0,00 "
09/10/2024 08:45:45,Position closed,NSDQ100/USD," 319,52 ",0.319169,"(0,48)"," 5.439,42 "," 1.759,48 ",2827865290,CFD," 0,00 "
09/10/2024 08:48:00,Open Position,NSDQ100/USD," 199,99 ",0.199427," 0,00 "," 5.439,42 "," 1.559,49 ",2827916313,CFD," 0,00 "
09/10/2024 08:49:01,Open Position,NSDQ100/USD," 200,00 ",0.199490," 0,00 "," 5.439,42 "," 1.359,49 ",2827916501,CFD," 0,00 "
09/10/2024 09:15:25,Open Position,NSDQ100/USD," 250,00 ",0.249252," 0,00 "," 5.439,42 "," 1.109,49 ",2827920855,CFD," 0,00 "
09/10/2024 10:21:18,Position closed,NSDQ100/USD," 256,87 ",0.249252," 6,87 "," 5.446,29 "," 1.366,36 ",2827920855,CFD," 0,00 "
09/10/2024 10:21:22,Position closed,NSDQ100/USD," 205,89 ",0.199427," 5,90 "," 5.452,19 "," 1.572,25 ",2827916313,CFD," 0,00 "
09/10/2024 12:03:57,Open Position,NSDQ100/USD," 199,99 ",0.199263," 0,00 "," 5.452,19 "," 1.372,26 ",2828053396,CFD," 0,00 "
09/10/2024 12:27:10,Open Position,NSDQ100/USD," 199,99 ",0.199204," 0,00 "," 5.452,19 "," 1.172,27 ",2828064906,CFD," 0,00 "
09/10/2024 13:05:55,Position closed,NSDQ100/USD," 202,76 ",0.199204," 2,77 "," 5.454,96 "," 1.375,03 ",2828064906,CFD," 0,00 "
09/10/2024 13:06:02,Position closed,NSDQ100/USD," 204,09 ",0.199263," 4,10 "," 5.459,06 "," 1.579,12 ",2828053396,CFD," 0,00 "
09/10/2024 13:20:14,Open Position,NSDQ100/USD," 300,00 ",0.298384," 0,00 "," 5.459,06 "," 1.279,12 ",2828079378,CFD," 0,00 "
09/10/2024 13:20:23,Position closed,NSDQ100/USD," 202,22 ",0.199053," 2,23 "," 5.461,29 "," 1.481,34 ",2827794291,CFD," 0,00 "
09/10/2024 13:21:34,Open Position,NSDQ100/USD," 300,00 ",0.298406," 0,00 "," 5.461,29 "," 1.181,34 ",2828079805,CFD," 0,00 "
09/10/2024 13:24:25,Open Position,NSDQ100/USD," 100,00 ",0.099460," 0,00 "," 5.461,29 "," 1.081,34 ",2828080974,CFD," 0,00 "
09/10/2024 14:23:43,Position closed,NSDQ100/USD," 307,95 ",0.298406," 7,95 "," 5.469,24 "," 1.389,29 ",2828079805,CFD," 0,00 "
09/10/2024 14:23:49,Position closed,NSDQ100/USD," 307,68 ",0.298384," 7,68 "," 5.476,92 "," 1.696,97 ",2828079378,CFD," 0,00 "
09/10/2024 14:23:55,Position closed,NSDQ100/USD," 102,38 ",0.099460," 2,38 "," 5.479,30 "," 1.799,35 ",2828080974,CFD," 0,00 "
09/10/2024 14:24:16,Open Position,NSDQ100/USD," 250,00 ",0.248267," 0,00 "," 5.479,30 "," 1.549,35 ",2828305817,CFD," 0,00 "
09/10/2024 14:24:25,Open Position,NSDQ100/USD," 99,99 ",0.099323," 0,00 "," 5.479,30 "," 1.449,36 ",2828306044,CFD," 0,00 "
09/10/2024 14:34:42,Position closed,NSDQ100/USD," 254,44 ",0.248267," 4,44 "," 5.483,74 "," 1.703,80 ",2828305817,CFD," 0,00 "
09/10/2024 14:34:47,Position closed,NSDQ100/USD," 101,96 ",0.099323," 1,97 "," 5.485,71 "," 1.805,76 ",2828306044,CFD," 0,00 "
09/10/2024 14:35:24,Open Position,NSDQ100/USD," 299,99 ",0.297612," 0,00 "," 5.485,71 "," 1.505,77 ",2828328177,CFD," 0,00 "
09/10/2024 14:37:19,Open Position,NSDQ100/USD," 150,00 ",0.148905," 0,00 "," 5.485,71 "," 1.355,77 ",2828332750,CFD," 0,00 "
09/10/2024 14:37:48,Open Position,NSDQ100/USD," 199,99 ",0.198583," 0,00 "," 5.485,71 "," 1.155,78 ",2828333714,CFD," 0,00 "
09/10/2024 14:38:59,Position closed,NSDQ100/USD," 149,37 ",0.148905,"(0,63)"," 5.485,08 "," 1.305,15 ",2828332750,CFD," 0,00 "
09/10/2024 14:39:14,Open Position,NSDQ100/USD," 150,00 ",0.148886," 0,00 "," 5.485,08 "," 1.155,15 ",2828335237,CFD," 0,00 "
09/10/2024 15:37:37,Position closed,NSDQ100/USD," 317,09 ",0.297612," 17,10 "," 5.502,18 "," 1.472,24 ",2828328177,CFD," 0,00 "
09/10/2024 15:41:27,Open Position,NSDQ100/USD," 200,00 ",0.197793," 0,00 "," 5.502,18 "," 1.272,24 ",2828419195,CFD," 0,00 "
09/10/2024 15:41:36,Open Position,NSDQ100/USD," 149,99 ",0.148344," 0,00 "," 5.502,18 "," 1.122,25 ",2828419315,CFD," 0,00 "
09/10/2024 16:49:30,Open Position,NSDQ100/USD," 199,99 ",0.197811," 0,00 "," 5.502,18 "," 922,26 ",2828477429,CFD," 0,00 "
09/10/2024 18:42:51,Position closed,NSDQ100/USD," 152,26 ",0.148344," 2,27 "," 5.504,45 "," 1.074,52 ",2828419315,CFD," 0,00 "
09/10/2024 18:42:58,Position closed,NSDQ100/USD," 203,22 ",0.197793," 3,22 "," 5.507,67 "," 1.277,74 ",2828419195,CFD," 0,00 "
09/10/2024 18:43:35,Open Position,NSDQ100/USD," 319,99 ",0.316132," 0,00 "," 5.507,67 "," 957,75 ",2828546098,CFD," 0,00 "
09/10/2024 20:44:20,Position closed,NSDQ100/USD," 318,35 ",0.316132,"(1,64)"," 5.506,03 "," 1.276,10 ",2828546098,CFD," 0,00 "
09/10/2024 22:15:42,Open Position,NSDQ100/USD," 349,99 ",0.345659," 0,00 "," 5.506,03 "," 926,11 ",2828611499,CFD," 0,00 "
09/10/2024 22:28:25,Open Position,NSDQ100/USD," 239,99 ",0.236940," 0,00 "," 5.506,03 "," 686,12 ",2828612029,CFD," 0,00 "
09/10/2024 22:28:40,Position closed,NSDQ100/USD," 351,39 ",0.345659," 1,40 "," 5.507,43 "," 1.037,51 ",2828611499,CFD," 0,00 "
09/10/2024 22:28:51,Open Position,NSDQ100/USD," 350,00 ",0.345523," 0,00 "," 5.507,43 "," 687,51 ",2828612043,CFD," 0,00 "
09/10/2024 22:29:48,Open Position,NSDQ100/USD," 250,00 ",0.246789," 0,00 "," 5.507,43 "," 437,51 ",2828612076,CFD," 0,00 "
09/10/2024 22:32:10,Open Position,NSDQ100/USD," 199,99 ",0.197448," 0,00 "," 5.507,43 "," 237,52 ",2828612173,CFD," 0,00 "
09/10/2024 22:37:16,Position closed,NSDQ100/USD," 199,07 ",0.197448,"(0,92)"," 5.506,51 "," 436,59 ",2828612173,CFD," 0,00 "
09/10/2024 22:37:35,Position closed,NSDQ100/USD," 239,39 ",0.236940,"(0,60)"," 5.505,91 "," 675,98 ",2828612029,CFD," 0,00 "
09/10/2024 22:37:50,Open Position,NSDQ100/USD," 150,00 ",0.148102," 0,00 "," 5.505,91 "," 525,98 ",2828612326,CFD," 0,00 "
09/10/2024 22:39:36,Position closed,NSDQ100/USD," 248,81 ",0.246789,"(1,19)"," 5.504,72 "," 774,79 ",2828612076,CFD," 0,00 "
09/10/2024 22:39:59,Open Position,NSDQ100/USD," 150,00 ",0.148094," 0,00 "," 5.504,72 "," 624,79 ",2828612472,CFD," 0,00 "
09/10/2024 22:40:46,Open Position,NSDQ100/USD," 199,99 ",0.197436," 0,00 "," 5.504,72 "," 424,80 ",2828612515,CFD," 0,00 "
10/10/2024 00:19:21,Index price adjustment,NSDQ100/USD,"(0,12)",-,"(0,12)"," 5.504,60 "," 424,68 ",2826951573,CFD," 0,00 "
10/10/2024 00:19:21,Index price adjustment,NSDQ100/USD,"(0,10)",-,"(0,10)"," 5.504,50 "," 424,58 ",2826953564,CFD," 0,00 "
10/10/2024 00:19:21,Index price adjustment,NSDQ100/USD,"(0,10)",-,"(0,10)"," 5.504,40 "," 424,48 ",2826972939,CFD," 0,00 "
10/10/2024 00:19:21,Index price adjustment,NSDQ100/USD,"(0,12)",-,"(0,12)"," 5.504,28 "," 424,36 ",2827000259,CFD," 0,00 "
10/10/2024 00:19:21,Index price adjustment,NSDQ100/USD,"(0,10)",-,"(0,10)"," 5.504,18 "," 424,26 ",2827005963,CFD," 0,00 "
10/10/2024 00:19:21,Index price adjustment,NSDQ100/USD,"(0,08)",-,"(0,08)"," 5.504,10 "," 424,18 ",2827008807,CFD," 0,00 "
10/10/2024 00:19:21,Index price adjustment,NSDQ100/USD,"(0,10)",-,"(0,10)"," 5.504,00 "," 424,08 ",2827009249,CFD," 0,00 "
10/10/2024 00:19:21,Index price adjustment,NSDQ100/USD,"(0,10)",-,"(0,10)"," 5.503,90 "," 423,98 ",2827021234,CFD," 0,00 "
10/10/2024 00:19:21,Index price adjustment,NSDQ100/USD,"(0,12)",-,"(0,12)"," 5.503,78 "," 423,86 ",2827073507,CFD," 0,00 "
10/10/2024 00:19:21,Index price adjustment,NSDQ100/USD,"(0,12)",-,"(0,12)"," 5.503,66 "," 423,74 ",2827181713,CFD," 0,00 "
10/10/2024 00:19:21,Index price adjustment,NSDQ100/USD,"(0,22)",-,"(0,22)"," 5.503,44 "," 423,52 ",2827348937,CFD," 0,00 "
10/10/2024 00:19:21,Index price adjustment,NSDQ100/USD,"(0,10)",-,"(0,10)"," 5.503,34 "," 423,42 ",2827350562,CFD," 0,00 "
10/10/2024 00:19:21,Index price adjustment,NSDQ100/USD,"(0,08)",-,"(0,08)"," 5.503,26 "," 423,34 ",2827916501,CFD," 0,00 "
10/10/2024 00:19:21,Index price adjustment,NSDQ100/USD,"(0,08)",-,"(0,08)"," 5.503,18 "," 423,26 ",2828333714,CFD," 0,00 "
10/10/2024 00:19:21,Index price adjustment,NSDQ100/USD,"(0,06)",-,"(0,06)"," 5.503,12 "," 423,20 ",2828335237,CFD," 0,00 "
10/10/2024 00:19:21,Index price adjustment,NSDQ100/USD,"(0,08)",-,"(0,08)"," 5.503,04 "," 423,12 ",2828477429,CFD," 0,00 "
10/10/2024 00:19:21,Index price adjustment,NSDQ100/USD," 0,12 ",-," 0,12 "," 5.503,16 "," 423,24 ",2828546098,CFD," 0,00 "
10/10/2024 00:48:40,Overnight fee,Daily,"(0,01)",-,"(0,01)"," 5.503,15 "," 423,23 ",2826972939,CFD," 0,00 "
10/10/2024 00:48:40,Overnight fee,Daily,"(0,01)",-,"(0,01)"," 5.503,14 "," 423,22 ",2826953564,CFD," 0,00 "
10/10/2024 00:48:40,Overnight fee,Daily,"(0,01)",-,"(0,01)"," 5.503,13 "," 423,21 ",2828333714,CFD," 0,00 "
10/10/2024 00:48:40,Overnight fee,Daily,"(0,01)",-,"(0,01)"," 5.503,12 "," 423,20 ",2827916501,CFD," 0,00 "
10/10/2024 00:48:40,Overnight fee,Daily,"(0,01)",-,"(0,01)"," 5.503,11 "," 423,19 ",2828477429,CFD," 0,00 "
10/10/2024 00:48:40,Overnight fee,Daily,"(0,01)",-,"(0,01)"," 5.503,10 "," 423,18 ",2827350562,CFD," 0,00 "
10/10/2024 00:48:40,Overnight fee,Daily,"(0,01)",-,"(0,01)"," 5.503,09 "," 423,17 ",2827008807,CFD," 0,00 "
10/10/2024 00:48:40,Overnight fee,Daily,"(0,01)",-,"(0,01)"," 5.503,08 "," 423,16 ",2827073507,CFD," 0,00 "
10/10/2024 00:48:40,Overnight fee,Daily,"(0,01)",-,"(0,01)"," 5.503,07 "," 423,15 ",2826951573,CFD," 0,00 "
10/10/2024 00:48:40,Overnight fee,Daily,"(0,01)",-,"(0,01)"," 5.503,06 "," 423,14 ",2827009249,CFD," 0,00 "
10/10/2024 00:48:40,Overnight fee,Daily,"(0,01)",-,"(0,01)"," 5.503,05 "," 423,13 ",2827021234,CFD," 0,00 "
10/10/2024 00:48:40,Overnight fee,Daily,"(0,01)",-,"(0,01)"," 5.503,04 "," 423,12 ",2827000259,CFD," 0,00 "
10/10/2024 00:48:40,Overnight fee,Daily,"(0,01)",-,"(0,01)"," 5.503,03 "," 423,11 ",2827181713,CFD," 0,00 "
10/10/2024 00:48:40,Overnight fee,Daily,"(0,01)",-,"(0,01)"," 5.503,02 "," 423,10 ",2827005963,CFD," 0,00 "
10/10/2024 00:48:40,Overnight fee,Daily,"(0,02)",-,"(0,02)"," 5.503,00 "," 423,08 ",2827348937,CFD," 0,00 "
10/10/2024 05:41:32,Position closed,NSDQ100/USD," 147,98 ",0.148094,"(2,02)"," 5.500,98 "," 571,06 ",2828612472,CFD," 0,00 "
10/10/2024 05:41:40,Position closed,NSDQ100/USD," 147,77 ",0.148102,"(2,23)"," 5.498,75 "," 718,83 ",2828612326,CFD," 0,00 "
10/10/2024 05:46:52,Position closed,NSDQ100/USD," 201,90 ",0.197436," 1,91 "," 5.500,66 "," 920,73 ",2828612515,CFD," 0,00 "
10/10/2024 05:46:59,Position closed,NSDQ100/USD," 353,75 ",0.345523," 3,75 "," 5.504,41 "," 1.274,48 ",2828612043,CFD," 0,00 "
10/10/2024 05:57:31,Position closed,NSDQ100/USD," 192,69 ",0.197811,"(7,30)"," 5.497,11 "," 1.467,17 ",2828477429,CFD," 0,00 "
10/10/2024 05:59:44,Open Position,NSDQ100/USD," 369,99 ",0.365361," 0,00 "," 5.497,11 "," 1.097,18 ",2828637790,CFD," 0,00 "
10/10/2024 06:01:25,Position closed,NSDQ100/USD," 134,31 ",0.148886,"(15,69)"," 5.481,42 "," 1.231,49 ",2828335237,CFD," 0,00 "
10/10/2024 06:01:38,Open Position,NSDQ100/USD," 310,00 ",0.306093," 0,00 "," 5.481,42 "," 921,49 ",2828638025,CFD," 0,00 "
10/10/2024 06:07:24,Open Position,NSDQ100/USD," 300,00 ",0.296303," 0,00 "," 5.481,42 "," 621,49 ",2828639686,CFD," 0,00 "
10/10/2024 06:09:46,Open Position,NSDQ100/USD," 250,00 ",0.246949," 0,00 "," 5.481,42 "," 371,49 ",2828644206,CFD," 0,00 "
10/10/2024 06:20:07,Open Position,NSDQ100/USD," 100,00 ",0.098805," 0,00 "," 5.481,42 "," 271,49 ",2828645392,CFD," 0,00 "
10/10/2024 06:36:44,Position closed,NSDQ100/USD," 178,77 ",0.198583,"(21,22)"," 5.460,20 "," 450,26 ",2828333714,CFD," 0,00 "
10/10/2024 06:37:33,Open Position,NSDQ100/USD," 250,00 ",0.246966," 0,00 "," 5.460,20 "," 200,26 ",2828647105,CFD," 0,00 "
10/10/2024 06:52:12,Position closed,NSDQ100/USD," 310,26 ",0.306093," 0,26 "," 5.460,46 "," 510,52 ",2828638025,CFD," 0,00 "
10/10/2024 06:52:24,Position closed,NSDQ100/USD," 370,45 ",0.365361," 0,46 "," 5.460,92 "," 880,97 ",2828637790,CFD," 0,00 "
10/10/2024 06:52:48,Position closed,NSDQ100/USD," 252,56 ",0.246966," 2,56 "," 5.463,48 "," 1.133,53 ",2828647105,CFD," 0,00 "
10/10/2024 06:52:56,Position closed,NSDQ100/USD," 101,41 ",0.098805," 1,41 "," 5.464,89 "," 1.234,94 ",2828645392,CFD," 0,00 "
10/10/2024 06:53:01,Position closed,NSDQ100/USD," 252,36 ",0.246949," 2,36 "," 5.467,25 "," 1.487,30 ",2828644206,CFD," 0,00 "
10/10/2024 06:53:10,Position closed,NSDQ100/USD," 301,80 ",0.296303," 1,80 "," 5.469,05 "," 1.789,10 ",2828639686,CFD," 0,00 "
10/10/2024 06:53:31,Open Position,NSDQ100/USD," 449,99 ",0.444264," 0,00 "," 5.469,05 "," 1.339,11 ",2828648838,CFD," 0,00 "
10/10/2024 06:54:20,Open Position,NSDQ100/USD," 340,00 ",0.335719," 0,00 "," 5.469,05 "," 999,11 ",2828648920,CFD," 0,00 "
10/10/2024 06:56:21,Open Position,NSDQ100/USD," 250,00 ",0.246829," 0,00 "," 5.469,05 "," 749,11 ",2828649099,CFD," 0,00 "
10/10/2024 06:57:17,Position closed,NSDQ100/USD," 157,80 ",0.199490,"(42,20)"," 5.426,85 "," 906,91 ",2827916501,CFD," 0,00 "
10/10/2024 06:57:58,Position closed,NSDQ100/USD," 341,16 ",0.335719," 1,16 "," 5.428,01 "," 1.248,07 ",2828648920,CFD," 0,00 "
10/10/2024 06:58:02,Position closed,NSDQ100/USD," 450,19 ",0.444264," 0,20 "," 5.428,21 "," 1.698,26 ",2828648838,CFD," 0,00 "
10/10/2024 06:58:10,Position closed,NSDQ100/USD," 250,43 ",0.246829," 0,43 "," 5.428,64 "," 1.948,69 ",2828649099,CFD," 0,00 "
10/10/2024 06:59:19,Open Position,NSDQ100/USD," 489,99 ",0.483744," 0,00 "," 5.428,64 "," 1.458,70 ",2828649375,CFD," 0,00 "
10/10/2024 06:59:25,Open Position,NSDQ100/USD," 369,99 ",0.365258," 0,00 "," 5.428,64 "," 1.088,71 ",2828649388,CFD," 0,00 "
10/10/2024 06:59:42,Open Position,NSDQ100/USD," 300,00 ",0.296124," 0,00 "," 5.428,64 "," 788,71 ",2828649413,CFD," 0,00 "
10/10/2024 07:00:47,Open Position,NSDQ100/USD," 199,99 ",0.197455," 0,00 "," 5.428,64 "," 588,72 ",2828666191,CFD," 0,00 "
10/10/2024 08:02:48,Open Position,NSDQ100/USD," 149,99 ",0.148228," 0,00 "," 5.428,64 "," 438,73 ",2828702624,CFD," 0,00 "
10/10/2024 08:45:12,Open Position,NSDQ100/USD," 250,00 ",0.247191," 0,00 "," 5.428,64 "," 188,73 ",2828712101,CFD," 0,00 "
10/10/2024 09:32:17,Position closed,NSDQ100/USD," 250,59 ",0.247191," 0,59 "," 5.429,23 "," 439,32 ",2828712101,CFD," 0,00 "
10/10/2024 09:32:24,Position closed,NSDQ100/USD," 148,78 ",0.148228,"(1,21)"," 5.428,02 "," 588,10 ",2828702624,CFD," 0,00 "
10/10/2024 09:33:37,Open Position,NSDQ100/USD," 300,00 ",0.296464," 0,00 "," 5.428,02 "," 288,10 ",2828721634,CFD," 0,00 "
10/10/2024 11:04:44,Position closed,NSDQ100/USD," 293,47 ",0.296464,"(6,53)"," 5.421,49 "," 581,57 ",2828721634,CFD," 0,00 "
10/10/2024 11:12:16,Open Position,NSDQ100/USD," 149,99 ",0.148404," 0,00 "," 5.421,49 "," 431,58 ",2828739431,CFD," 0,00 "
10/10/2024 11:17:48,Position closed,NSDQ100/USD," 151,35 ",0.148404," 1,36 "," 5.422,85 "," 582,93 ",2828739431,CFD," 0,00 "
10/10/2024 12:00:58,Open Position,NSDQ100/USD," 199,99 ",0.197550," 0,00 "," 5.422,85 "," 382,94 ",2828747984,CFD," 0,00 "
10/10/2024 12:10:37,Position closed,NSDQ100/USD," 201,74 ",0.197550," 1,75 "," 5.424,60 "," 584,68 ",2828747984,CFD," 0,00 "
10/10/2024 12:12:40,Position closed,NSDQ100/USD," 199,21 ",0.197455,"(0,78)"," 5.423,82 "," 783,89 ",2828666191,CFD," 0,00 "
10/10/2024 12:24:01,Open Position,NSDQ100/USD," 199,99 ",0.197550," 0,00 "," 5.423,82 "," 583,90 ",2828754521,CFD," 0,00 "
10/10/2024 12:25:11,Position closed,NSDQ100/USD," 482,86 ",0.483744,"(7,13)"," 5.416,69 "," 1.066,76 ",2828649375,CFD," 0,00 "
10/10/2024 12:27:49,Position closed,NSDQ100/USD," 198,44 ",0.197550,"(1,55)"," 5.415,14 "," 1.265,20 ",2828754521,CFD," 0,00 "
10/10/2024 12:31:07,Open Position,NSDQ100/USD," 320,00 ",0.316527," 0,00 "," 5.415,14 "," 945,20 ",2828760363,CFD," 0,00 "
10/10/2024 12:31:49,Open Position,NSDQ100/USD," 239,99 ",0.237386," 0,00 "," 5.415,14 "," 705,21 ",2828760908,CFD," 0,00 "
10/10/2024 12:37:58,Open Position,NSDQ100/USD," 179,98 ",0.178254," 0,00 "," 5.415,14 "," 525,23 ",2828763855,CFD," 0,00 "
10/10/2024 12:41:12,Position closed,NSDQ100/USD," 169,28 ",0.178254,"(10,70)"," 5.404,44 "," 694,51 ",2828763855,CFD," 0,00 "
10/10/2024 12:42:19,Open Position,NSDQ100/USD," 179,99 ",0.178691," 0,00 "," 5.404,44 "," 514,52 ",2828766391,CFD," 0,00 "
10/10/2024 12:42:31,Position closed,NSDQ100/USD," 211,38 ",0.250129,"(38,61)"," 5.365,83 "," 725,90 ",2827350562,CFD," 0,00 "
10/10/2024 12:44:45,Open Position,NSDQ100/USD," 189,99 ",0.188516," 0,00 "," 5.365,83 "," 535,91 ",2828767393,CFD," 0,00 "
10/10/2024 12:46:05,Position closed,NSDQ100/USD," 190,66 ",0.188516," 0,67 "," 5.366,50 "," 726,57 ",2828767393,CFD," 0,00 "
10/10/2024 12:46:09,Position closed,NSDQ100/USD," 181,95 ",0.178691," 1,96 "," 5.368,46 "," 908,52 ",2828766391,CFD," 0,00 "
10/10/2024 12:46:37,Open Position,NSDQ100/USD," 300,00 ",0.297508," 0,00 "," 5.368,46 "," 608,52 ",2828768133,CFD," 0,00 "
10/10/2024 12:47:44,Open Position,NSDQ100/USD," 300,00 ",0.297468," 0,00 "," 5.368,46 "," 308,52 ",2828768597,CFD," 0,00 "
10/10/2024 12:48:15,Position closed,NSDQ100/USD," 302,70 ",0.297508," 2,70 "," 5.371,16 "," 611,22 ",2828768133,CFD," 0,00 "
10/10/2024 12:48:27,Position closed,NSDQ100/USD," 302,88 ",0.297468," 2,88 "," 5.374,04 "," 914,10 ",2828768597,CFD," 0,00 "
10/10/2024 12:51:08,Open Position,NSDQ100/USD," 250,00 ",0.247884," 0,00 "," 5.374,04 "," 664,10 ",2828770585,CFD," 0,00 "
10/10/2024 12:51:18,Position closed,NSDQ100/USD," 248,73 ",0.247884,"(1,27)"," 5.372,77 "," 912,83 ",2828770585,CFD," 0,00 "
10/10/2024 12:52:28,Open Position,NSDQ100/USD," 199,99 ",0.198304," 0,00 "," 5.372,77 "," 712,84 ",2828771108,CFD," 0,00 "
10/10/2024 12:54:47,Open Position,NSDQ100/USD," 50,00 ",0.049582," 0,00 "," 5.372,77 "," 662,84 ",2828772137,CFD," 0,00 "
10/10/2024 12:55:10,Position closed,NSDQ100/USD," 201,17 ",0.198304," 1,18 "," 5.373,95 "," 864,01 ",2828771108,CFD," 0,00 "
10/10/2024 12:55:21,Position closed,NSDQ100/USD," 50,29 ",0.049582," 0,29 "," 5.374,24 "," 914,30 ",2828772137,CFD," 0,00 "
10/10/2024 12:56:21,Open Position,NSDQ100/USD," 229,99 ",0.228168," 0,00 "," 5.374,24 "," 684,31 ",2828772753,CFD," 0,00 "
10/10/2024 12:57:06,Position closed,NSDQ100/USD," 231,24 ",0.228168," 1,25 "," 5.375,49 "," 915,55 ",2828772753,CFD," 0,00 "
10/10/2024 12:59:58,Position closed,NSDQ100/USD," 227,48 ",0.237386,"(12,51)"," 5.362,98 "," 1.143,03 ",2828760908,CFD," 0,00 "
10/10/2024 13:00:09,Open Position,NSDQ100/USD," 249,99 ",0.247900," 0,00 "," 5.362,98 "," 893,04 ",2828773598,CFD," 0,00 "
10/10/2024 13:09:22,Position closed,NSDQ100/USD," 248,74 ",0.247900,"(1,25)"," 5.361,73 "," 1.141,78 ",2828773598,CFD," 0,00 "
10/10/2024 13:11:33,Open Position,NSDQ100/USD," 290,00 ",0.287502," 0,00 "," 5.361,73 "," 851,78 ",2828778457,CFD," 0,00 "
10/10/2024 13:11:41,Open Position,NSDQ100/USD," 219,99 ",0.218122," 0,00 "," 5.361,73 "," 631,79 ",2828778494,CFD," 0,00 "
10/10/2024 13:12:35,Open Position,NSDQ100/USD," 300,00 ",0.297454," 0,00 "," 5.361,73 "," 331,79 ",2828778705,CFD," 0,00 "
10/10/2024 13:19:20,Open Position,NSDQ100/USD," 250,00 ",0.247902," 0,00 "," 5.361,73 "," 81,79 ",2828780276,CFD," 0,00 "
10/10/2024 13:32:11,Position closed,NSDQ100/USD," 251,19 ",0.247902," 1,19 "," 5.362,92 "," 332,98 ",2828780276,CFD," 0,00 "
10/10/2024 13:32:40,Position closed,NSDQ100/USD," 303,90 ",0.297454," 3,90 "," 5.366,82 "," 636,88 ",2828778705,CFD," 0,00 "
10/10/2024 13:32:55,Position closed,NSDQ100/USD," 222,63 ",0.218122," 2,64 "," 5.369,46 "," 859,51 ",2828778494,CFD," 0,00 "
10/10/2024 13:33:05,Position closed,NSDQ100/USD," 292,91 ",0.287502," 2,91 "," 5.372,37 "," 1.152,42 ",2828778457,CFD," 0,00 "
10/10/2024 13:33:13,Open Position,NSDQ100/USD," 289,99 ",0.287259," 0,00 "," 5.372,37 "," 862,43 ",2828852387,CFD," 0,00 "
10/10/2024 13:33:27,Open Position,NSDQ100/USD," 220,00 ",0.217884," 0,00 "," 5.372,37 "," 642,43 ",2828853892,CFD," 0,00 "
10/10/2024 13:39:58,Open Position,NSDQ100/USD," 299,99 ",0.297317," 0,00 "," 5.372,37 "," 342,44 ",2828888710,CFD," 0,00 "
10/10/2024 13:43:45,Position closed,NSDQ100/USD," 300,52 ",0.297317," 0,53 "," 5.372,90 "," 642,96 ",2828888710,CFD," 0,00 "
10/10/2024 13:52:32,Open Position,NSDQ100/USD," 200,00 ",0.198487," 0,00 "," 5.372,90 "," 442,96 ",2828957440,CFD," 0,00 "
10/10/2024 13:53:08,Open Position,NSDQ100/USD," 200,00 ",0.198449," 0,00 "," 5.372,90 "," 242,96 ",2828960305,CFD," 0,00 "
10/10/2024 13:53:56,Position closed,NSDQ100/USD," 178,40 ",0.251631,"(71,60)"," 5.301,30 "," 421,36 ",2826953564,CFD," 0,00 "
10/10/2024 13:54:33,Open Position,NSDQ100/USD," 200,00 ",0.198445," 0,00 "," 5.301,30 "," 221,36 ",2828964852,CFD," 0,00 "
10/10/2024 13:56:57,Position closed,NSDQ100/USD," 290,30 ",0.287259," 0,31 "," 5.301,61 "," 511,66 ",2828852387,CFD," 0,00 "
10/10/2024 13:57:48,Position closed,NSDQ100/USD," 204,90 ",0.198445," 4,90 "," 5.306,51 "," 716,56 ",2828964852,CFD," 0,00 "
10/10/2024 13:57:52,Position closed,NSDQ100/USD," 205,43 ",0.198449," 5,43 "," 5.311,94 "," 921,99 ",2828960305,CFD," 0,00 "
10/10/2024 13:57:57,Position closed,NSDQ100/USD," 205,75 ",0.198487," 5,75 "," 5.317,69 "," 1.127,74 ",2828957440,CFD," 0,00 "
10/10/2024 13:58:22,Open Position,NSDQ100/USD," 249,99 ",0.247626," 0,00 "," 5.317,69 "," 877,75 ",2828970674,CFD," 0,00 "
10/10/2024 14:00:07,Open Position,NSDQ100/USD," 220,00 ",0.218139," 0,00 "," 5.317,69 "," 657,75 ",2828972615,CFD," 0,00 "
10/10/2024 14:00:33,Position closed,NSDQ100/USD," 224,29 ",0.218139," 4,29 "," 5.321,98 "," 882,04 ",2828972615,CFD," 0,00 "
10/10/2024 14:00:52,Position closed,NSDQ100/USD," 250,58 ",0.247626," 0,59 "," 5.322,57 "," 1.132,62 ",2828970674,CFD," 0,00 "
10/10/2024 14:01:29,Open Position,NSDQ100/USD," 289,99 ",0.287158," 0,00 "," 5.322,57 "," 842,63 ",2828974819,CFD," 0,00 "
10/10/2024 14:02:28,Open Position,NSDQ100/USD," 299,99 ",0.297136," 0,00 "," 5.322,57 "," 542,64 ",2828976221,CFD," 0,00 "
10/10/2024 14:03:07,Open Position,NSDQ100/USD," 299,99 ",0.297290," 0,00 "," 5.322,57 "," 242,65 ",2828976746,CFD," 0,00 "
10/10/2024 14:03:36,Position closed,NSDQ100/USD," 301,14 ",0.297290," 1,15 "," 5.323,72 "," 543,79 ",2828976746,CFD," 0,00 "
10/10/2024 14:05:21,Position closed,NSDQ100/USD," 291,36 ",0.287158," 1,37 "," 5.325,09 "," 835,15 ",2828974819,CFD," 0,00 "
10/10/2024 14:05:28,Position closed,NSDQ100/USD," 301,88 ",0.297136," 1,89 "," 5.326,98 "," 1.137,03 ",2828976221,CFD," 0,00 "
10/10/2024 14:05:54,Position closed,NSDQ100/USD," 222,91 ",0.217884," 2,91 "," 5.329,89 "," 1.359,94 ",2828853892,CFD," 0,00 "
10/10/2024 14:06:18,Open Position,NSDQ100/USD," 269,98 ",0.267288," 0,00 "," 5.329,89 "," 1.089,96 ",2828982191,CFD," 0,00 "
10/10/2024 14:06:40,Open Position,NSDQ100/USD," 279,99 ",0.277274," 0,00 "," 5.329,89 "," 809,97 ",2828982589,CFD," 0,00 "
10/10/2024 14:07:02,Open Position,NSDQ100/USD," 210,00 ",0.207996," 0,00 "," 5.329,89 "," 599,97 ",2828982998,CFD," 0,00 "
10/10/2024 14:07:28,Open Position,NSDQ100/USD," 299,99 ",0.297247," 0,00 "," 5.329,89 "," 299,98 ",2828984377,CFD," 0,00 "
10/10/2024 14:08:56,Position closed,NSDQ100/USD," 210,24 ",0.207996," 0,24 "," 5.330,13 "," 510,22 ",2828982998,CFD," 0,00 "
10/10/2024 14:09:10,Position closed,NSDQ100/USD," 302,80 ",0.297247," 2,81 "," 5.332,94 "," 813,02 ",2828984377,CFD," 0,00 "
10/10/2024 14:10:40,Position closed,NSDQ100/USD," 282,14 ",0.277274," 2,15 "," 5.335,09 "," 1.095,16 ",2828982589,CFD," 0,00 "
10/10/2024 14:11:05,Position closed,NSDQ100/USD," 273,69 ",0.267288," 3,71 "," 5.338,80 "," 1.368,85 ",2828982191,CFD," 0,00 "
10/10/2024 14:11:12,Position closed,NSDQ100/USD," 320,61 ",0.316527," 0,61 "," 5.339,41 "," 1.689,46 ",2828760363,CFD," 0,00 "
10/10/2024 14:11:58,Open Position,NSDQ100/USD," 299,99 ",0.296614," 0,00 "," 5.339,41 "," 1.389,47 ",2828990879,CFD," 0,00 "
10/10/2024 14:14:10,Open Position,NSDQ100/USD," 350,00 ",0.346249," 0,00 "," 5.339,41 "," 1.039,47 ",2828994811,CFD," 0,00 "
10/10/2024 14:15:35,Position closed,NSDQ100/USD," 183,94 ",0.302335,"(116,05)"," 5.223,36 "," 1.223,41 ",2826951573,CFD," 0,00 "
10/10/2024 14:16:06,Open Position,NSDQ100/USD," 200,00 ",0.197748," 0,00 "," 5.223,36 "," 1.023,41 ",2828997215,CFD," 0,00 "
10/10/2024 14:16:39,Position closed,NSDQ100/USD," 351,93 ",0.346249," 1,93 "," 5.225,29 "," 1.375,34 ",2828994811,CFD," 0,00 "
10/10/2024 14:17:00,Open Position,NSDQ100/USD," 499,99 ",0.494497," 0,00 "," 5.225,29 "," 875,35 ",2829000166,CFD," 0,00 "
10/10/2024 14:20:57,Open Position,NSDQ100/USD," 350,00 ",0.346437," 0,00 "," 5.225,29 "," 525,35 ",2829007860,CFD," 0,00 "
10/10/2024 14:21:12,Open Position,NSDQ100/USD," 350,00 ",0.346429," 0,00 "," 5.225,29 "," 175,35 ",2829008122,CFD," 0,00 "
10/10/2024 14:25:07,Open Position,NSDQ100/USD," 149,99 ",0.148473," 0,00 "," 5.225,29 "," 25,36 ",2829013929,CFD," 0,00 "
10/10/2024 14:28:05,Position closed,NSDQ100/USD," 353,56 ",0.346437," 3,56 "," 5.228,85 "," 378,92 ",2829007860,CFD," 0,00 "
10/10/2024 14:28:23,Position closed,NSDQ100/USD," 150,33 ",0.148473," 0,34 "," 5.229,19 "," 529,25 ",2829013929,CFD," 0,00 "
10/10/2024 14:30:25,Position closed,NSDQ100/USD," 354,01 ",0.346429," 4,01 "," 5.233,20 "," 883,26 ",2829008122,CFD," 0,00 "
10/10/2024 14:30:37,Position closed,NSDQ100/USD," 499,09 ",0.494497,"(0,90)"," 5.232,30 "," 1.382,35 ",2829000166,CFD," 0,00 "
10/10/2024 14:31:24,Open Position,NSDQ100/USD," 250,00 ",0.247405," 0,00 "," 5.232,30 "," 1.132,35 ",2829020511,CFD," 0,00 "
10/10/2024 14:31:36,Open Position,NSDQ100/USD," 289,99 ",0.286961," 0,00 "," 5.232,30 "," 842,36 ",2829020680,CFD," 0,00 "
10/10/2024 14:32:29,Open Position,NSDQ100/USD," 350,00 ",0.346504," 0,00 "," 5.232,30 "," 492,36 ",2829022462,CFD," 0,00 "
10/10/2024 14:36:00,Position closed,NSDQ100/USD," 166,06 ",0.251692,"(83,93)"," 5.148,37 "," 658,42 ",2826972939,CFD," 0,00 "
10/10/2024 14:36:29,Open Position,NSDQ100/USD," 400,00 ",0.396338," 0,00 "," 5.148,37 "," 258,42 ",2829028064,CFD," 0,00 "
10/10/2024 14:39:06,Position closed,NSDQ100/USD," 404,47 ",0.396338," 4,47 "," 5.152,84 "," 662,89 ",2829028064,CFD," 0,00 "
10/10/2024 14:39:54,Open Position,NSDQ100/USD," 200,00 ",0.198009," 0,00 "," 5.152,84 "," 462,89 ",2829032506,CFD," 0,00 "
10/10/2024 14:40:12,Open Position,NSDQ100/USD," 200,00 ",0.198051," 0,00 "," 5.152,84 "," 262,89 ",2829032679,CFD," 0,00 "
10/10/2024 14:43:01,Position closed,NSDQ100/USD," 201,68 ",0.198051," 1,68 "," 5.154,52 "," 464,57 ",2829032679,CFD," 0,00 "
10/10/2024 14:43:42,Position closed,NSDQ100/USD," 291,62 ",0.286961," 1,63 "," 5.156,15 "," 756,19 ",2829020680,CFD," 0,00 "
10/10/2024 14:44:05,Position closed,NSDQ100/USD," 357,16 ",0.346504," 7,16 "," 5.163,31 "," 1.113,35 ",2829022462,CFD," 0,00 "
10/10/2024 14:44:22,Position closed,NSDQ100/USD," 253,65 ",0.247405," 3,65 "," 5.166,96 "," 1.367,00 ",2829020511,CFD," 0,00 "
10/10/2024 14:45:00,Position closed,NSDQ100/USD," 202,61 ",0.198009," 2,61 "," 5.169,57 "," 1.569,61 ",2829032506,CFD," 0,00 "
10/10/2024 14:45:24,Open Position,NSDQ100/USD," 399,99 ",0.395813," 0,00 "," 5.169,57 "," 1.169,62 ",2829036260,CFD," 0,00 "
10/10/2024 14:45:40,Open Position,NSDQ100/USD," 200,00 ",0.197819," 0,00 "," 5.169,57 "," 969,62 ",2829036444,CFD," 0,00 "
10/10/2024 14:47:18,Open Position,NSDQ100/USD," 250,00 ",0.247273," 0,00 "," 5.169,57 "," 719,62 ",2829038117,CFD," 0,00 "
10/10/2024 14:47:50,Position closed,NSDQ100/USD," 200,55 ",0.197748," 0,55 "," 5.170,12 "," 920,17 ",2828997215,CFD," 0,00 "
10/10/2024 14:48:02,Position closed,NSDQ100/USD," 300,87 ",0.296614," 0,88 "," 5.171,00 "," 1.221,04 ",2828990879,CFD," 0,00 "
10/10/2024 14:48:17,Position closed,NSDQ100/USD," 402,79 ",0.395813," 2,80 "," 5.173,80 "," 1.623,83 ",2829036260,CFD," 0,00 "
10/10/2024 14:48:36,Open Position,NSDQ100/USD," 299,99 ",0.296685," 0,00 "," 5.173,80 "," 1.323,84 ",2829039399,CFD," 0,00 "
10/10/2024 14:48:53,Open Position,NSDQ100/USD," 250,00 ",0.247319," 0,00 "," 5.173,80 "," 1.073,84 ",2829039871,CFD," 0,00 "
10/10/2024 14:49:32,Open Position,NSDQ100/USD," 269,99 ",0.267082," 0,00 "," 5.173,80 "," 803,85 ",2829040383,CFD," 0,00 "
10/10/2024 14:53:44,Open Position,NSDQ100/USD," 299,99 ",0.297102," 0,00 "," 5.173,80 "," 503,86 ",2829047264,CFD," 0,00 "
10/10/2024 14:57:24,Position closed,NSDQ100/USD," 305,24 ",0.297102," 5,25 "," 5.179,05 "," 809,10 ",2829047264,CFD," 0,00 "
10/10/2024 14:58:00,Open Position,NSDQ100/USD," 299,99 ",0.296984," 0,00 "," 5.179,05 "," 509,11 ",2829055196,CFD," 0,00 "
10/10/2024 14:58:13,Open Position,NSDQ100/USD," 149,99 ",0.148520," 0,00 "," 5.179,05 "," 359,12 ",2829055905,CFD," 0,00 "
10/10/2024 14:58:27,Open Position,NSDQ100/USD," 149,99 ",0.148568," 0,00 "," 5.179,05 "," 209,13 ",2829056186,CFD," 0,00 "
10/10/2024 15:03:11,Open Position,NSDQ100/USD," 149,99 ",0.148641," 0,00 "," 5.179,05 "," 59,14 ",2829061984,CFD," 0,00 "
10/10/2024 15:08:27,Position closed,NSDQ100/USD," 200,15 ",0.197819," 0,15 "," 5.179,20 "," 259,29 ",2829036444,CFD," 0,00 "
10/10/2024 15:08:34,Position closed,NSDQ100/USD," 155,90 ",0.148641," 5,91 "," 5.185,11 "," 415,19 ",2829061984,CFD," 0,00 "
10/10/2024 15:08:44,Position closed,NSDQ100/USD," 250,78 ",0.247273," 0,78 "," 5.185,89 "," 665,97 ",2829038117,CFD," 0,00 "
10/10/2024 15:09:00,Position closed,NSDQ100/USD," 300,22 ",0.296685," 0,23 "," 5.186,12 "," 966,19 ",2829039399,CFD," 0,00 "
10/10/2024 15:09:26,Position closed,NSDQ100/USD," 154,14 ",0.148568," 4,15 "," 5.190,27 "," 1.120,33 ",2829056186,CFD," 0,00 "
10/10/2024 15:09:31,Position closed,NSDQ100/USD," 249,50 ",0.247319,"(0,50)"," 5.189,77 "," 1.369,83 ",2829039871,CFD," 0,00 "
10/10/2024 15:09:38,Position closed,NSDQ100/USD," 152,11 ",0.148520," 2,12 "," 5.191,89 "," 1.521,94 ",2829055905,CFD," 0,00 "
10/10/2024 15:09:55,Position closed,NSDQ100/USD," 304,79 ",0.296984," 4,80 "," 5.196,69 "," 1.826,73 ",2829055196,CFD," 0,00 "
10/10/2024 15:10:34,Open Position,NSDQ100/USD," 250,00 ",0.247297," 0,00 "," 5.196,69 "," 1.576,73 ",2829069049,CFD," 0,00 "
10/10/2024 15:11:28,Position closed,NSDQ100/USD," 271,45 ",0.267082," 1,46 "," 5.198,15 "," 1.848,18 ",2829040383,CFD," 0,00 "
10/10/2024 15:12:02,Position closed,NSDQ100/USD," 251,11 ",0.247297," 1,11 "," 5.199,26 "," 2.099,29 ",2829069049,CFD," 0,00 "
10/10/2024 15:12:30,Open Position,NSDQ100/USD," 250,00 ",0.247197," 0,00 "," 5.199,26 "," 1.849,29 ",2829070352,CFD," 0,00 "
10/10/2024 15:12:51,Open Position,NSDQ100/USD," 250,00 ",0.247270," 0,00 "," 5.199,26 "," 1.599,29 ",2829070684,CFD," 0,00 "
10/10/2024 15:13:36,Open Position,NSDQ100/USD," 350,00 ",0.346136," 0,00 "," 5.199,26 "," 1.249,29 ",2829071140,CFD," 0,00 "
10/10/2024 15:14:48,Position closed,NSDQ100/USD," 250,17 ",0.247197," 0,17 "," 5.199,43 "," 1.499,46 ",2829070352,CFD," 0,00 "
10/10/2024 15:15:24,Position closed,NSDQ100/USD," 254,07 ",0.247270," 4,07 "," 5.203,50 "," 1.753,53 ",2829070684,CFD," 0,00 "
10/10/2024 15:16:21,Position closed,NSDQ100/USD," 356,74 ",0.346136," 6,74 "," 5.210,24 "," 2.110,27 ",2829071140,CFD," 0,00 "
10/10/2024 15:17:06,Open Position,NSDQ100/USD," 299,99 ",0.296507," 0,00 "," 5.210,24 "," 1.810,28 ",2829073852,CFD," 0,00 "
10/10/2024 15:17:33,Open Position,NSDQ100/USD," 349,99 ",0.345891," 0,00 "," 5.210,24 "," 1.460,29 ",2829074146,CFD," 0,00 "
10/10/2024 15:18:56,Open Position,NSDQ100/USD," 200,00 ",0.197685," 0,00 "," 5.210,24 "," 1.260,29 ",2829079326,CFD," 0,00 "
10/10/2024 15:27:52,Position closed,NSDQ100/USD," 202,09 ",0.197685," 2,09 "," 5.212,33 "," 1.462,38 ",2829079326,CFD," 0,00 "
10/10/2024 15:29:11,Position closed,NSDQ100/USD," 353,75 ",0.345891," 3,76 "," 5.216,09 "," 1.816,13 ",2829074146,CFD," 0,00 "
10/10/2024 15:30:37,Position closed,NSDQ100/USD," 302,56 ",0.296507," 2,57 "," 5.218,66 "," 2.118,69 ",2829073852,CFD," 0,00 "
10/10/2024 15:30:47,Open Position,NSDQ100/USD," 200,00 ",0.197554," 0,00 "," 5.218,66 "," 1.918,69 ",2829097513,CFD," 0,00 "
10/10/2024 15:32:24,Open Position,NSDQ100/USD," 299,99 ",0.296460," 0,00 "," 5.218,66 "," 1.618,70 ",2829098774,CFD," 0,00 "
10/10/2024 15:34:04,Position closed,NSDQ100/USD," 302,11 ",0.296460," 2,12 "," 5.220,78 "," 1.920,81 ",2829098774,CFD," 0,00 "
10/10/2024 15:35:21,Position closed,NSDQ100/USD," 199,91 ",0.197554,"(0,09)"," 5.220,69 "," 2.120,72 ",2829097513,CFD," 0,00 "
10/10/2024 15:35:58,Open Position,NSDQ100/USD," 350,00 ",0.345619," 0,00 "," 5.220,69 "," 1.770,72 ",2829100860,CFD," 0,00 "
10/10/2024 15:36:29,Open Position,NSDQ100/USD," 200,00 ",0.197480," 0,00 "," 5.220,69 "," 1.570,72 ",2829101113,CFD," 0,00 "
10/10/2024 15:44:21,Open Position,NSDQ100/USD," 299,99 ",0.296160," 0,00 "," 5.220,69 "," 1.270,73 ",2829106913,CFD," 0,00 "
10/10/2024 15:44:31,Position closed,NSDQ100/USD," 350,85 ",0.345619," 0,85 "," 5.221,54 "," 1.621,58 ",2829100860,CFD," 0,00 "
10/10/2024 15:45:01,Open Position,NSDQ100/USD," 200,00 ",0.197425," 0,00 "," 5.221,54 "," 1.421,58 ",2829107757,CFD," 0,00 "
10/10/2024 15:53:32,Position closed,NSDQ100/USD," 200,27 ",0.197480," 0,27 "," 5.221,81 "," 1.621,85 ",2829101113,CFD," 0,00 "
10/10/2024 15:55:26,Position closed,NSDQ100/USD," 300,83 ",0.296124," 0,83 "," 5.222,64 "," 1.922,68 ",2828649413,CFD," 0,00 "
10/10/2024 15:56:21,Position closed,NSDQ100/USD," 372,59 ",0.365258," 2,60 "," 5.225,24 "," 2.295,27 ",2828649388,CFD," 0,00 "
10/10/2024 15:56:34,Position closed,NSDQ100/USD," 200,98 ",0.197425," 0,98 "," 5.226,22 "," 2.496,25 ",2829107757,CFD," 0,00 "
10/10/2024 15:56:55,Position closed,NSDQ100/USD," 303,09 ",0.296160," 3,10 "," 5.229,32 "," 2.799,34 ",2829106913,CFD," 0,00 "
10/10/2024 16:15:22,Open Position,NSDQ100/USD," 99,99 ",0.098488," 0,00 "," 5.229,32 "," 2.699,35 ",2829137983,CFD," 0,00 "
10/10/2024 16:34:16,Open Position,NSDQ100/USD," 249,99 ",0.246613," 0,00 "," 5.229,32 "," 2.449,36 ",2829152281,CFD," 0,00 "
10/10/2024 16:55:22,Open Position,NSDQ100/USD," 619,99 ",0.612231," 0,00 "," 5.229,32 "," 1.829,37 ",2829166667,CFD," 0,00 "
10/10/2024 16:55:34,Open Position,NSDQ100/USD," 200,00 ",0.197482," 0,00 "," 5.229,32 "," 1.629,37 ",2829166838,CFD," 0,00 "
10/10/2024 17:03:24,Open Position,NSDQ100/USD," 410,00 ",0.404537," 0,00 "," 5.229,32 "," 1.219,37 ",2829172256,CFD," 0,00 "
10/10/2024 17:03:49,Position closed,NSDQ100/USD," 201,93 ",0.197482," 1,93 "," 5.231,25 "," 1.421,30 ",2829166838,CFD," 0,00 "
10/10/2024 17:03:59,Position closed,NSDQ100/USD," 625,90 ",0.612231," 5,91 "," 5.237,16 "," 2.047,20 ",2829166667,CFD," 0,00 "
10/10/2024 17:04:12,Open Position,NSDQ100/USD," 400,00 ",0.394808," 0,00 "," 5.237,16 "," 1.647,20 ",2829173168,CFD," 0,00 "
10/10/2024 17:12:28,Open Position,NSDQ100/USD," 200,00 ",0.197616," 0,00 "," 5.237,16 "," 1.447,20 ",2829177332,CFD," 0,00 "
10/10/2024 17:17:02,Open Position,NSDQ100/USD," 200,00 ",0.197586," 0,00 "," 5.237,16 "," 1.247,20 ",2829179508,CFD," 0,00 "
10/10/2024 17:29:02,Position closed,NSDQ100/USD," 248,80 ",0.246613,"(1,19)"," 5.235,97 "," 1.496,00 ",2829152281,CFD," 0,00 "
10/10/2024 17:29:10,Position closed,NSDQ100/USD," 204,60 ",0.197586," 4,60 "," 5.240,57 "," 1.700,60 ",2829179508,CFD," 0,00 "
10/10/2024 17:29:17,Position closed,NSDQ100/USD," 401,44 ",0.394808," 1,44 "," 5.242,01 "," 2.102,04 ",2829173168,CFD," 0,00 "
10/10/2024 17:29:27,Position closed,NSDQ100/USD," 206,20 ",0.197616," 6,20 "," 5.248,21 "," 2.308,24 ",2829177332,CFD," 0,00 "
10/10/2024 17:29:37,Position closed,NSDQ100/USD," 410,39 ",0.404537," 0,39 "," 5.248,60 "," 2.718,63 ",2829172256,CFD," 0,00 "
10/10/2024 17:30:14,Open Position,NSDQ100/USD," 299,99 ",0.295899," 0,00 "," 5.248,60 "," 2.418,64 ",2829190273,CFD," 0,00 "
10/10/2024 17:30:23,Open Position,NSDQ100/USD," 99,99 ",0.098645," 0,00 "," 5.248,60 "," 2.318,65 ",2829190310,CFD," 0,00 "
10/10/2024 17:49:34,Open Position,NSDQ100/USD," 200,00 ",0.197544," 0,00 "," 5.248,60 "," 2.118,65 ",2829200099,CFD," 0,00 "
10/10/2024 17:52:53,Open Position,NSDQ100/USD," 530,00 ",0.524234," 0,00 "," 5.248,60 "," 1.588,65 ",2829202631,CFD," 0,00 "
10/10/2024 17:53:06,Open Position,NSDQ100/USD," 149,99 ",0.148348," 0,00 "," 5.248,60 "," 1.438,66 ",2829202695,CFD," 0,00 "
10/10/2024 17:53:16,Open Position,NSDQ100/USD," 114,99 ",0.113750," 0,00 "," 5.248,60 "," 1.323,67 ",2829202747,CFD," 0,00 "
10/10/2024 18:05:05,Position closed,NSDQ100/USD," 532,87 ",0.524234," 2,87 "," 5.251,47 "," 1.856,54 ",2829202631,CFD," 0,00 "
10/10/2024 18:05:14,Position closed,NSDQ100/USD," 150,36 ",0.148348," 0,37 "," 5.251,84 "," 2.006,90 ",2829202695,CFD," 0,00 "
10/10/2024 18:05:20,Position closed,NSDQ100/USD," 115,82 ",0.113750," 0,83 "," 5.252,67 "," 2.122,72 ",2829202747,CFD," 0,00 "
10/10/2024 18:05:40,Open Position,NSDQ100/USD," 540,00 ",0.533882," 0,00 "," 5.252,67 "," 1.582,72 ",2829209661,CFD," 0,00 "
10/10/2024 18:05:50,Open Position,NSDQ100/USD," 200,00 ",0.197719," 0,00 "," 5.252,67 "," 1.382,72 ",2829209832,CFD," 0,00 "
10/10/2024 18:32:53,Open Position,NSDQ100/USD," 499,99 ",0.494590," 0,00 "," 5.252,67 "," 882,73 ",2829225165,CFD," 0,00 "
10/10/2024 19:08:58,Open Position,NSDQ100/USD," 299,99 ",0.296845," 0,00 "," 5.252,67 "," 582,74 ",2829260333,CFD," 0,00 "
10/10/2024 19:30:09,Position closed,NSDQ100/USD," 503,44 ",0.494590," 3,45 "," 5.256,12 "," 1.086,18 ",2829225165,CFD," 0,00 "
10/10/2024 19:30:17,Position closed,NSDQ100/USD," 303,90 ",0.296845," 3,91 "," 5.260,03 "," 1.390,08 ",2829260333,CFD," 0,00 "
10/10/2024 19:30:28,Open Position,NSDQ100/USD," 499,99 ",0.494350," 0,00 "," 5.260,03 "," 890,09 ",2829270929,CFD," 0,00 "
10/10/2024 19:31:08,Open Position,NSDQ100/USD," 249,99 ",0.247178," 0,00 "," 5.260,03 "," 640,10 ",2829271144,CFD," 0,00 "
10/10/2024 19:52:55,Position closed,NSDQ100/USD," 252,06 ",0.247178," 2,07 "," 5.262,10 "," 892,16 ",2829271144,CFD," 0,00 "
10/10/2024 19:53:02,Position closed,NSDQ100/USD," 505,12 ",0.494350," 5,13 "," 5.267,23 "," 1.397,28 ",2829270929,CFD," 0,00 "
10/10/2024 19:53:22,Position closed,NSDQ100/USD," 201,83 ",0.197719," 1,83 "," 5.269,06 "," 1.599,11 ",2829209832,CFD," 0,00 "
10/10/2024 19:53:30,Position closed,NSDQ100/USD," 545,80 ",0.533882," 5,80 "," 5.274,86 "," 2.144,91 ",2829209661,CFD," 0,00 "
10/10/2024 19:54:09,Position closed,NSDQ100/USD," 200,07 ",0.197544," 0,07 "," 5.274,93 "," 2.344,98 ",2829200099,CFD," 0,00 "
10/10/2024 19:54:58,Open Position,NSDQ100/USD," 299,99 ",0.296301," 0,00 "," 5.274,93 "," 2.044,99 ",2829285470,CFD," 0,00 "
10/10/2024 19:55:14,Open Position,NSDQ100/USD," 299,99 ",0.296450," 0,00 "," 5.274,93 "," 1.745,00 ",2829285680,CFD," 0,00 "
10/10/2024 20:42:43,Position closed,NSDQ100/USD," 304,00 ",0.296450," 4,01 "," 5.278,94 "," 2.049,00 ",2829285680,CFD," 0,00 "
10/10/2024 20:42:50,Position closed,NSDQ100/USD," 300,91 ",0.296301," 0,92 "," 5.279,86 "," 2.349,91 ",2829285470,CFD," 0,00 "
10/10/2024 20:43:10,Open Position,NSDQ100/USD," 300,00 ",0.296211," 0,00 "," 5.279,86 "," 2.049,91 ",2829297058,CFD," 0,00 "
10/10/2024 23:17:27,Position closed,NSDQ100/USD," 305,32 ",0.296211," 5,32 "," 5.285,18 "," 2.355,23 ",2829297058,CFD," 0,00 "
10/10/2024 23:18:00,Open Position,NSDQ100/USD," 250,00 ",0.246584," 0,00 "," 5.285,18 "," 2.105,23 ",2829303347,CFD," 0,00 "
11/10/2024 00:48:26,Overnight fee,Daily,"(0,01)",-,"(0,01)"," 5.285,17 "," 2.105,22 ",2827181713,CFD," 0,00 "
11/10/2024 00:48:26,Overnight fee,Daily,"(0,01)",-,"(0,01)"," 5.285,16 "," 2.105,21 ",2827005963,CFD," 0,00 "
11/10/2024 00:48:26,Overnight fee,Daily,"(0,01)",-,"(0,01)"," 5.285,15 "," 2.105,20 ",2827009249,CFD," 0,00 "
11/10/2024 00:48:26,Overnight fee,Daily,"(0,01)",-,"(0,01)"," 5.285,14 "," 2.105,19 ",2827000259,CFD," 0,00 "
11/10/2024 00:48:26,Overnight fee,Daily,"(0,01)",-,"(0,01)"," 5.285,13 "," 2.105,18 ",2827021234,CFD," 0,00 "
11/10/2024 00:48:26,Overnight fee,Daily,"(0,01)",-,"(0,01)"," 5.285,12 "," 2.105,17 ",2827073507,CFD," 0,00 "
11/10/2024 00:48:26,Overnight fee,Daily,"(0,01)",-,"(0,01)"," 5.285,11 "," 2.105,16 ",2827008807,CFD," 0,00 "
11/10/2024 00:48:26,Overnight fee,Daily,"(0,02)",-,"(0,02)"," 5.285,09 "," 2.105,14 ",2827348937,CFD," 0,00 "
11/10/2024 00:48:26,Overnight fee,Daily,"(0,50)",-,"(0,50)"," 5.284,59 "," 2.104,64 ",2829190310,CFD," 0,00 "
11/10/2024 00:48:26,Overnight fee,Daily,"(0,50)",-,"(0,50)"," 5.284,09 "," 2.104,14 ",2829137983,CFD," 0,00 "
11/10/2024 00:48:26,Overnight fee,Daily,"(1,51)",-,"(1,51)"," 5.282,58 "," 2.102,63 ",2829190273,CFD," 0,00 "
11/10/2024 00:48:26,Overnight fee,Daily,"(1,52)",-,"(1,52)"," 5.281,06 "," 2.101,11 ",2829297058,CFD," 0,00 "
11/10/2024 01:13:40,Index price adjustment,NSDQ100/USD,"(0,02)",-,"(0,02)"," 5.281,04 "," 2.101,09 ",2827000259,CFD," 0,00 "
11/10/2024 01:13:40,Index price adjustment,NSDQ100/USD,"(0,02)",-,"(0,02)"," 5.281,02 "," 2.101,07 ",2827005963,CFD," 0,00 "
11/10/2024 01:13:40,Index price adjustment,NSDQ100/USD,"(0,01)",-,"(0,01)"," 5.281,01 "," 2.101,06 ",2827008807,CFD," 0,00 "
11/10/2024 01:13:40,Index price adjustment,NSDQ100/USD,"(0,02)",-,"(0,02)"," 5.280,99 "," 2.101,04 ",2827009249,CFD," 0,00 "
11/10/2024 01:13:40,Index price adjustment,NSDQ100/USD,"(0,02)",-,"(0,02)"," 5.280,97 "," 2.101,02 ",2827021234,CFD," 0,00 "
11/10/2024 01:13:40,Index price adjustment,NSDQ100/USD,"(0,02)",-,"(0,02)"," 5.280,95 "," 2.101,00 ",2827073507,CFD," 0,00 "
11/10/2024 01:13:40,Index price adjustment,NSDQ100/USD,"(0,02)",-,"(0,02)"," 5.280,93 "," 2.100,98 ",2827181713,CFD," 0,00 "
11/10/2024 01:13:40,Index price adjustment,NSDQ100/USD,"(0,04)",-,"(0,04)"," 5.280,89 "," 2.100,94 ",2827348937,CFD," 0,00 "
11/10/2024 01:13:40,Index price adjustment,NSDQ100/USD," 0,01 ",-," 0,01 "," 5.280,90 "," 2.100,95 ",2829137983,CFD," 0,00 "
11/10/2024 01:13:40,Index price adjustment,NSDQ100/USD," 0,02 ",-," 0,02 "," 5.280,92 "," 2.100,97 ",2829190273,CFD," 0,00 "
11/10/2024 01:13:40,Index price adjustment,NSDQ100/USD," 0,01 ",-," 0,01 "," 5.280,93 "," 2.100,98 ",2829190310,CFD," 0,00 "
11/10/2024 01:13:40,Index price adjustment,NSDQ100/USD," 0,02 ",-," 0,02 "," 5.280,95 "," 2.101,00 ",2829285470,CFD," 0,00 "
11/10/2024 01:13:40,Index price adjustment,NSDQ100/USD," 0,02 ",-," 0,02 "," 5.280,97 "," 2.101,02 ",2829285680,CFD," 0,00 "
11/10/2024 06:31:19,Open Position,NSDQ100/USD," 300,00 ",0.296364," 0,00 "," 5.280,97 "," 1.801,02 ",2829322009,CFD," 0,00 "
11/10/2024 06:31:58,Open Position,NSDQ100/USD," 149,99 ",0.148183," 0,00 "," 5.280,97 "," 1.651,03 ",2829322078,CFD," 0,00 "
11/10/2024 08:14:56,Position closed,NSDQ100/USD," 203,79 ",0.301848,"(96,20)"," 5.184,77 "," 1.854,82 ",2827000259,CFD," 0,00 "
11/10/2024 08:15:04,Open Position,NSDQ100/USD," 469,99 ",0.465382," 0,00 "," 5.184,77 "," 1.384,83 ",2829373724,CFD," 0,00 "
11/10/2024 08:15:28,Position closed,NSDQ100/USD," 169,14 ",0.251565,"(80,86)"," 5.103,91 "," 1.553,97 ",2827005963,CFD," 0,00 "
11/10/2024 08:15:42,Open Position,NSDQ100/USD," 399,99 ",0.396123," 0,00 "," 5.103,91 "," 1.153,98 ",2829373800,CFD," 0,00 "
11/10/2024 08:16:19,Open Position,NSDQ100/USD," 149,99 ",0.148527," 0,00 "," 5.103,91 "," 1.003,99 ",2829373871,CFD," 0,00 "
11/10/2024 08:48:52,Open Position,NSDQ100/USD," 199,99 ",0.198076," 0,00 "," 5.103,91 "," 804,00 ",2829380658,CFD," 0,00 "
11/10/2024 10:20:40,Open Position,NSDQ100/USD," 149,99 ",0.148482," 0,00 "," 5.103,91 "," 654,01 ",2829399175,CFD," 0,00 "
11/10/2024 12:38:22,Position closed,NSDQ100/USD," 201,59 ",0.198076," 1,60 "," 5.105,51 "," 855,60 ",2829380658,CFD," 0,00 "
11/10/2024 12:44:12,Position closed,NSDQ100/USD," 403,22 ",0.396123," 3,23 "," 5.108,74 "," 1.258,82 ",2829373800,CFD," 0,00 "
11/10/2024 12:44:36,Open Position,NSDQ100/USD," 320,00 ",0.316702," 0,00 "," 5.108,74 "," 938,82 ",2829447033,CFD," 0,00 "
11/10/2024 14:58:16,Position closed,NSDQ100/USD," 158,78 ",0.148527," 8,79 "," 5.117,53 "," 1.097,60 ",2829373871,CFD," 0,00 "
11/10/2024 14:58:23,Position closed,NSDQ100/USD," 496,94 ",0.465382," 26,95 "," 5.144,48 "," 1.594,54 ",2829373724,CFD," 0,00 "
11/10/2024 14:58:30,Position closed,NSDQ100/USD," 303,59 ",0.296364," 3,59 "," 5.148,07 "," 1.898,13 ",2829322009,CFD," 0,00 "
11/10/2024 14:58:38,Position closed,NSDQ100/USD," 336,06 ",0.316702," 16,06 "," 5.164,13 "," 2.234,19 ",2829447033,CFD," 0,00 "
11/10/2024 14:58:46,Position closed,NSDQ100/USD," 158,00 ",0.148482," 8,01 "," 5.172,14 "," 2.392,19 ",2829399175,CFD," 0,00 "
11/10/2024 14:58:53,Position closed,NSDQ100/USD," 151,34 ",0.148183," 1,35 "," 5.173,49 "," 2.543,53 ",2829322078,CFD," 0,00 "
11/10/2024 14:59:19,Open Position,NSDQ100/USD," 299,99 ",0.296195," 0,00 "," 5.173,49 "," 2.243,54 ",2829798873,CFD," 0,00 "
11/10/2024 16:07:28,Position closed,NSDQ100/USD," 309,46 ",0.296195," 9,47 "," 5.182,96 "," 2.553,00 ",2829798873,CFD," 0,00 "
11/10/2024 16:07:35,Position closed,NSDQ100/USD," 253,13 ",0.246584," 3,13 "," 5.186,09 "," 2.806,13 ",2829303347,CFD," 0,00 "
11/10/2024 16:07:42,Position closed,NSDQ100/USD," 101,28 ",0.098645," 1,29 "," 5.187,38 "," 2.907,41 ",2829190310,CFD," 0,00 "
11/10/2024 16:07:48,Position closed,NSDQ100/USD," 303,29 ",0.295899," 3,30 "," 5.190,68 "," 3.210,70 ",2829190273,CFD," 0,00 "
11/10/2024 16:08:42,Open Position,NSDQ100/USD," 299,99 ",0.295692," 0,00 "," 5.190,68 "," 2.910,71 ",2829858456,CFD," 0,00 "
11/10/2024 16:08:56,Open Position,NSDQ100/USD," 149,99 ",0.147867," 0,00 "," 5.190,68 "," 2.760,72 ",2829858534,CFD," 0,00 "
11/10/2024 16:11:57,Open Position,NSDQ100/USD," 199,99 ",0.197138," 0,00 "," 5.190,68 "," 2.560,73 ",2829860391,CFD," 0,00 "
11/10/2024 16:12:12,Open Position,NSDQ100/USD," 200,00 ",0.197152," 0,00 "," 5.190,68 "," 2.360,73 ",2829860545,CFD," 0,00 "
11/10/2024 19:41:45,Position closed,NSDQ100/USD," 299,71 ",0.295692,"(0,28)"," 5.190,40 "," 2.660,44 ",2829858456,CFD," 0,00 "
11/10/2024 19:41:53,Position closed,NSDQ100/USD," 150,35 ",0.147867," 0,36 "," 5.190,76 "," 2.810,79 ",2829858534,CFD," 0,00 "
11/10/2024 19:41:59,Position closed,NSDQ100/USD," 200,70 ",0.197152," 0,70 "," 5.191,46 "," 3.011,49 ",2829860545,CFD," 0,00 "
11/10/2024 19:42:06,Position closed,NSDQ100/USD," 199,23 ",0.197138,"(0,76)"," 5.190,70 "," 3.210,72 ",2829860391,CFD," 0,00 "
11/10/2024 19:42:13,Position closed,NSDQ100/USD," 98,34 ",0.098488,"(1,65)"," 5.189,05 "," 3.309,06 ",2829137983,CFD," 0,00 "
12/10/2024 00:48:28,Overnight fee,Weekend Fee,"(0,02)",-,"(0,02)"," 5.189,03 "," 3.309,04 ",2827009249,CFD," 0,00 "
12/10/2024 00:48:28,Overnight fee,Weekend Fee,"(0,02)",-,"(0,02)"," 5.189,01 "," 3.309,02 ",2827008807,CFD," 0,00 "
12/10/2024 00:48:28,Overnight fee,Weekend Fee,"(0,02)",-,"(0,02)"," 5.188,99 "," 3.309,00 ",2827021234,CFD," 0,00 "
12/10/2024 00:48:28,Overnight fee,Weekend Fee,"(0,03)",-,"(0,03)"," 5.188,96 "," 3.308,97 ",2827181713,CFD," 0,00 "
12/10/2024 00:48:28,Overnight fee,Weekend Fee,"(0,03)",-,"(0,03)"," 5.188,93 "," 3.308,94 ",2827073507,CFD," 0,00 "
12/10/2024 00:48:28,Overnight fee,Weekend Fee,"(0,05)",-,"(0,05)"," 5.188,88 "," 3.308,89 ",2827348937,CFD," 0,00 "
14/10/2024 03:48:43,Open Position,NSDQ100/USD," 300,00 ",0.296514," 0,00 "," 5.188,88 "," 3.008,89 ",2830317408,CFD," 0,00 "
14/10/2024 03:50:34,Position closed,NSDQ100/USD," 127,54 ",0.201282,"(72,46)"," 5.116,42 "," 3.136,43 ",2827008807,CFD," 0,00 "
14/10/2024 03:50:50,Open Position,NSDQ100/USD," 250,00 ",0.247133," 0,00 "," 5.116,42 "," 2.886,43 ",2830317506,CFD," 0,00 "
14/10/2024 05:52:04,Position closed,NSDQ100/USD," 303,55 ",0.296514," 3,55 "," 5.119,97 "," 3.189,98 ",2830317408,CFD," 0,00 "
14/10/2024 05:52:09,Position closed,NSDQ100/USD," 254,05 ",0.247133," 4,05 "," 5.124,02 "," 3.444,03 ",2830317506,CFD," 0,00 "
14/10/2024 06:13:53,Open Position,NSDQ100/USD," 300,00 ",0.296252," 0,00 "," 5.124,02 "," 3.144,03 ",2830326152,CFD," 0,00 "
14/10/2024 06:43:36,Position closed,NSDQ100/USD," 303,16 ",0.296252," 3,16 "," 5.127,18 "," 3.447,19 ",2830326152,CFD," 0,00 "
14/10/2024 06:43:57,Open Position,NSDQ100/USD," 350,00 ",0.345376," 0,00 "," 5.127,18 "," 3.097,19 ",2830329406,CFD," 0,00 "
14/10/2024 06:44:44,Open Position,NSDQ100/USD," 199,99 ",0.197345," 0,00 "," 5.127,18 "," 2.897,20 ",2830329545,CFD," 0,00 "
14/10/2024 09:11:04,Position closed,NSDQ100/USD," 206,42 ",0.197345," 6,43 "," 5.133,61 "," 3.103,62 ",2830329545,CFD," 0,00 "
14/10/2024 09:11:09,Position closed,NSDQ100/USD," 361,31 ",0.345376," 11,31 "," 5.144,92 "," 3.464,93 ",2830329406,CFD," 0,00 "
14/10/2024 09:12:45,Open Position,NSDQ100/USD," 199,99 ",0.197004," 0,00 "," 5.144,92 "," 3.264,94 ",2830455689,CFD," 0,00 "
14/10/2024 10:01:42,Position closed,NSDQ100/USD," 202,17 ",0.197004," 2,18 "," 5.147,10 "," 3.467,11 ",2830455689,CFD," 0,00 "
14/10/2024 10:26:24,Open Position,NSDQ100/USD," 300,00 ",0.294964," 0,00 "," 5.147,10 "," 3.167,11 ",2830490794,CFD," 0,00 "
14/10/2024 11:41:22,Open Position,NSDQ100/USD," 250,00 ",0.245872," 0,00 "," 5.147,10 "," 2.917,11 ",2830508442,CFD," 0,00 "
14/10/2024 11:47:00,Position closed,NSDQ100/USD," 250,28 ",0.245872," 0,28 "," 5.147,38 "," 3.167,39 ",2830508442,CFD," 0,00 "
14/10/2024 13:01:30,Position closed,NSDQ100/USD," 124,96 ",0.251631,"(125,04)"," 5.022,34 "," 3.292,35 ",2827009249,CFD," 0,00 "
14/10/2024 13:16:00,Position closed,NSDQ100/USD," 149,96 ",0.301665,"(150,04)"," 4.872,30 "," 3.442,31 ",2827073507,CFD," 0,00 "
14/10/2024 13:27:11,Position closed,NSDQ100/USD," 309,96 ",0.294964," 9,96 "," 4.882,26 "," 3.752,27 ",2830490794,CFD," 0,00 "
14/10/2024 13:28:09,Open Position,NSDQ100/USD," 300,00 ",0.294456," 0,00 "," 4.882,26 "," 3.452,27 ",2830578405,CFD," 0,00 "
14/10/2024 13:31:36,Position closed,NSDQ100/USD," 124,91 ",0.251357,"(125,09)"," 4.757,17 "," 3.577,18 ",2827021234,CFD," 0,00 "
14/10/2024 13:34:31,Position closed,NSDQ100/USD," 149,96 ",0.301456,"(150,04)"," 4.607,13 "," 3.727,14 ",2827181713,CFD," 0,00 "
14/10/2024 13:37:28,Position closed,NSDQ100/USD," 309,98 ",0.294456," 9,98 "," 4.617,11 "," 4.037,12 ",2830578405,CFD," 0,00 "
14/10/2024 13:37:55,Open Position,NSDQ100/USD," 299,99 ",0.293923," 0,00 "," 4.617,11 "," 3.737,13 ",2830815376,CFD," 0,00 "
14/10/2024 13:38:24,Position closed,NSDQ100/USD," 300,94 ",0.293923," 0,95 "," 4.618,06 "," 4.038,07 ",2830815376,CFD," 0,00 "
14/10/2024 13:39:57,Open Position,NSDQ100/USD," 149,99 ",0.147021," 0,00 "," 4.618,06 "," 3.888,08 ",2830842480,CFD," 0,00 "
14/10/2024 13:44:52,Position closed,NSDQ100/USD," 152,44 ",0.147021," 2,45 "," 4.620,51 "," 4.040,52 ",2830842480,CFD," 0,00 "
14/10/2024 13:45:21,Open Position,NSDQ100/USD," 400,00 ",0.391575," 0,00 "," 4.620,51 "," 3.640,52 ",2830857966,CFD," 0,00 "
14/10/2024 13:45:39,Position closed,NSDQ100/USD," 314,52 ",0.580730,"(265,47)"," 4.355,04 "," 3.955,04 ",2827348937,CFD," 0,00 "
14/10/2024 13:54:48,Position closed,NSDQ100/USD," 410,51 ",0.391575," 10,51 "," 4.365,55 "," 4.365,55 ",2830857966,CFD," 0,00 "
14/10/2024 13:55:33,Open Position,NSDQ100/USD," 400,00 ",0.391010," 0,00 "," 4.365,55 "," 3.965,55 ",2831012721,CFD," 0,00 "
14/10/2024 13:58:07,Position closed,NSDQ100/USD," 406,81 ",0.391010," 6,81 "," 4.372,36 "," 4.372,36 ",2831012721,CFD," 0,00 "
14/10/2024 13:58:54,Open Position,NSDQ100/USD," 499,99 ",0.488143," 0,00 "," 4.372,36 "," 3.872,37 ",2831050048,CFD," 0,00 "
14/10/2024 14:00:12,Position closed,NSDQ100/USD," 503,28 ",0.488143," 3,29 "," 4.375,65 "," 4.375,65 ",2831050048,CFD," 0,00 "
14/10/2024 14:00:45,Open Position,NSDQ100/USD," 350,00 ",0.341603," 0,00 "," 4.375,65 "," 4.025,65 ",2831065566,CFD," 0,00 "
14/10/2024 14:13:40,Open Position,NSDQ100/USD," 400,00 ",0.391251," 0,00 "," 4.375,65 "," 3.625,65 ",2831099623,CFD," 0,00 "
14/10/2024 14:24:12,Open Position,NSDQ100/USD," 299,99 ",0.293423," 0,00 "," 4.375,65 "," 3.325,66 ",2831118734,CFD," 0,00 "
14/10/2024 14:28:45,Position closed,NSDQ100/USD," 404,04 ",0.391251," 4,04 "," 4.379,69 "," 3.729,70 ",2831099623,CFD," 0,00 "
14/10/2024 14:28:53,Position closed,NSDQ100/USD," 302,26 ",0.293423," 2,27 "," 4.381,96 "," 4.031,96 ",2831118734,CFD," 0,00 "
14/10/2024 14:29:06,Open Position,NSDQ100/USD," 499,99 ",0.488715," 0,00 "," 4.381,96 "," 3.531,97 ",2831129852,CFD," 0,00 "
14/10/2024 14:52:32,Open Position,NSDQ100/USD," 299,99 ",0.294123," 0,00 "," 4.381,96 "," 3.231,98 ",2831171169,CFD," 0,00 "
14/10/2024 14:53:09,Open Position,NSDQ100/USD," 249,99 ",0.245004," 0,00 "," 4.381,96 "," 2.981,99 ",2831172910,CFD," 0,00 "
14/10/2024 14:59:32,Open Position,NSDQ100/USD," 200,00 ",0.196221," 0,00 "," 4.381,96 "," 2.781,99 ",2831180179,CFD," 0,00 "
14/10/2024 15:30:51,Open Position,NSDQ100/USD," 200,00 ",0.196494," 0,00 "," 4.381,96 "," 2.581,99 ",2831294031,CFD," 0,00 "
14/10/2024 16:00:32,Position closed,NSDQ100/USD," 209,72 ",0.196494," 9,72 "," 4.391,68 "," 2.791,71 ",2831294031,CFD," 0,00 "
14/10/2024 16:00:39,Position closed,NSDQ100/USD," 204,31 ",0.196221," 4,31 "," 4.395,99 "," 2.996,02 ",2831180179,CFD," 0,00 "
14/10/2024 16:00:46,Position closed,NSDQ100/USD," 302,53 ",0.294123," 2,54 "," 4.398,53 "," 3.298,55 ",2831171169,CFD," 0,00 "
14/10/2024 16:01:23,Open Position,NSDQ100/USD," 200,00 ",0.196012," 0,00 "," 4.398,53 "," 3.098,55 ",2831325242,CFD," 0,00 "
14/10/2024 16:43:32,Position closed,NSDQ100/USD," 204,20 ",0.196012," 4,20 "," 4.402,73 "," 3.302,75 ",2831325242,CFD," 0,00 "
14/10/2024 16:43:38,Position closed,NSDQ100/USD," 254,88 ",0.245004," 4,89 "," 4.407,62 "," 3.557,63 ",2831172910,CFD," 0,00 "
14/10/2024 17:13:07,Open Position,NSDQ100/USD," 200,00 ",0.195835," 0,00 "," 4.407,62 "," 3.357,63 ",2831385450,CFD," 0,00 "
14/10/2024 18:14:52,Position closed,NSDQ100/USD," 202,89 ",0.195835," 2,89 "," 4.410,51 "," 3.560,52 ",2831385450,CFD," 0,00 "
14/10/2024 18:15:14,Open Position,NSDQ100/USD," 200,00 ",0.195652," 0,00 "," 4.410,51 "," 3.360,52 ",2831427281,CFD," 0,00 "
14/10/2024 19:22:55,Position closed,NSDQ100/USD," 201,96 ",0.195652," 1,96 "," 4.412,47 "," 3.562,48 ",2831427281,CFD," 0,00 "
14/10/2024 19:23:02,Position closed,NSDQ100/USD," 496,44 ",0.488715,"(3,55)"," 4.408,92 "," 4.058,92 ",2831129852,CFD," 0,00 "
14/10/2024 19:24:34,Open Position,TSLA/USD," 199,99 ",4.559578," 0,00 "," 4.408,92 "," 3.858,93 ",2831472675,CFD," 0,00 "
14/10/2024 19:24:48,Open Position,NSDQ100/USD," 200,00 ",0.195507," 0,00 "," 4.408,92 "," 3.658,93 ",2831472746,CFD," 0,00 "
14/10/2024 19:46:58,Position closed,NSDQ100/USD," 201,49 ",0.195507," 1,49 "," 4.410,41 "," 3.860,42 ",2831472746,CFD," 0,00 "
14/10/2024 19:47:43,Position closed,NSDQ100/USD," 344,24 ",0.341603,"(5,76)"," 4.404,65 "," 4.204,66 ",2831065566,CFD," 0,00 "
14/10/2024 20:29:10,Open Position,NSDQ100/USD," 350,00 ",0.342517," 0,00 "," 4.404,65 "," 3.854,66 ",2831530740,CFD," 0,00 "
14/10/2024 22:00:30,Position closed,NSDQ100/USD," 355,29 ",0.342517," 5,29 "," 4.409,94 "," 4.209,95 ",2831530740,CFD," 0,00 "
14/10/2024 23:18:11,Open Position,NSDQ100/USD," 300,00 ",0.293377," 0,00 "," 4.409,94 "," 3.909,95 ",2831550507,CFD," 0,00 "
15/10/2024 00:48:55,Overnight fee,Daily,"(0,31)",-,"(0,31)"," 4.409,63 "," 3.909,64 ",2831472675,CFD," 0,00 "
15/10/2024 00:48:55,Overnight fee,Daily,"(1,77)",-,"(1,77)"," 4.407,86 "," 3.907,87 ",2831530740,CFD," 0,00 "
15/10/2024 06:40:46,Open Position,NSDQ100/USD," 500,00 ",0.489513," 0,00 "," 4.407,86 "," 3.407,87 ",2831586823,CFD," 0,00 "
15/10/2024 06:40:58,Open Position,NSDQ100/USD," 250,00 ",0.244764," 0,00 "," 4.407,86 "," 3.157,87 ",2831586841,CFD," 0,00 "
15/10/2024 07:46:32,Open Position,NSDQ100/USD," 399,99 ",0.391593," 0,00 "," 4.407,86 "," 2.757,88 ",2831645732,CFD," 0,00 "
15/10/2024 07:47:47,Open Position,UK100/GBP," 100,00 ",0.184876," 0,00 "," 4.407,86 "," 2.657,88 ",2831646001,CFD," 0,00 "
15/10/2024 07:48:37,Open Position,NSDQ100/USD," 199,99 ",0.195781," 0,00 "," 4.407,86 "," 2.457,89 ",2831646153,CFD," 0,00 "
15/10/2024 08:24:42,Open Position,NSDQ100/USD," 619,99 ",0.607720," 0,00 "," 4.407,86 "," 1.837,90 ",2831657464,CFD," 0,00 "
15/10/2024 08:40:08,Open Position,NSDQ100/USD," 199,99 ",0.196115," 0,00 "," 4.407,86 "," 1.637,91 ",2831664949,CFD," 0,00 "
15/10/2024 08:48:27,Position closed,NSDQ100/USD," 201,15 ",0.196115," 1,16 "," 4.409,02 "," 1.839,06 ",2831664949,CFD," 0,00 "
15/10/2024 09:02:10,Position closed,NSDQ100/USD," 620,93 ",0.607720," 0,94 "," 4.409,96 "," 2.459,99 ",2831657464,CFD," 0,00 "
15/10/2024 09:38:00,Open Position,NSDQ100/USD," 199,99 ",0.195998," 0,00 "," 4.409,96 "," 2.260,00 ",2831678662,CFD," 0,00 "
15/10/2024 12:13:50,Position closed,NSDQ100/USD," 205,52 ",0.195998," 5,53 "," 4.415,49 "," 2.465,52 ",2831678662,CFD," 0,00 "
15/10/2024 12:14:15,Position closed,NSDQ100/USD," 201,70 ",0.195781," 1,71 "," 4.417,20 "," 2.667,22 ",2831646153,CFD," 0,00 "
15/10/2024 12:14:22,Position closed,NSDQ100/USD," 404,04 ",0.391593," 4,05 "," 4.421,25 "," 3.071,26 ",2831645732,CFD," 0,00 "
15/10/2024 12:14:32,Position closed,NSDQ100/USD," 505,31 ",0.489513," 5,31 "," 4.426,56 "," 3.576,57 ",2831586823,CFD," 0,00 "
15/10/2024 12:14:40,Position closed,NSDQ100/USD," 252,70 ",0.244764," 2,70 "," 4.429,26 "," 3.829,27 ",2831586841,CFD," 0,00 "
15/10/2024 12:15:52,Open Position,NSDQ100/USD," 250,00 ",0.244555," 0,00 "," 4.429,26 "," 3.579,27 ",2831725489,CFD," 0,00 "
15/10/2024 13:01:08,Position closed,NSDQ100/USD," 300,54 ",0.293377," 0,54 "," 4.429,80 "," 3.879,81 ",2831550507,CFD," 0,00 "
15/10/2024 13:01:08,Position closed,NSDQ100/USD," 251,96 ",0.244555," 1,96 "," 4.431,76 "," 4.131,77 ",2831725489,CFD," 0,00 "
15/10/2024 13:04:22,Open Position,NSDQ100/USD," 250,00 ",0.244412," 0,00 "," 4.431,76 "," 3.881,77 ",2831738314,CFD," 0,00 "
15/10/2024 13:25:08,Position closed,NSDQ100/USD," 252,64 ",0.244412," 2,64 "," 4.434,40 "," 4.134,41 ",2831738314,CFD," 0,00 "
15/10/2024 13:28:55,Open Position,NSDQ100/USD," 250,00 ",0.244389," 0,00 "," 4.434,40 "," 3.884,41 ",2831760585,CFD," 0,00 "
15/10/2024 13:32:14,Open Position,NSDQ100/USD," 199,98 ",0.195603," 0,00 "," 4.434,40 "," 3.684,43 ",2831871174,CFD," 0,00 "
15/10/2024 13:33:30,Open Position,NSDQ100/USD," 200,00 ",0.195551," 0,00 "," 4.434,40 "," 3.484,43 ",2831973426,CFD," 0,00 "
15/10/2024 13:34:31,Position closed,TSLA/USD," 213,93 ",4.559578," 13,94 "," 4.448,34 "," 3.698,36 ",2831472675,CFD," 0,00 "
15/10/2024 13:35:12,Open Position,TSLA/USD," 100,00 ",0.447267," 0,00 "," 4.448,34 "," 3.598,36 ",2831977650,Stocks," 0,00 "
15/10/2024 13:35:35,Position closed,NSDQ100/USD," 254,68 ",0.244389," 4,68 "," 4.453,02 "," 3.853,04 ",2831760585,CFD," 0,00 "
15/10/2024 13:35:35,Position closed,NSDQ100/USD," 206,01 ",0.195603," 6,03 "," 4.459,05 "," 4.059,05 ",2831871174,CFD," 0,00 "
15/10/2024 13:35:35,Position closed,NSDQ100/USD," 204,60 ",0.195551," 4,60 "," 4.463,65 "," 4.263,65 ",2831973426,CFD," 0,00 "
15/10/2024 13:36:30,Open Position,NSDQ100/USD," 200,00 ",0.195460," 0,00 "," 4.463,65 "," 4.063,65 ",2831980871,CFD," 0,00 "
15/10/2024 13:38:21,Open Position,NVDA/USD," 99,99 ",3.613309," 0,00 "," 4.463,65 "," 3.963,66 ",2831986603,CFD," 0,00 "
15/10/2024 13:38:36,Position closed,TSLA/USD," 99,49 ",0.447267,"(0,51)"," 4.463,14 "," 4.063,15 ",2831977650,Stocks," 0,00 "
15/10/2024 13:38:56,Open Position,TSLA/USD," 99,99 ",2.241608," 0,00 "," 4.463,14 "," 3.963,16 ",2831987551,CFD," 0,00 "
15/10/2024 13:39:39,Open Position,NSDQ100/USD," 299,99 ",0.293468," 0,00 "," 4.463,14 "," 3.663,17 ",2831990253,CFD," 0,00 "
15/10/2024 13:41:22,Open Position,NSDQ100/USD," 200,00 ",0.195632," 0,00 "," 4.463,14 "," 3.463,17 ",2832013016,CFD," 0,00 "
15/10/2024 13:51:08,Open Position,NSDQ100/USD," 499,99 ",0.489227," 0,00 "," 4.463,14 "," 2.963,18 ",2832243325,CFD," 0,00 "
15/10/2024 14:00:02,Position closed,NSDQ100/USD," 506,95 ",0.489227," 6,96 "," 4.470,10 "," 3.470,13 ",2832243325,CFD," 0,00 "
15/10/2024 14:00:57,Position closed,NSDQ100/USD," 200,91 ",0.195632," 0,91 "," 4.471,01 "," 3.671,04 ",2832013016,CFD," 0,00 "
15/10/2024 14:01:04,Position closed,NSDQ100/USD," 302,26 ",0.293468," 2,27 "," 4.473,28 "," 3.973,30 ",2831990253,CFD," 0,00 "
15/10/2024 14:02:21,Open Position,NVDA/USD," 99,99 ",3.674206," 0,00 "," 4.473,28 "," 3.873,31 ",2832344644,CFD," 0,00 "
15/10/2024 14:02:48,Open Position,NSDQ100/USD," 299,99 ",0.293335," 0,00 "," 4.473,28 "," 3.573,32 ",2832348855,CFD," 0,00 "
15/10/2024 14:19:11,Open Position,NSDQ100/USD," 499,99 ",0.490319," 0,00 "," 4.473,28 "," 3.073,33 ",2832409467,CFD," 0,00 "
15/10/2024 14:19:27,Open Position,NSDQ100/USD," 299,99 ",0.294153," 0,00 "," 4.473,28 "," 2.773,34 ",2832410440,CFD," 0,00 "
15/10/2024 14:24:23,Open Position,NSDQ100/USD," 250,00 ",0.245228," 0,00 "," 4.473,28 "," 2.523,34 ",2832421812,CFD," 0,00 "
15/10/2024 14:31:22,Open Position,NSDQ100/USD," 639,99 ",0.630132," 0,00 "," 4.473,28 "," 1.883,35 ",2832441440,CFD," 0,00 "
15/10/2024 14:34:33,Open Position,NSDQ100/USD," 299,97 ",0.296276," 0,00 "," 4.473,28 "," 1.583,38 ",2832449632,CFD," 0,00 "
15/10/2024 14:35:03,Open Position,NSDQ100/USD," 250,00 ",0.246742," 0,00 "," 4.473,28 "," 1.333,38 ",2832450215,CFD," 0,00 "
15/10/2024 14:41:56,Open Position,NSDQ100/USD," 399,99 ",0.396183," 0,00 "," 4.473,28 "," 933,39 ",2832514088,CFD," 0,00 "
15/10/2024 14:42:09,Open Position,NSDQ100/USD," 299,99 ",0.297037," 0,00 "," 4.473,28 "," 633,40 ",2832514428,CFD," 0,00 "
15/10/2024 14:43:38,Position closed,UK100/GBP," 95,25 ",0.184876,"(4,75)"," 4.468,53 "," 728,65 ",2831646001,CFD," 0,00 "
15/10/2024 14:44:17,Open Position,NSDQ100/USD," 250,00 ",0.247284," 0,00 "," 4.468,53 "," 478,65 ",2832519290,CFD," 0,00 "
15/10/2024 14:48:13,Open Position,NSDQ100/USD," 250,00 ",0.247066," 0,00 "," 4.468,53 "," 228,65 ",2832546846,CFD," 0,00 "
15/10/2024 14:48:52,Position closed,NSDQ100/USD," 415,94 ",0.396183," 15,95 "," 4.484,48 "," 644,59 ",2832514088,CFD," 0,00 "
15/10/2024 14:49:23,Position closed,NSDQ100/USD," 308,44 ",0.297037," 8,45 "," 4.492,93 "," 953,03 ",2832514428,CFD," 0,00 "
15/10/2024 14:49:35,Open Position,NSDQ100/USD," 350,00 ",0.346004," 0,00 "," 4.492,93 "," 603,03 ",2832569348,CFD," 0,00 "
15/10/2024 14:52:33,Position closed,NSDQ100/USD," 251,15 ",0.247284," 1,15 "," 4.494,08 "," 854,18 ",2832519290,CFD," 0,00 "
15/10/2024 14:53:23,Position closed,NSDQ100/USD," 354,18 ",0.346004," 4,18 "," 4.498,26 "," 1.208,36 ",2832569348,CFD," 0,00 "
15/10/2024 14:54:08,Position closed,NSDQ100/USD," 302,89 ",0.296276," 2,92 "," 4.501,18 "," 1.511,25 ",2832449632,CFD," 0,00 "
15/10/2024 14:54:17,Position closed,NSDQ100/USD," 254,61 ",0.247066," 4,61 "," 4.505,79 "," 1.765,86 ",2832546846,CFD," 0,00 "
15/10/2024 14:54:40,Open Position,NSDQ100/USD," 350,00 ",0.345459," 0,00 "," 4.505,79 "," 1.415,86 ",2832588329,CFD," 0,00 "
15/10/2024 14:54:47,Open Position,NSDQ100/USD," 99,99 ",0.098699," 0,00 "," 4.505,79 "," 1.315,87 ",2832589226,CFD," 0,00 "
15/10/2024 15:00:38,Open Position,NSDQ100/USD," 249,99 ",0.247293," 0,00 "," 4.505,79 "," 1.065,88 ",2832608850,CFD," 0,00 "
15/10/2024 15:00:55,Open Position,NSDQ100/USD," 200,00 ",0.197906," 0,00 "," 4.505,79 "," 865,88 ",2832609121,CFD," 0,00 "
15/10/2024 15:02:16,Position closed,NSDQ100/USD," 203,83 ",0.197906," 3,83 "," 4.509,62 "," 1.069,71 ",2832609121,CFD," 0,00 "
15/10/2024 15:02:47,Position closed,NSDQ100/USD," 258,89 ",0.247293," 8,90 "," 4.518,52 "," 1.328,60 ",2832608850,CFD," 0,00 "
15/10/2024 15:03:27,Open Position,NSDQ100/USD," 339,99 ",0.336183," 0,00 "," 4.518,52 "," 988,61 ",2832613083,CFD," 0,00 "
15/10/2024 15:08:15,Open Position,NSDQ100/USD," 350,00 ",0.346519," 0,00 "," 4.518,52 "," 638,61 ",2832620693,CFD," 0,00 "
15/10/2024 15:08:24,Open Position,NSDQ100/USD," 200,00 ",0.197925," 0,00 "," 4.518,52 "," 438,61 ",2832620914,CFD," 0,00 "
15/10/2024 15:11:54,Position closed,NSDQ100/USD," 356,43 ",0.346519," 6,43 "," 4.524,95 "," 795,04 ",2832620693,CFD," 0,00 "
15/10/2024 15:12:27,Position closed,NSDQ100/USD," 340,01 ",0.336183," 0,02 "," 4.524,97 "," 1.135,05 ",2832613083,CFD," 0,00 "
15/10/2024 15:12:36,Position closed,NSDQ100/USD," 201,72 ",0.197925," 1,72 "," 4.526,69 "," 1.336,77 ",2832620914,CFD," 0,00 "
15/10/2024 15:13:04,Open Position,NSDQ100/USD," 339,99 ",0.336289," 0,00 "," 4.526,69 "," 996,78 ",2832628771,CFD," 0,00 "
15/10/2024 15:13:42,Position closed,NSDQ100/USD," 342,77 ",0.336289," 2,78 "," 4.529,47 "," 1.339,55 ",2832628771,CFD," 0,00 "
15/10/2024 15:14:24,Open Position,NSDQ100/USD," 250,00 ",0.247127," 0,00 "," 4.529,47 "," 1.089,55 ",2832631080,CFD," 0,00 "
15/10/2024 15:17:49,Position closed,NSDQ100/USD," 257,04 ",0.247127," 7,04 "," 4.536,51 "," 1.346,59 ",2832631080,CFD," 0,00 "
15/10/2024 15:18:00,Position closed,NSDQ100/USD," 100,03 ",0.098699," 0,04 "," 4.536,55 "," 1.446,62 ",2832589226,CFD," 0,00 "
15/10/2024 15:18:17,Position closed,NSDQ100/USD," 351,40 ",0.345459," 1,40 "," 4.537,95 "," 1.798,02 ",2832588329,CFD," 0,00 "
15/10/2024 15:18:45,Position closed,NSDQ100/USD," 248,78 ",0.246742,"(1,22)"," 4.536,73 "," 2.046,80 ",2832450215,CFD," 0,00 "
15/10/2024 15:19:24,Open Position,NSDQ100/USD," 299,99 ",0.296258," 0,00 "," 4.536,73 "," 1.746,81 ",2832656356,CFD," 0,00 "
15/10/2024 15:23:42,Open Position,NSDQ100/USD," 250,00 ",0.246960," 0,00 "," 4.536,73 "," 1.496,81 ",2832680099,CFD," 0,00 "
15/10/2024 15:24:54,Open Position,NSDQ100/USD," 250,00 ",0.247127," 0,00 "," 4.536,73 "," 1.246,81 ",2832681345,CFD," 0,00 "
15/10/2024 15:26:40,Open Position,NSDQ100/USD," 149,99 ",0.148328," 0,00 "," 4.536,73 "," 1.096,82 ",2832683458,CFD," 0,00 "
15/10/2024 15:35:52,Position closed,NSDQ100/USD," 152,63 ",0.148328," 2,64 "," 4.539,37 "," 1.249,45 ",2832683458,CFD," 0,00 "
15/10/2024 15:36:00,Position closed,NSDQ100/USD," 252,59 ",0.247127," 2,59 "," 4.541,96 "," 1.502,04 ",2832681345,CFD," 0,00 "
15/10/2024 15:39:55,Open Position,NSDQ100/USD," 299,99 ",0.296660," 0,00 "," 4.541,96 "," 1.202,05 ",2832704644,CFD," 0,00 "
15/10/2024 15:45:26,Open Position,NSDQ100/USD," 309,99 ",0.306799," 0,00 "," 4.541,96 "," 892,06 ",2832709673,CFD," 0,00 "
15/10/2024 15:55:33,Open Position,NSDQ100/USD," 400,00 ",0.396432," 0,00 "," 4.541,96 "," 492,06 ",2832720825,CFD," 0,00 "
15/10/2024 16:25:56,Position closed,NSDQ100/USD," 413,82 ",0.396432," 13,82 "," 4.555,78 "," 905,88 ",2832720825,CFD," 0,00 "
15/10/2024 16:26:05,Position closed,NSDQ100/USD," 311,76 ",0.306799," 1,77 "," 4.557,55 "," 1.217,64 ",2832709673,CFD," 0,00 "
15/10/2024 16:26:18,Open Position,NSDQ100/USD," 200,00 ",0.197829," 0,00 "," 4.557,55 "," 1.017,64 ",2832792671,CFD," 0,00 "
15/10/2024 16:50:07,Open Position,NSDQ100/USD," 299,99 ",0.296881," 0,00 "," 4.557,55 "," 717,65 ",2832813919,CFD," 0,00 "
15/10/2024 17:07:41,Open Position,NSDQ100/USD," 250,00 ",0.247438," 0,00 "," 4.557,55 "," 467,65 ",2832824005,CFD," 0,00 "
15/10/2024 17:30:50,Open Position,NSDQ100/USD," 250,00 ",0.247855," 0,00 "," 4.557,55 "," 217,65 ",2832837418,CFD," 0,00 "
15/10/2024 17:49:50,Position closed,NSDQ100/USD," 255,15 ",0.247855," 5,15 "," 4.562,70 "," 472,80 ",2832837418,CFD," 0,00 "
15/10/2024 17:57:52,Open Position,NSDQ100/USD," 350,00 ",0.346816," 0,00 "," 4.562,70 "," 122,80 ",2832864948,CFD," 0,00 "
15/10/2024 18:55:45,Open Position,NSDQ100/USD," 99,99 ",0.099149," 0,00 "," 4.562,70 "," 22,81 ",2832898676,CFD," 0,00 "
15/10/2024 19:40:12,Deposit,4000.00 USDRON CreditCard," 850,87 ",-," 850,87 "," 5.413,57 "," 873,68 ",-,-," 0,00 "
15/10/2024 19:40:12,Deposit Conversion Fee,-,"(25,16)",-," 0,00 "," 5.413,57 "," 873,68 ",-,-," 0,00 "
15/10/2024 19:40:29,Open Position,NSDQ100/USD," 799,99 ",0.795471," 0,00 "," 5.413,57 "," 73,69 ",2832954816,CFD," 0,00 "
15/10/2024 19:57:08,Position closed,NSDQ100/USD," 98,33 ",0.099149,"(1,66)"," 5.411,91 "," 172,02 ",2832898676,CFD," 0,00 "
15/10/2024 19:57:38,Position closed,NSDQ100/USD," 827,10 ",0.795471," 27,11 "," 5.439,02 "," 999,12 ",2832954816,CFD," 0,00 "
15/10/2024 19:58:37,Open Position,NSDQ100/USD," 99,99 ",0.099223," 0,00 "," 5.439,02 "," 899,13 ",2832969022,CFD," 0,00 "
15/10/2024 20:13:10,Open Position,NSDQ100/USD," 300,00 ",0.297734," 0,00 "," 5.439,02 "," 599,13 ",2832995599,CFD," 0,00 "
15/10/2024 20:29:13,Position closed,NSDQ100/USD," 301,90 ",0.297734," 1,90 "," 5.440,92 "," 901,03 ",2832995599,CFD," 0,00 "
15/10/2024 20:29:19,Position closed,NSDQ100/USD," 100,26 ",0.099223," 0,27 "," 5.441,19 "," 1.001,29 ",2832969022,CFD," 0,00 "
15/10/2024 20:51:30,Open Position,NSDQ100/USD," 350,00 ",0.347216," 0,00 "," 5.441,19 "," 651,29 ",2833010517,CFD," 0,00 "
15/10/2024 22:08:08,Open Position,NSDQ100/USD," 250,00 ",0.248213," 0,00 "," 5.441,19 "," 401,29 ",2833015087,CFD," 0,00 "
16/10/2024 00:48:54,Overnight fee,Daily,"(0,15)",-,"(0,15)"," 5.441,04 "," 401,14 ",2831986603,CFD," 0,00 "
16/10/2024 00:48:54,Overnight fee,Daily,"(0,15)",-,"(0,15)"," 5.440,89 "," 400,99 ",2832344644,CFD," 0,00 "
16/10/2024 00:48:54,Overnight fee,Daily,"(0,15)",-,"(0,15)"," 5.440,74 "," 400,84 ",2831987551,CFD," 0,00 "
16/10/2024 00:48:54,Overnight fee,Daily,"(1,01)",-,"(1,01)"," 5.439,73 "," 399,83 ",2831980871,CFD," 0,00 "
16/10/2024 00:48:54,Overnight fee,Daily,"(1,02)",-,"(1,02)"," 5.438,71 "," 398,81 ",2832792671,CFD," 0,00 "
16/10/2024 00:48:54,Overnight fee,Daily,"(1,26)",-,"(1,26)"," 5.437,45 "," 397,55 ",2832421812,CFD," 0,00 "
16/10/2024 00:48:54,Overnight fee,Daily,"(1,27)",-,"(1,27)"," 5.436,18 "," 396,28 ",2832680099,CFD," 0,00 "
16/10/2024 00:48:54,Overnight fee,Daily,"(1,28)",-,"(1,28)"," 5.434,90 "," 395,00 ",2832824005,CFD," 0,00 "
16/10/2024 00:48:54,Overnight fee,Daily,"(1,51)",-,"(1,51)"," 5.433,39 "," 393,49 ",2832348855,CFD," 0,00 "
16/10/2024 00:48:54,Overnight fee,Daily,"(1,52)",-,"(1,52)"," 5.431,87 "," 391,97 ",2832410440,CFD," 0,00 "
16/10/2024 00:48:54,Overnight fee,Daily,"(1,53)",-,"(1,53)"," 5.430,34 "," 390,44 ",2832656356,CFD," 0,00 "
16/10/2024 00:48:54,Overnight fee,Daily,"(1,53)",-,"(1,53)"," 5.428,81 "," 388,91 ",2832813919,CFD," 0,00 "
16/10/2024 00:48:54,Overnight fee,Daily,"(1,53)",-,"(1,53)"," 5.427,28 "," 387,38 ",2832704644,CFD," 0,00 "
16/10/2024 00:48:54,Overnight fee,Daily,"(1,79)",-,"(1,79)"," 5.425,49 "," 385,59 ",2833010517,CFD," 0,00 "
16/10/2024 00:48:54,Overnight fee,Daily,"(1,79)",-,"(1,79)"," 5.423,70 "," 383,80 ",2832864948,CFD," 0,00 "
16/10/2024 00:48:54,Overnight fee,Daily,"(2,53)",-,"(2,53)"," 5.421,17 "," 381,27 ",2832409467,CFD," 0,00 "
16/10/2024 00:48:54,Overnight fee,Daily,"(3,25)",-,"(3,25)"," 5.417,92 "," 378,02 ",2832441440,CFD," 0,00 "
16/10/2024 01:03:42,Position closed,NSDQ100/USD," 258,43 ",0.248213," 8,43 "," 5.426,35 "," 636,45 ",2833015087,CFD," 0,00 "
16/10/2024 01:03:49,Position closed,NSDQ100/USD," 356,28 ",0.347216," 6,28 "," 5.432,63 "," 992,73 ",2833010517,CFD," 0,00 "
16/10/2024 01:03:56,Position closed,NSDQ100/USD," 348,27 ",0.346816,"(1,73)"," 5.430,90 "," 1.341,00 ",2832864948,CFD," 0,00 "
16/10/2024 01:04:57,Position closed,NSDQ100/USD," 242,16 ",0.247438,"(7,84)"," 5.423,06 "," 1.583,16 ",2832824005,CFD," 0,00 "
16/10/2024 01:08:16,Open Position,NSDQ100/USD," 350,00 ",0.346864," 0,00 "," 5.423,06 "," 1.233,16 ",2833020579,CFD," 0,00 "
16/10/2024 05:26:14,Position closed,NSDQ100/USD," 359,49 ",0.346864," 9,49 "," 5.432,55 "," 1.592,65 ",2833020579,CFD," 0,00 "
16/10/2024 05:28:34,Position closed,NSDQ100/USD," 300,71 ",0.296881," 0,72 "," 5.433,27 "," 1.893,36 ",2832813919,CFD," 0,00 "
16/10/2024 05:30:10,Position closed,NSDQ100/USD," 199,79 ",0.197829,"(0,21)"," 5.433,06 "," 2.093,15 ",2832792671,CFD," 0,00 "
16/10/2024 05:30:59,Position closed,NSDQ100/USD," 297,77 ",0.296660,"(2,22)"," 5.430,84 "," 2.390,92 ",2832704644,CFD," 0,00 "
16/10/2024 05:31:44,Position closed,NSDQ100/USD," 243,06 ",0.246960,"(6,94)"," 5.423,90 "," 2.633,98 ",2832680099,CFD," 0,00 "
16/10/2024 05:33:20,Position closed,NSDQ100/USD," 289,65 ",0.296258,"(10,34)"," 5.413,56 "," 2.923,63 ",2832656356,CFD," 0,00 "
16/10/2024 05:34:07,Position closed,NSDQ100/USD," 576,47 ",0.630132,"(63,52)"," 5.350,04 "," 3.500,10 ",2832441440,CFD," 0,00 "
16/10/2024 05:59:03,Open Position,NSDQ100/USD," 199,99 ",0.197854," 0,00 "," 5.350,04 "," 3.300,11 ",2833038250,CFD," 0,00 "
16/10/2024 06:05:08,Open Position,NSDQ100/USD," 250,00 ",0.247458," 0,00 "," 5.350,04 "," 3.050,11 ",2833040345,CFD," 0,00 "
16/10/2024 06:06:36,Open Position,NSDQ100/USD," 250,00 ",0.247475," 0,00 "," 5.350,04 "," 2.800,11 ",2833040562,CFD," 0,00 "
16/10/2024 06:22:17,Open Position,NSDQ100/USD," 399,99 ",0.396113," 0,00 "," 5.350,04 "," 2.400,12 ",2833043033,CFD," 0,00 "
16/10/2024 06:34:37,Position closed,NSDQ100/USD," 401,88 ",0.396113," 1,89 "," 5.351,93 "," 2.802,00 ",2833043033,CFD," 0,00 "
16/10/2024 06:40:46,Position closed,NSDQ100/USD," 250,74 ",0.247475," 0,74 "," 5.352,67 "," 3.052,74 ",2833040562,CFD," 0,00 "
16/10/2024 06:49:32,Position closed,NSDQ100/USD," 252,17 ",0.247458," 2,17 "," 5.354,84 "," 3.304,91 ",2833040345,CFD," 0,00 "
16/10/2024 06:56:02,Open Position,XAU/USD," 300,00 ",2.241247," 0,00 "," 5.354,84 "," 3.004,91 ",2833048028,CFD," 0,00 "
16/10/2024 07:03:36,Open Position,NSDQ100/USD," 500,00 ",0.495272," 0,00 "," 5.354,84 "," 2.504,91 ",2833089471,CFD," 0,00 "
16/10/2024 07:03:58,Open Position,NSDQ100/USD," 199,99 ",0.198103," 0,00 "," 5.354,84 "," 2.304,92 ",2833093114,CFD," 0,00 "
16/10/2024 07:04:48,Position closed,NSDQ100/USD," 502,76 ",0.495272," 2,76 "," 5.357,60 "," 2.807,68 ",2833089471,CFD," 0,00 "
16/10/2024 07:05:55,Open Position,NSDQ100/USD," 300,00 ",0.297097," 0,00 "," 5.357,60 "," 2.507,68 ",2833096908,CFD," 0,00 "
16/10/2024 07:09:08,Position closed,NSDQ100/USD," 200,88 ",0.198103," 0,89 "," 5.358,49 "," 2.708,56 ",2833093114,CFD," 0,00 "
16/10/2024 07:13:19,Open Position,NSDQ100/USD," 679,99 ",0.673580," 0,00 "," 5.358,49 "," 2.028,57 ",2833099141,CFD," 0,00 "
16/10/2024 07:14:03,Open Position,NSDQ100/USD," 350,00 ",0.346848," 0,00 "," 5.358,49 "," 1.678,57 ",2833099307,CFD," 0,00 "
16/10/2024 07:14:48,Open Position,NSDQ100/USD," 199,99 ",0.198172," 0,00 "," 5.358,49 "," 1.478,58 ",2833099499,CFD," 0,00 "
16/10/2024 07:17:10,Position closed,XAU/USD," 304,82 ",2.241247," 4,82 "," 5.363,31 "," 1.783,40 ",2833048028,CFD," 0,00 "
16/10/2024 07:18:09,Open Position,NSDQ100/USD," 250,00 ",0.247785," 0,00 "," 5.363,31 "," 1.533,40 ",2833104187,CFD," 0,00 "
16/10/2024 07:21:28,Open Position,XAU/USD," 399,99 ",2.990687," 0,00 "," 5.363,31 "," 1.133,41 ",2833119138,CFD," 0,00 "
16/10/2024 07:24:28,Open Position,NSDQ100/USD," 250,00 ",0.247892," 0,00 "," 5.363,31 "," 883,41 ",2833121178,CFD," 0,00 "
16/10/2024 07:25:05,Open Position,XAU/USD," 300,00 ",2.244089," 0,00 "," 5.363,31 "," 583,41 ",2833126177,CFD," 0,00 "
16/10/2024 07:27:23,Position closed,NSDQ100/USD," 251,90 ",0.247892," 1,90 "," 5.365,21 "," 835,31 ",2833121178,CFD," 0,00 "
16/10/2024 07:28:47,Position closed,NSDQ100/USD," 680,17 ",0.673580," 0,18 "," 5.365,39 "," 1.515,48 ",2833099141,CFD," 0,00 "
16/10/2024 07:28:59,Position closed,NSDQ100/USD," 252,79 ",0.247785," 2,79 "," 5.368,18 "," 1.768,27 ",2833104187,CFD," 0,00 "
16/10/2024 07:29:25,Position closed,NSDQ100/USD," 352,56 ",0.346848," 2,56 "," 5.370,74 "," 2.120,83 ",2833099307,CFD," 0,00 "
16/10/2024 07:30:36,Position closed,NSDQ100/USD," 201,97 ",0.198172," 1,98 "," 5.372,72 "," 2.322,80 ",2833099499,CFD," 0,00 "
16/10/2024 07:32:00,Position closed,NSDQ100/USD," 300,59 ",0.297097," 0,59 "," 5.373,31 "," 2.623,39 ",2833096908,CFD," 0,00 "
16/10/2024 07:34:14,Open Position,NSDQ100/USD," 149,99 ",0.148478," 0,00 "," 5.373,31 "," 2.473,40 ",2833132281,CFD," 0,00 "
16/10/2024 07:34:24,Open Position,NSDQ100/USD," 149,99 ",0.148475," 0,00 "," 5.373,31 "," 2.323,41 ",2833132331,CFD," 0,00 "
16/10/2024 07:52:34,Position closed,NSDQ100/USD," 151,54 ",0.148478," 1,55 "," 5.374,86 "," 2.474,95 ",2833132281,CFD," 0,00 "
16/10/2024 07:52:40,Position closed,NSDQ100/USD," 151,17 ",0.148475," 1,18 "," 5.376,04 "," 2.626,12 ",2833132331,CFD," 0,00 "
16/10/2024 08:14:17,Open Position,NSDQ100/USD," 399,99 ",0.396243," 0,00 "," 5.376,04 "," 2.226,13 ",2833161749,CFD," 0,00 "
16/10/2024 08:28:27,Open Position,NSDQ100/USD," 500,00 ",0.495485," 0,00 "," 5.376,04 "," 1.726,13 ",2833164520,CFD," 0,00 "
16/10/2024 08:31:45,Open Position,NSDQ100/USD," 250,00 ",0.247785," 0,00 "," 5.376,04 "," 1.476,13 ",2833165226,CFD," 0,00 "
16/10/2024 08:44:24,Open Position,NSDQ100/USD," 250,00 ",0.247709," 0,00 "," 5.376,04 "," 1.226,13 ",2833167844,CFD," 0,00 "
16/10/2024 08:44:49,Position closed,NSDQ100/USD," 251,95 ",0.247785," 1,95 "," 5.377,99 "," 1.478,08 ",2833165226,CFD," 0,00 "
16/10/2024 08:45:00,Position closed,NSDQ100/USD," 501,03 ",0.495485," 1,03 "," 5.379,02 "," 1.979,11 ",2833164520,CFD," 0,00 "
16/10/2024 08:45:22,Open Position,NSDQ100/USD," 199,99 ",0.198145," 0,00 "," 5.379,02 "," 1.779,12 ",2833168061,CFD," 0,00 "
16/10/2024 09:09:37,Position closed,NSDQ100/USD," 405,96 ",0.396243," 5,97 "," 5.384,99 "," 2.185,08 ",2833161749,CFD," 0,00 "
16/10/2024 09:09:42,Position closed,NSDQ100/USD," 254,47 ",0.247709," 4,47 "," 5.389,46 "," 2.439,55 ",2833167844,CFD," 0,00 "
16/10/2024 09:09:53,Position closed,NSDQ100/USD," 202,86 ",0.198145," 2,87 "," 5.392,33 "," 2.642,41 ",2833168061,CFD," 0,00 "
16/10/2024 09:20:08,Open Position,NSDQ100/USD," 300,00 ",0.297045," 0,00 "," 5.392,33 "," 2.342,41 ",2833175610,CFD," 0,00 "
16/10/2024 09:25:24,Open Position,NSDQ100/USD," 399,99 ",0.396270," 0,00 "," 5.392,33 "," 1.942,42 ",2833176641,CFD," 0,00 "
16/10/2024 09:30:17,Open Position,NSDQ100/USD," 199,99 ",0.198181," 0,00 "," 5.392,33 "," 1.742,43 ",2833177551,CFD," 0,00 "
16/10/2024 09:34:36,Position closed,NSDQ100/USD," 201,09 ",0.198181," 1,10 "," 5.393,43 "," 1.943,52 ",2833177551,CFD," 0,00 "
16/10/2024 09:36:45,Open Position,NSDQ100/USD," 300,00 ",0.297182," 0,00 "," 5.393,43 "," 1.643,52 ",2833178534,CFD," 0,00 "
16/10/2024 09:39:09,Position closed,NSDQ100/USD," 401,52 ",0.396270," 1,53 "," 5.394,96 "," 2.045,04 ",2833176641,CFD," 0,00 "
16/10/2024 09:42:07,Open Position,XAU/USD," 349,99 ",2.611881," 0,00 "," 5.394,96 "," 1.695,05 ",2833179446,CFD," 0,00 "
16/10/2024 09:42:52,Open Position,NSDQ100/USD," 300,00 ",0.297195," 0,00 "," 5.394,96 "," 1.395,05 ",2833179601,CFD," 0,00 "
16/10/2024 10:10:45,Position closed,XAU/USD," 351,95 ",2.611881," 1,96 "," 5.396,92 "," 1.747,00 ",2833179446,CFD," 0,00 "
16/10/2024 10:23:57,Open Position,XAU/USD," 250,00 ",1.866751," 0,00 "," 5.396,92 "," 1.497,00 ",2833209098,CFD," 0,00 "
16/10/2024 10:39:38,Position closed,NSDQ100/USD," 299,52 ",0.297195,"(0,48)"," 5.396,44 "," 1.796,52 ",2833179601,CFD," 0,00 "
16/10/2024 11:03:50,Position closed,XAU/USD," 402,29 ",2.990687," 2,30 "," 5.398,74 "," 2.198,81 ",2833119138,CFD," 0,00 "
16/10/2024 11:04:32,Position closed,XAU/USD," 239,86 ",1.866751,"(10,14)"," 5.388,60 "," 2.438,67 ",2833209098,CFD," 0,00 "
16/10/2024 11:25:55,Position closed,NSDQ100/USD," 303,82 ",0.297182," 3,82 "," 5.392,42 "," 2.742,49 ",2833178534,CFD," 0,00 "
16/10/2024 11:26:00,Position closed,NSDQ100/USD," 300,94 ",0.297045," 0,94 "," 5.393,36 "," 3.043,43 ",2833175610,CFD," 0,00 "
16/10/2024 11:26:26,Open Position,XAU/USD," 249,99 ",1.867511," 0,00 "," 5.393,36 "," 2.793,44 ",2833220364,CFD," 0,00 "
16/10/2024 12:23:00,Open Position,NSDQ100/USD," 399,99 ",0.396333," 0,00 "," 5.393,36 "," 2.393,45 ",2833237737,CFD," 0,00 "
16/10/2024 12:49:06,Open Position,NSDQ100/USD," 449,99 ",0.446014," 0,00 "," 5.393,36 "," 1.943,46 ",2833250784,CFD," 0,00 "
16/10/2024 13:17:44,Position closed,NSDQ100/USD," 459,52 ",0.446014," 9,53 "," 5.402,89 "," 2.402,98 ",2833250784,CFD," 0,00 "
16/10/2024 13:18:36,Position closed,NSDQ100/USD," 405,17 ",0.396333," 5,18 "," 5.408,07 "," 2.808,15 ",2833237737,CFD," 0,00 "
16/10/2024 13:20:19,Open Position,XAU/USD," 200,00 ",1.492036," 0,00 "," 5.408,07 "," 2.608,15 ",2833269247,CFD," 0,00 "
16/10/2024 13:22:50,Open Position,NSDQ100/USD," 300,00 ",0.297254," 0,00 "," 5.408,07 "," 2.308,15 ",2833281493,CFD," 0,00 "
16/10/2024 13:23:56,Open Position,NSDQ100/USD," 199,99 ",0.198148," 0,00 "," 5.408,07 "," 2.108,16 ",2833281735,CFD," 0,00 "
16/10/2024 13:33:43,Open Position,NSDQ100/USD," 400,00 ",0.397115," 0,00 "," 5.408,07 "," 1.708,16 ",2833382788,CFD," 0,00 "
16/10/2024 13:39:05,Open Position,NSDQ100/USD," 350,00 ",0.348155," 0,00 "," 5.408,07 "," 1.358,16 ",2833407935,CFD," 0,00 "
16/10/2024 13:41:11,Position closed,NSDQ100/USD," 354,87 ",0.348155," 4,87 "," 5.412,94 "," 1.713,03 ",2833407935,CFD," 0,00 "
16/10/2024 13:41:53,Open Position,NSDQ100/USD," 350,00 ",0.347914," 0,00 "," 5.412,94 "," 1.363,03 ",2833441460,CFD," 0,00 "
16/10/2024 13:43:01,Open Position,NSDQ100/USD," 299,99 ",0.298300," 0,00 "," 5.412,94 "," 1.063,04 ",2833486452,CFD," 0,00 "
16/10/2024 13:45:05,Open Position,NSDQ100/USD," 299,99 ",0.298807," 0,00 "," 5.412,94 "," 763,05 ",2833525670,CFD," 0,00 "
16/10/2024 13:46:57,Open Position,NSDQ100/USD," 250,00 ",0.249163," 0,00 "," 5.412,94 "," 513,05 ",2833565416,CFD," 0,00 "
16/10/2024 13:47:31,Position closed,XAU/USD," 197,69 ",1.492036,"(2,31)"," 5.410,63 "," 710,74 ",2833269247,CFD," 0,00 "
16/10/2024 13:48:00,Open Position,NSDQ100/USD," 200,00 ",0.199199," 0,00 "," 5.410,63 "," 510,74 ",2833603757,CFD," 0,00 "
16/10/2024 13:57:56,Position closed,XAU/USD," 254,32 ",1.867511," 4,33 "," 5.414,96 "," 765,06 ",2833220364,CFD," 0,00 "
16/10/2024 13:58:05,Position closed,XAU/USD," 296,84 ",2.244089,"(3,16)"," 5.411,80 "," 1.061,90 ",2833126177,CFD," 0,00 "
16/10/2024 13:59:40,Position closed,TSLA/USD," 92,09 ",2.241608,"(7,90)"," 5.403,90 "," 1.153,99 ",2831987551,CFD," 0,00 "
16/10/2024 14:00:15,Position closed,NVDA/USD," 83,96 ",3.674206,"(16,03)"," 5.387,87 "," 1.237,95 ",2832344644,CFD," 0,00 "
16/10/2024 14:00:27,Position closed,NVDA/USD," 76,92 ",3.613309,"(23,07)"," 5.364,80 "," 1.314,87 ",2831986603,CFD," 0,00 "
16/10/2024 14:01:18,Open Position,NSDQ100/USD," 329,99 ",0.329304," 0,00 "," 5.364,80 "," 984,88 ",2833681397,CFD," 0,00 "
16/10/2024 14:04:28,Position closed,NSDQ100/USD," 341,81 ",0.329304," 11,82 "," 5.376,62 "," 1.326,69 ",2833681397,CFD," 0,00 "
16/10/2024 14:04:52,Position closed,NSDQ100/USD," 300,61 ",0.298807," 0,62 "," 5.377,24 "," 1.627,30 ",2833525670,CFD," 0,00 "
16/10/2024 14:05:10,Position closed,NSDQ100/USD," 253,53 ",0.249163," 3,53 "," 5.380,77 "," 1.880,83 ",2833565416,CFD," 0,00 "
16/10/2024 14:05:31,Open Position,NSDQ100/USD," 299,99 ",0.298860," 0,00 "," 5.380,77 "," 1.580,84 ",2833687041,CFD," 0,00 "
16/10/2024 14:07:01,Position closed,NSDQ100/USD," 201,17 ",0.199199," 1,17 "," 5.381,94 "," 1.782,01 ",2833603757,CFD," 0,00 "
16/10/2024 14:07:40,Position closed,NSDQ100/USD," 304,47 ",0.298860," 4,48 "," 5.386,42 "," 2.086,48 ",2833687041,CFD," 0,00 "
16/10/2024 14:07:55,Open Position,NSDQ100/USD," 400,00 ",0.398086," 0,00 "," 5.386,42 "," 1.686,48 ",2833706007,CFD," 0,00 "
16/10/2024 14:11:40,Position closed,NSDQ100/USD," 406,64 ",0.398086," 6,64 "," 5.393,06 "," 2.093,12 ",2833706007,CFD," 0,00 "
16/10/2024 14:12:29,Open Position,NSDQ100/USD," 249,99 ",0.248524," 0,00 "," 5.393,06 "," 1.843,13 ",2833720444,CFD," 0,00 "
16/10/2024 14:14:35,Position closed,NSDQ100/USD," 302,49 ",0.298300," 2,50 "," 5.395,56 "," 2.145,62 ",2833486452,CFD," 0,00 "
16/10/2024 14:14:47,Position closed,NSDQ100/USD," 253,64 ",0.248524," 3,65 "," 5.399,21 "," 2.399,26 ",2833720444,CFD," 0,00 "
16/10/2024 14:15:02,Position closed,NSDQ100/USD," 353,65 ",0.347914," 3,65 "," 5.402,86 "," 2.752,91 ",2833441460,CFD," 0,00 "
16/10/2024 14:15:14,Open Position,NSDQ100/USD," 299,99 ",0.298038," 0,00 "," 5.402,86 "," 2.452,92 ",2833724111,CFD," 0,00 "
16/10/2024 14:22:31,Position closed,NSDQ100/USD," 299,84 ",0.298038,"(0,15)"," 5.402,71 "," 2.752,76 ",2833724111,CFD," 0,00 "
16/10/2024 14:24:44,Position closed,NSDQ100/USD," 400,75 ",0.397115," 0,75 "," 5.403,46 "," 3.153,51 ",2833382788,CFD," 0,00 "
16/10/2024 14:27:09,Open Position,NSDQ100/USD," 200,00 ",0.198450," 0,00 "," 5.403,46 "," 2.953,51 ",2833743134,CFD," 0,00 "
16/10/2024 14:27:59,Position closed,NSDQ100/USD," 200,61 ",0.198450," 0,61 "," 5.404,07 "," 3.154,12 ",2833743134,CFD," 0,00 "
16/10/2024 14:28:20,Open Position,NSDQ100/USD," 299,99 ",0.297489," 0,00 "," 5.404,07 "," 2.854,13 ",2833744259,CFD," 0,00 "
16/10/2024 14:38:05,Open Position,NSDQ100/USD," 350,00 ",0.347833," 0,00 "," 5.404,07 "," 2.504,13 ",2833756573,CFD," 0,00 "
16/10/2024 14:41:35,Open Position,NSDQ100/USD," 350,00 ",0.348273," 0,00 "," 5.404,07 "," 2.154,13 ",2833762412,CFD," 0,00 "
16/10/2024 14:45:11,Open Position,NSDQ100/USD," 299,99 ",0.298622," 0,00 "," 5.404,07 "," 1.854,14 ",2833767272,CFD," 0,00 "
16/10/2024 14:47:19,Position closed,NSDQ100/USD," 302,05 ",0.298622," 2,06 "," 5.406,13 "," 2.156,19 ",2833767272,CFD," 0,00 "
16/10/2024 14:48:45,Position closed,NSDQ100/USD," 350,38 ",0.348273," 0,38 "," 5.406,51 "," 2.506,57 ",2833762412,CFD," 0,00 "
16/10/2024 14:51:02,Open Position,NSDQ100/USD," 200,00 ",0.198787," 0,00 "," 5.406,51 "," 2.306,57 ",2833774465,CFD," 0,00 "
16/10/2024 14:56:58,Open Position,NSDQ100/USD," 299,99 ",0.298389," 0,00 "," 5.406,51 "," 2.006,58 ",2833780778,CFD," 0,00 "
16/10/2024 15:11:00,Position closed,NSDQ100/USD," 302,01 ",0.298389," 2,02 "," 5.408,53 "," 2.308,59 ",2833780778,CFD," 0,00 "
16/10/2024 15:13:05,Position closed,NSDQ100/USD," 354,93 ",0.347833," 4,93 "," 5.413,46 "," 2.663,52 ",2833756573,CFD," 0,00 "
16/10/2024 15:16:42,Position closed,NSDQ100/USD," 203,10 ",0.198787," 3,10 "," 5.416,56 "," 2.866,62 ",2833774465,CFD," 0,00 "
16/10/2024 15:18:46,Open Position,NSDQ100/USD," 250,00 ",0.248314," 0,00 "," 5.416,56 "," 2.616,62 ",2833817003,CFD," 0,00 "
16/10/2024 15:21:25,Position closed,NSDQ100/USD," 252,30 ",0.248314," 2,30 "," 5.418,86 "," 2.868,92 ",2833817003,CFD," 0,00 "
16/10/2024 15:22:18,Open Position,NSDQ100/USD," 299,99 ",0.298058," 0,00 "," 5.418,86 "," 2.568,93 ",2833819755,CFD," 0,00 "
16/10/2024 15:29:04,Position closed,NSDQ100/USD," 300,58 ",0.298058," 0,59 "," 5.419,45 "," 2.869,51 ",2833819755,CFD," 0,00 "
16/10/2024 15:57:34,Open Position,NSDQ100/USD," 400,00 ",0.397969," 0,00 "," 5.419,45 "," 2.469,51 ",2833863078,CFD," 0,00 "
16/10/2024 16:04:25,Position closed,NSDQ100/USD," 403,37 ",0.397969," 3,37 "," 5.422,82 "," 2.872,88 ",2833863078,CFD," 0,00 "
16/10/2024 16:07:19,Open Position,NSDQ100/USD," 720,00 ",0.716194," 0,00 "," 5.422,82 "," 2.152,88 ",2833869701,CFD," 0,00 "
16/10/2024 16:10:20,Position closed,NSDQ100/USD," 727,51 ",0.716194," 7,51 "," 5.430,33 "," 2.880,39 ",2833869701,CFD," 0,00 "
16/10/2024 16:12:28,Open Position,NSDQ100/USD," 400,00 ",0.397777," 0,00 "," 5.430,33 "," 2.480,39 ",2833872321,CFD," 0,00 "
16/10/2024 16:51:45,Position closed,NSDQ100/USD," 409,74 ",0.397777," 9,74 "," 5.440,07 "," 2.890,13 ",2833872321,CFD," 0,00 "
16/10/2024 17:18:07,Open Position,NSDQ100/USD," 350,00 ",0.347510," 0,00 "," 5.440,07 "," 2.540,13 ",2833988826,CFD," 0,00 "
16/10/2024 17:21:10,Open Position,NSDQ100/USD," 299,99 ",0.298012," 0,00 "," 5.440,07 "," 2.240,14 ",2833990204,CFD," 0,00 "
16/10/2024 17:33:40,Position closed,NSDQ100/USD," 302,37 ",0.298012," 2,38 "," 5.442,45 "," 2.542,51 ",2833990204,CFD," 0,00 "
16/10/2024 17:40:08,Open Position,NSDQ100/USD," 299,99 ",0.297958," 0,00 "," 5.442,45 "," 2.242,52 ",2833998332,CFD," 0,00 "
16/10/2024 17:44:18,Position closed,NSDQ100/USD," 353,57 ",0.347510," 3,57 "," 5.446,02 "," 2.596,09 ",2833988826,CFD," 0,00 "
16/10/2024 17:44:32,Position closed,NSDQ100/USD," 304,42 ",0.297958," 4,43 "," 5.450,45 "," 2.900,51 ",2833998332,CFD," 0,00 "
16/10/2024 18:01:27,Open Position,NSDQ100/USD," 299,99 ",0.297604," 0,00 "," 5.450,45 "," 2.600,52 ",2834014770,CFD," 0,00 "
16/10/2024 18:29:34,Position closed,NSDQ100/USD," 308,91 ",0.297604," 8,92 "," 5.459,37 "," 2.909,43 ",2834014770,CFD," 0,00 "
16/10/2024 18:29:42,Position closed,NSDQ100/USD," 307,00 ",0.297489," 7,01 "," 5.466,38 "," 3.216,43 ",2833744259,CFD," 0,00 "
16/10/2024 18:29:51,Position closed,NSDQ100/USD," 201,54 ",0.198148," 1,55 "," 5.467,93 "," 3.417,97 ",2833281735,CFD," 0,00 "
16/10/2024 18:29:58,Position closed,NSDQ100/USD," 302,77 ",0.297254," 2,77 "," 5.470,70 "," 3.720,74 ",2833281493,CFD," 0,00 "
16/10/2024 22:19:01,Open Position,NSDQ100/USD," 300,00 ",0.297728," 0,00 "," 5.470,70 "," 3.420,74 ",2834090831,CFD," 0,00 "
16/10/2024 22:39:43,Open Position,NSDQ100/USD," 300,00 ",0.297704," 0,00 "," 5.470,70 "," 3.120,74 ",2834092788,CFD," 0,00 "
16/10/2024 23:54:55,Position closed,NSDQ100/USD," 296,93 ",0.297728,"(3,07)"," 5.467,63 "," 3.417,67 ",2834090831,CFD," 0,00 "
16/10/2024 23:56:18,Open Position,NSDQ100/USD," 399,99 ",0.397146," 0,00 "," 5.467,63 "," 3.017,68 ",2834094996,CFD," 0,00 "
16/10/2024 23:57:27,Open Position,NSDQ100/USD," 350,00 ",0.347497," 0,00 "," 5.467,63 "," 2.667,68 ",2834095008,CFD," 0,00 "
17/10/2024 00:30:57,Open Position,NSDQ100/USD," 350,00 ",0.347442," 0,00 "," 5.467,63 "," 2.317,68 ",2834098359,CFD," 0,00 "
17/10/2024 00:48:49,Overnight fee,Daily,"(1,01)",-,"(1,01)"," 5.466,62 "," 2.316,67 ",2831980871,CFD," 0,00 "
17/10/2024 00:48:49,Overnight fee,Daily,"(1,02)",-,"(1,02)"," 5.465,60 "," 2.315,65 ",2833038250,CFD," 0,00 "
17/10/2024 00:48:49,Overnight fee,Daily,"(1,26)",-,"(1,26)"," 5.464,34 "," 2.314,39 ",2832421812,CFD," 0,00 "
17/10/2024 00:48:49,Overnight fee,Daily,"(1,51)",-,"(1,51)"," 5.462,83 "," 2.312,88 ",2832348855,CFD," 0,00 "
17/10/2024 00:48:49,Overnight fee,Daily,"(1,52)",-,"(1,52)"," 5.461,31 "," 2.311,36 ",2832410440,CFD," 0,00 "
17/10/2024 00:48:49,Overnight fee,Daily,"(2,53)",-,"(2,53)"," 5.458,78 "," 2.308,83 ",2832409467,CFD," 0,00 "
17/10/2024 06:07:15,Position closed,NSDQ100/USD," 307,91 ",0.297704," 7,91 "," 5.466,69 "," 2.616,74 ",2834092788,CFD," 0,00 "
17/10/2024 06:07:15,Position closed,NSDQ100/USD," 414,76 ",0.397146," 14,77 "," 5.481,46 "," 3.031,50 ",2834094996,CFD," 0,00 "
17/10/2024 06:19:01,Position closed,NSDQ100/USD," 200,70 ",0.197854," 0,71 "," 5.482,17 "," 3.232,20 ",2833038250,CFD," 0,00 "
17/10/2024 06:54:12,Position closed,NSDQ100/USD," 394,16 ",0.347497," 44,16 "," 5.526,33 "," 3.626,36 ",2834095008,CFD," 0,00 "
17/10/2024 06:54:19,Position closed,NSDQ100/USD," 392,00 ",0.347442," 42,00 "," 5.568,33 "," 4.018,36 ",2834098359,CFD," 0,00 "
17/10/2024 06:55:57,Position closed,NSDQ100/USD," 430,41 ",0.490319,"(69,58)"," 5.498,75 "," 4.448,77 ",2832409467,CFD," 0,00 "
17/10/2024 07:03:56,Open Position,NSDQ100/USD," 300,00 ",0.296073," 0,00 "," 5.498,75 "," 4.148,77 ",2834155586,CFD," 0,00 "
17/10/2024 07:10:56,Open Position,NSDQ100/USD," 300,00 ",0.296211," 0,00 "," 5.498,75 "," 3.848,77 ",2834160373,CFD," 0,00 "
17/10/2024 07:17:21,Open Position,NSDQ100/USD," 199,99 ",0.197545," 0,00 "," 5.498,75 "," 3.648,78 ",2834161728,CFD," 0,00 "
17/10/2024 07:33:43,Position closed,NSDQ100/USD," 205,45 ",0.197545," 5,46 "," 5.504,21 "," 3.854,23 ",2834161728,CFD," 0,00 "
17/10/2024 07:33:48,Position closed,NSDQ100/USD," 305,32 ",0.296211," 5,32 "," 5.509,53 "," 4.159,55 ",2834160373,CFD," 0,00 "
17/10/2024 07:33:53,Position closed,NSDQ100/USD," 302,62 ",0.296073," 2,62 "," 5.512,15 "," 4.462,17 ",2834155586,CFD," 0,00 "
17/10/2024 07:34:49,Open Position,NSDQ100/USD," 300,00 ",0.295987," 0,00 "," 5.512,15 "," 4.162,17 ",2834176886,CFD," 0,00 "
17/10/2024 07:40:11,Position closed,NSDQ100/USD," 301,17 ",0.295987," 1,17 "," 5.513,32 "," 4.463,34 ",2834176886,CFD," 0,00 "
17/10/2024 07:43:26,Open Position,NSDQ100/USD," 500,00 ",0.493263," 0,00 "," 5.513,32 "," 3.963,34 ",2834178650,CFD," 0,00 "
17/10/2024 07:47:44,Open Position,NSDQ100/USD," 500,00 ",0.493446," 0,00 "," 5.513,32 "," 3.463,34 ",2834179725,CFD," 0,00 "
17/10/2024 07:54:07,Position closed,NSDQ100/USD," 501,66 ",0.493446," 1,66 "," 5.514,98 "," 3.965,00 ",2834179725,CFD," 0,00 "
17/10/2024 07:55:38,Open Position,NSDQ100/USD," 500,00 ",0.493385," 0,00 "," 5.514,98 "," 3.465,00 ",2834181265,CFD," 0,00 "
17/10/2024 07:55:47,Open Position,NSDQ100/USD," 300,00 ",0.296010," 0,00 "," 5.514,98 "," 3.165,00 ",2834181285,CFD," 0,00 "
17/10/2024 07:56:36,Open Position,NSDQ100/USD," 250,00 ",0.246647," 0,00 "," 5.514,98 "," 2.915,00 ",2834181365,CFD," 0,00 "
17/10/2024 08:03:49,Position closed,NSDQ100/USD," 509,31 ",0.493385," 9,31 "," 5.524,29 "," 3.424,31 ",2834181265,CFD," 0,00 "
17/10/2024 08:04:01,Position closed,NSDQ100/USD," 507,68 ",0.493263," 7,68 "," 5.531,97 "," 3.931,99 ",2834178650,CFD," 0,00 "
17/10/2024 08:04:09,Position closed,NSDQ100/USD," 304,34 ",0.296010," 4,34 "," 5.536,31 "," 4.236,33 ",2834181285,CFD," 0,00 "
17/10/2024 08:04:27,Position closed,NSDQ100/USD," 253,25 ",0.246647," 3,25 "," 5.539,56 "," 4.489,58 ",2834181365,CFD," 0,00 "
17/10/2024 08:04:44,Open Position,NSDQ100/USD," 399,99 ",0.394428," 0,00 "," 5.539,56 "," 4.089,59 ",2834183164,CFD," 0,00 "
17/10/2024 08:05:12,Open Position,NSDQ100/USD," 500,00 ",0.492947," 0,00 "," 5.539,56 "," 3.589,59 ",2834183323,CFD," 0,00 "
17/10/2024 08:05:53,Open Position,NSDQ100/USD," 500,00 ",0.492884," 0,00 "," 5.539,56 "," 3.089,59 ",2834183412,CFD," 0,00 "
17/10/2024 08:06:46,Open Position,NSDQ100/USD," 350,00 ",0.345165," 0,00 "," 5.539,56 "," 2.739,59 ",2834183522,CFD," 0,00 "
17/10/2024 08:08:14,Open Position,NSDQ100/USD," 500,00 ",0.493285," 0,00 "," 5.539,56 "," 2.239,59 ",2834183971,CFD," 0,00 "
17/10/2024 08:08:28,Open Position,NSDQ100/USD," 199,99 ",0.197291," 0,00 "," 5.539,56 "," 2.039,60 ",2834183996,CFD," 0,00 "
17/10/2024 08:12:53,Position closed,NSDQ100/USD," 201,13 ",0.197291," 1,14 "," 5.540,70 "," 2.240,73 ",2834183996,CFD," 0,00 "
17/10/2024 08:13:01,Position closed,NSDQ100/USD," 503,58 ",0.493285," 3,58 "," 5.544,28 "," 2.744,31 ",2834183971,CFD," 0,00 "
17/10/2024 08:13:52,Open Position,NSDQ100/USD," 300,00 ",0.295872," 0,00 "," 5.544,28 "," 2.444,31 ",2834184748,CFD," 0,00 "
17/10/2024 08:31:36,Position closed,NSDQ100/USD," 507,57 ",0.492947," 7,57 "," 5.551,85 "," 2.951,88 ",2834183323,CFD," 0,00 "
17/10/2024 08:31:44,Position closed,NSDQ100/USD," 306,79 ",0.295872," 6,79 "," 5.558,64 "," 3.258,67 ",2834184748,CFD," 0,00 "
17/10/2024 08:31:50,Position closed,NSDQ100/USD," 357,30 ",0.345165," 7,30 "," 5.565,94 "," 3.615,97 ",2834183522,CFD," 0,00 "
17/10/2024 08:31:55,Position closed,NSDQ100/USD," 407,27 ",0.394428," 7,28 "," 5.573,22 "," 4.023,24 ",2834183164,CFD," 0,00 "
17/10/2024 08:32:01,Position closed,NSDQ100/USD," 505,85 ",0.492884," 5,85 "," 5.579,07 "," 4.529,09 ",2834183412,CFD," 0,00 "
17/10/2024 08:33:04,Open Position,NSDQ100/USD," 500,00 ",0.492348," 0,00 "," 5.579,07 "," 4.029,09 ",2834188187,CFD," 0,00 "
17/10/2024 08:33:15,Open Position,NSDQ100/USD," 299,99 ",0.295382," 0,00 "," 5.579,07 "," 3.729,10 ",2834188222,CFD," 0,00 "
17/10/2024 08:33:25,Open Position,NSDQ100/USD," 199,99 ",0.196920," 0,00 "," 5.579,07 "," 3.529,11 ",2834188267,CFD," 0,00 "
17/10/2024 08:33:42,Open Position,NSDQ100/USD," 199,99 ",0.196951," 0,00 "," 5.579,07 "," 3.329,12 ",2834188303,CFD," 0,00 "
17/10/2024 10:13:40,Withdraw Fee,-,"(5,00)",-,"(5,00)"," 5.574,07 "," 3.324,12 ",-,-," 0,00 "
17/10/2024 10:13:40,Withdrawal Conversion Fee,-,"(5,75)",-," 0,00 "," 5.379,07 "," 3.129,12 ",-,-," 0,00 "
17/10/2024 10:13:40,Withdraw Request,-,"(195,00)",-,"(195,00)"," 5.379,07 "," 3.129,12 ",-,-," 0,00 "
17/10/2024 10:26:35,Position closed,NSDQ100/USD," 513,26 ",0.492348," 13,26 "," 5.392,33 "," 3.642,38 ",2834188187,CFD," 0,00 "
17/10/2024 10:26:39,Position closed,NSDQ100/USD," 307,36 ",0.295382," 7,37 "," 5.399,70 "," 3.949,74 ",2834188222,CFD," 0,00 "
17/10/2024 10:26:43,Position closed,NSDQ100/USD," 204,78 ",0.196920," 4,79 "," 5.404,49 "," 4.154,52 ",2834188267,CFD," 0,00 "
17/10/2024 10:26:48,Position closed,NSDQ100/USD," 205,16 ",0.196951," 5,17 "," 5.409,66 "," 4.359,68 ",2834188303,CFD," 0,00 "
17/10/2024 10:27:43,Open Position,NSDQ100/USD," 399,99 ",0.393313," 0,00 "," 5.409,66 "," 3.959,69 ",2834213661,CFD," 0,00 "
17/10/2024 10:54:28,Position closed,NSDQ100/USD," 406,46 ",0.393313," 6,47 "," 5.416,13 "," 4.366,15 ",2834213661,CFD," 0,00 "
17/10/2024 10:55:05,Open Position,NSDQ100/USD," 300,00 ",0.294693," 0,00 "," 5.416,13 "," 4.066,15 ",2834219702,CFD," 0,00 "
17/10/2024 11:43:40,Open Position,NSDQ100/USD," 199,99 ",0.196639," 0,00 "," 5.416,13 "," 3.866,16 ",2834228828,CFD," 0,00 "
17/10/2024 12:29:13,Position closed,NSDQ100/USD," 199,96 ",0.196639,"(0,03)"," 5.416,10 "," 4.066,12 ",2834228828,CFD," 0,00 "
17/10/2024 12:39:16,Position closed,NSDQ100/USD," 301,22 ",0.294693," 1,22 "," 5.417,32 "," 4.367,34 ",2834219702,CFD," 0,00 "
17/10/2024 12:40:39,Open Position,NSDQ100/USD," 199,99 ",0.196427," 0,00 "," 5.417,32 "," 4.167,35 ",2834244150,CFD," 0,00 "
17/10/2024 13:02:45,Position closed,NSDQ100/USD," 251,42 ",0.245228," 1,42 "," 5.418,74 "," 4.418,77 ",2832421812,CFD," 0,00 "
17/10/2024 13:02:50,Position closed,NSDQ100/USD," 206,03 ",0.196427," 6,04 "," 5.424,78 "," 4.624,80 ",2834244150,CFD," 0,00 "
17/10/2024 13:04:01,Open Position,NSDQ100/USD," 350,00 ",0.343108," 0,00 "," 5.424,78 "," 4.274,80 ",2834251758,CFD," 0,00 "
17/10/2024 13:11:41,Position closed,NSDQ100/USD," 354,06 ",0.343108," 4,06 "," 5.428,84 "," 4.628,86 ",2834251758,CFD," 0,00 "
17/10/2024 13:11:55,Position closed,NSDQ100/USD," 303,93 ",0.294153," 3,94 "," 5.432,78 "," 4.932,79 ",2832410440,CFD," 0,00 "
17/10/2024 13:13:01,Open Position,NSDQ100/USD," 350,00 ",0.342950," 0,00 "," 5.432,78 "," 4.582,79 ",2834254794,CFD," 0,00 "
17/10/2024 13:13:10,Open Position,NSDQ100/USD," 300,00 ",0.293987," 0,00 "," 5.432,78 "," 4.282,79 ",2834254830,CFD," 0,00 "
17/10/2024 13:31:33,Open Position,NSDQ100/USD," 299,99 ",0.294343," 0,00 "," 5.432,78 "," 3.982,80 ",2834325781,CFD," 0,00 "
17/10/2024 13:37:32,Open Position,NSDQ100/USD," 299,99 ",0.296266," 0,00 "," 5.432,78 "," 3.682,81 ",2834365603,CFD," 0,00 "
17/10/2024 13:37:56,Open Position,NSDQ100/USD," 299,98 ",0.295975," 0,00 "," 5.432,78 "," 3.382,83 ",2834366412,CFD," 0,00 "
17/10/2024 13:39:49,Open Position,NSDQ100/USD," 299,99 ",0.295991," 0,00 "," 5.432,78 "," 3.082,84 ",2834370756,CFD," 0,00 "
17/10/2024 13:40:02,Position closed,NSDQ100/USD," 300,42 ",0.296266," 0,43 "," 5.433,21 "," 3.383,26 ",2834365603,CFD," 0,00 "
17/10/2024 13:40:28,Open Position,NSDQ100/USD," 249,99 ",0.246498," 0,00 "," 5.433,21 "," 3.133,27 ",2834372258,CFD," 0,00 "
17/10/2024 13:41:21,Open Position,NSDQ100/USD," 299,99 ",0.295776," 0,00 "," 5.433,21 "," 2.833,28 ",2834375464,CFD," 0,00 "
17/10/2024 13:42:24,Position closed,NSDQ100/USD," 303,29 ",0.295991," 3,30 "," 5.436,51 "," 3.136,57 ",2834370756,CFD," 0,00 "
17/10/2024 13:42:31,Position closed,NSDQ100/USD," 303,11 ",0.295975," 3,13 "," 5.439,64 "," 3.439,68 ",2834366412,CFD," 0,00 "
17/10/2024 13:49:14,Position closed,NSDQ100/USD," 303,76 ",0.295776," 3,77 "," 5.443,41 "," 3.743,44 ",2834375464,CFD," 0,00 "
17/10/2024 13:49:20,Position closed,NSDQ100/USD," 251,14 ",0.246498," 1,15 "," 5.444,56 "," 3.994,58 ",2834372258,CFD," 0,00 "
17/10/2024 13:49:52,Open Position,NSDQ100/USD," 299,99 ",0.295492," 0,00 "," 5.444,56 "," 3.694,59 ",2834392549,CFD," 0,00 "
17/10/2024 14:28:40,Open Position,NSDQ100/USD," 299,99 ",0.296226," 0,00 "," 5.444,56 "," 3.394,60 ",2834509939,CFD," 0,00 "
17/10/2024 14:29:32,Position closed,NSDQ100/USD," 303,30 ",0.296226," 3,31 "," 5.447,87 "," 3.697,90 ",2834509939,CFD," 0,00 "
17/10/2024 14:29:51,Open Position,NSDQ100/USD," 299,99 ",0.295963," 0,00 "," 5.447,87 "," 3.397,91 ",2834510846,CFD," 0,00 "
17/10/2024 14:48:06,Open Position,NSDQ100/USD," 400,00 ",0.395525," 0,00 "," 5.447,87 "," 2.997,91 ",2834541777,CFD," 0,00 "
17/10/2024 14:51:32,Open Position,NSDQ100/USD," 249,99 ",0.247298," 0,00 "," 5.447,87 "," 2.747,92 ",2834552101,CFD," 0,00 "
17/10/2024 14:58:36,Position closed,NSDQ100/USD," 253,22 ",0.247298," 3,23 "," 5.451,10 "," 3.001,14 ",2834552101,CFD," 0,00 "
17/10/2024 14:58:40,Position closed,NSDQ100/USD," 401,49 ",0.395525," 1,49 "," 5.452,59 "," 3.402,63 ",2834541777,CFD," 0,00 "
17/10/2024 15:00:11,Open Position,NSDQ100/USD," 400,00 ",0.395353," 0,00 "," 5.452,59 "," 3.002,63 ",2834559363,CFD," 0,00 "
17/10/2024 15:00:22,Open Position,NSDQ100/USD," 250,00 ",0.247159," 0,00 "," 5.452,59 "," 2.752,63 ",2834559439,CFD," 0,00 "
17/10/2024 15:05:14,Open Position,NSDQ100/USD," 689,99 ",0.682868," 0,00 "," 5.452,59 "," 2.062,64 ",2834563103,CFD," 0,00 "
17/10/2024 15:05:50,Position closed,NSDQ100/USD," 695,36 ",0.682868," 5,37 "," 5.457,96 "," 2.758,00 ",2834563103,CFD," 0,00 "
17/10/2024 15:06:25,Open Position,NSDQ100/USD," 200,00 ",0.197804," 0,00 "," 5.457,96 "," 2.558,00 ",2834564458,CFD," 0,00 "
17/10/2024 15:15:09,Position closed,NSDQ100/USD," 413,03 ",0.395353," 13,03 "," 5.470,99 "," 2.971,03 ",2834559363,CFD," 0,00 "
17/10/2024 15:15:15,Position closed,NSDQ100/USD," 259,26 ",0.247159," 9,26 "," 5.480,25 "," 3.230,29 ",2834559439,CFD," 0,00 "
17/10/2024 15:15:36,Position closed,NSDQ100/USD," 208,30 ",0.197804," 8,30 "," 5.488,55 "," 3.438,59 ",2834564458,CFD," 0,00 "
17/10/2024 15:17:23,Open Position,NSDQ100/USD," 299,99 ",0.296058," 0,00 "," 5.488,55 "," 3.138,60 ",2834571923,CFD," 0,00 "
17/10/2024 15:53:17,Position closed,NSDQ100/USD," 309,27 ",0.296058," 9,28 "," 5.497,83 "," 3.447,87 ",2834571923,CFD," 0,00 "
17/10/2024 15:53:33,Position closed,NSDQ100/USD," 308,92 ",0.295963," 8,93 "," 5.506,76 "," 3.756,79 ",2834510846,CFD," 0,00 "
17/10/2024 15:53:39,Position closed,NSDQ100/USD," 299,09 ",0.295492,"(0,90)"," 5.505,86 "," 4.055,88 ",2834392549,CFD," 0,00 "
17/10/2024 15:54:25,Open Position,NSDQ100/USD," 299,99 ",0.295556," 0,00 "," 5.505,86 "," 3.755,89 ",2834599929,CFD," 0,00 "
17/10/2024 15:58:26,Position closed,NSDQ100/USD," 305,53 ",0.295556," 5,54 "," 5.511,40 "," 4.061,42 ",2834599929,CFD," 0,00 "
17/10/2024 15:58:49,Open Position,NSDQ100/USD," 250,00 ",0.245954," 0,00 "," 5.511,40 "," 3.811,42 ",2834603257,CFD," 0,00 "
17/10/2024 16:00:19,Position closed,NSDQ100/USD," 250,90 ",0.245954," 0,90 "," 5.512,30 "," 4.062,32 ",2834603257,CFD," 0,00 "
17/10/2024 16:01:01,Open Position,NSDQ100/USD," 200,00 ",0.196673," 0,00 "," 5.512,30 "," 3.862,32 ",2834604900,CFD," 0,00 "
17/10/2024 16:29:53,Open Position,NSDQ100/USD," 299,99 ",0.295374," 0,00 "," 5.512,30 "," 3.562,33 ",2834682791,CFD," 0,00 "
17/10/2024 16:30:07,Open Position,NSDQ100/USD," 200,00 ",0.196976," 0,00 "," 5.512,30 "," 3.362,33 ",2834682932,CFD," 0,00 "
17/10/2024 16:37:15,Open Position,NSDQ100/USD," 299,99 ",0.295596," 0,00 "," 5.512,30 "," 3.062,34 ",2834691559,CFD," 0,00 "
17/10/2024 16:47:11,Position closed,NSDQ100/USD," 302,43 ",0.295596," 2,44 "," 5.514,74 "," 3.364,77 ",2834691559,CFD," 0,00 "
17/10/2024 17:39:31,Position closed,NSDQ100/USD," 199,71 ",0.196976,"(0,29)"," 5.514,45 "," 3.564,48 ",2834682932,CFD," 0,00 "
17/10/2024 18:07:04,Open Position,NSDQ100/USD," 350,00 ",0.345515," 0,00 "," 5.514,45 "," 3.214,48 ",2834773459,CFD," 0,00 "
17/10/2024 18:40:28,Open Position,NSDQ100/USD," 350,00 ",0.346134," 0,00 "," 5.514,45 "," 2.864,48 ",2834797256,CFD," 0,00 "
17/10/2024 18:57:10,Position closed,NSDQ100/USD," 356,81 ",0.346134," 6,81 "," 5.521,26 "," 3.221,29 ",2834797256,CFD," 0,00 "
17/10/2024 19:00:09,Open Position,NSDQ100/USD," 200,00 ",0.197400," 0,00 "," 5.521,26 "," 3.021,29 ",2834805757,CFD," 0,00 "
17/10/2024 19:54:24,Open Position,NSDQ100/USD," 499,99 ",0.494967," 0,00 "," 5.521,26 "," 2.521,30 ",2834833033,CFD," 0,00 "
17/10/2024 19:54:32,Open Position,NSDQ100/USD," 99,99 ",0.098971," 0,00 "," 5.521,26 "," 2.421,31 ",2834833121,CFD," 0,00 "
17/10/2024 20:09:50,Position closed,NSDQ100/USD," 510,59 ",0.494967," 10,60 "," 5.531,86 "," 2.931,90 ",2834833033,CFD," 0,00 "
17/10/2024 20:09:57,Position closed,NSDQ100/USD," 101,73 ",0.098971," 1,74 "," 5.533,60 "," 3.033,63 ",2834833121,CFD," 0,00 "
17/10/2024 20:11:52,Open Position,NSDQ100/USD," 299,99 ",0.296505," 0,00 "," 5.533,60 "," 2.733,64 ",2834839870,CFD," 0,00 "
17/10/2024 20:31:45,Open Position,NSDQ100/USD," 500,00 ",0.494696," 0,00 "," 5.533,60 "," 2.233,64 ",2834841000,CFD," 0,00 "
17/10/2024 20:32:04,Open Position,NSDQ100/USD," 199,99 ",0.197864," 0,00 "," 5.533,60 "," 2.033,65 ",2834841010,CFD," 0,00 "
17/10/2024 22:17:21,Position closed,NSDQ100/USD," 504,93 ",0.494696," 4,93 "," 5.538,53 "," 2.538,58 ",2834841000,CFD," 0,00 "
17/10/2024 22:17:28,Position closed,NSDQ100/USD," 201,51 ",0.197864," 1,52 "," 5.540,05 "," 2.740,09 ",2834841010,CFD," 0,00 "
17/10/2024 22:17:53,Open Position,NSDQ100/USD," 500,00 ",0.494390," 0,00 "," 5.540,05 "," 2.240,09 ",2834847188,CFD," 0,00 "
17/10/2024 22:48:00,Position closed,NSDQ100/USD," 508,19 ",0.494390," 8,19 "," 5.548,24 "," 2.748,28 ",2834847188,CFD," 0,00 "
17/10/2024 22:48:08,Position closed,NSDQ100/USD," 302,74 ",0.296505," 2,75 "," 5.550,99 "," 3.051,02 ",2834839870,CFD," 0,00 "
17/10/2024 22:57:43,Open Position,NSDQ100/USD," 199,99 ",0.197603," 0,00 "," 5.550,99 "," 2.851,03 ",2834848315,CFD," 0,00 "
18/10/2024 00:12:09,Index price adjustment,NSDQ100/USD," 0,01 ",-," 0,01 "," 5.551,00 "," 2.851,04 ",2832348855,CFD," 0,00 "
18/10/2024 00:12:09,Index price adjustment,NSDQ100/USD," 0,01 ",-," 0,01 "," 5.551,01 "," 2.851,05 ",2834254794,CFD," 0,00 "
18/10/2024 00:12:09,Index price adjustment,NSDQ100/USD," 0,01 ",-," 0,01 "," 5.551,02 "," 2.851,06 ",2834254830,CFD," 0,00 "
18/10/2024 00:12:09,Index price adjustment,NSDQ100/USD," 0,01 ",-," 0,01 "," 5.551,03 "," 2.851,07 ",2834325781,CFD," 0,00 "
18/10/2024 00:12:09,Index price adjustment,NSDQ100/USD," 0,01 ",-," 0,01 "," 5.551,04 "," 2.851,08 ",2834682791,CFD," 0,00 "
18/10/2024 00:12:09,Index price adjustment,NSDQ100/USD," 0,01 ",-," 0,01 "," 5.551,05 "," 2.851,09 ",2834773459,CFD," 0,00 "
18/10/2024 00:12:09,Index price adjustment,NSDQ100/USD," 0,01 ",-," 0,01 "," 5.551,06 "," 2.851,10 ",2834833033,CFD," 0,00 "
18/10/2024 00:48:53,Overnight fee,Daily,"(1,01)",-,"(1,01)"," 5.550,05 "," 2.850,09 ",2834604900,CFD," 0,00 "
18/10/2024 00:48:53,Overnight fee,Daily,"(1,01)",-,"(1,01)"," 5.549,04 "," 2.849,08 ",2831980871,CFD," 0,00 "
18/10/2024 00:48:53,Overnight fee,Daily,"(1,02)",-,"(1,02)"," 5.548,02 "," 2.848,06 ",2834805757,CFD," 0,00 "
18/10/2024 00:48:53,Overnight fee,Daily,"(1,02)",-,"(1,02)"," 5.547,00 "," 2.847,04 ",2834841010,CFD," 0,00 "
18/10/2024 00:48:53,Overnight fee,Daily,"(1,51)",-,"(1,51)"," 5.545,49 "," 2.845,53 ",2832348855,CFD," 0,00 "
18/10/2024 00:48:53,Overnight fee,Daily,"(1,52)",-,"(1,52)"," 5.543,97 "," 2.844,01 ",2834254830,CFD," 0,00 "
18/10/2024 00:48:53,Overnight fee,Daily,"(1,52)",-,"(1,52)"," 5.542,45 "," 2.842,49 ",2834682791,CFD," 0,00 "
18/10/2024 00:48:53,Overnight fee,Daily,"(1,52)",-,"(1,52)"," 5.540,93 "," 2.840,97 ",2834325781,CFD," 0,00 "
18/10/2024 00:48:53,Overnight fee,Daily,"(1,53)",-,"(1,53)"," 5.539,40 "," 2.839,44 ",2834839870,CFD," 0,00 "
18/10/2024 00:48:53,Overnight fee,Daily,"(1,77)",-,"(1,77)"," 5.537,63 "," 2.837,67 ",2834254794,CFD," 0,00 "
18/10/2024 00:48:53,Overnight fee,Daily,"(1,78)",-,"(1,78)"," 5.535,85 "," 2.835,89 ",2834773459,CFD," 0,00 "
18/10/2024 00:48:53,Overnight fee,Daily,"(2,55)",-,"(2,55)"," 5.533,30 "," 2.833,34 ",2834841000,CFD," 0,00 "
18/10/2024 06:46:23,Position closed,NSDQ100/USD," 203,12 ",0.197603," 3,13 "," 5.536,43 "," 3.036,46 ",2834848315,CFD," 0,00 "
18/10/2024 06:48:42,Open Position,NSDQ100/USD," 399,99 ",0.394874," 0,00 "," 5.536,43 "," 2.636,47 ",2834880956,CFD," 0,00 "
18/10/2024 08:11:42,Position closed,NSDQ100/USD," 411,78 ",0.394874," 11,79 "," 5.548,22 "," 3.048,25 ",2834880956,CFD," 0,00 "
18/10/2024 08:11:49,Position closed,NSDQ100/USD," 205,06 ",0.197400," 5,06 "," 5.553,28 "," 3.253,31 ",2834805757,CFD," 0,00 "
18/10/2024 08:12:05,Position closed,NSDQ100/USD," 360,30 ",0.345515," 10,30 "," 5.563,58 "," 3.613,61 ",2834773459,CFD," 0,00 "
18/10/2024 08:17:51,Open Position,NSDQ100/USD," 199,99 ",0.197038," 0,00 "," 5.563,58 "," 3.413,62 ",2834939152,CFD," 0,00 "
18/10/2024 11:43:31,Position closed,NSDQ100/USD," 201,72 ",0.197038," 1,73 "," 5.565,31 "," 3.615,34 ",2834939152,CFD," 0,00 "
18/10/2024 12:55:13,Position closed,NSDQ100/USD," 299,67 ",0.295374,"(0,32)"," 5.564,99 "," 3.915,01 ",2834682791,CFD," 0,00 "
18/10/2024 13:28:57,Position closed,NSDQ100/USD," 198,72 ",0.196673,"(1,28)"," 5.563,71 "," 4.113,73 ",2834604900,CFD," 0,00 "
18/10/2024 14:39:08,Open Position,NSDQ100/USD," 250,00 ",0.246041," 0,00 "," 5.563,71 "," 3.863,73 ",2835363057,CFD," 0,00 "
18/10/2024 17:43:10,Position closed,NSDQ100/USD," 251,81 ",0.246041," 1,81 "," 5.565,52 "," 4.115,54 ",2835363057,CFD," 0,00 "
18/10/2024 18:19:06,Open Position,NSDQ100/USD," 299,99 ",0.295014," 0,00 "," 5.565,52 "," 3.815,55 ",2835606242,CFD," 0,00 "
18/10/2024 19:03:22,Open Position,NSDQ100/USD," 249,99 ",0.246129," 0,00 "," 5.565,52 "," 3.565,56 ",2835644823,CFD," 0,00 "
18/10/2024 19:23:38,Position closed,NSDQ100/USD," 250,30 ",0.246129," 0,31 "," 5.565,83 "," 3.815,86 ",2835644823,CFD," 0,00 "
18/10/2024 19:36:20,Open Position,NSDQ100/USD," 200,00 ",0.196861," 0,00 "," 5.565,83 "," 3.615,86 ",2835657071,CFD," 0,00 "
18/10/2024 19:53:39,Open Position,NSDQ100/USD," 249,99 ",0.246322," 0,00 "," 5.565,83 "," 3.365,87 ",2835665742,CFD," 0,00 "
18/10/2024 19:55:06,Position closed,NSDQ100/USD," 253,90 ",0.246322," 3,91 "," 5.569,74 "," 3.619,77 ",2835665742,CFD," 0,00 "
18/10/2024 20:10:11,Position closed,NSDQ100/USD," 201,34 ",0.196861," 1,34 "," 5.571,08 "," 3.821,11 ",2835657071,CFD," 0,00 "
18/10/2024 20:11:54,Position closed,NSDQ100/USD," 297,49 ",0.295014,"(2,50)"," 5.568,58 "," 4.118,60 ",2835606242,CFD," 0,00 "
18/10/2024 20:12:42,Position closed,NSDQ100/USD," 173,51 ",0.195460,"(26,49)"," 5.542,09 "," 4.292,11 ",2831980871,CFD," 0,00 "
18/10/2024 20:12:52,Position closed,NSDQ100/USD," 263,20 ",0.293335,"(36,79)"," 5.505,30 "," 4.555,31 ",2832348855,CFD," 0,00 "
18/10/2024 20:14:02,Position closed,NSDQ100/USD," 276,20 ",0.293987,"(23,80)"," 5.481,50 "," 4.831,51 ",2834254830,CFD," 0,00 "
18/10/2024 20:14:02,Position closed,NSDQ100/USD," 321,52 ",0.342950,"(28,48)"," 5.453,02 "," 5.153,03 ",2834254794,CFD," 0,00 "
18/10/2024 20:14:02,Position closed,NSDQ100/USD," 283,42 ",0.294343,"(16,57)"," 5.436,45 "," 5.436,45 ",2834325781,CFD," 0,00 "
20/10/2024 21:06:16,Open Position,USD/JPY," 400,00 ",12000.000000," 0,00 "," 5.436,45 "," 5.036,45 ",2835720547,CFD," 0,00 "
20/10/2024 22:56:20,Position closed,USD/JPY," 402,89 ",12000.000000," 2,89 "," 5.439,34 "," 5.439,34 ",2835720547,CFD," 0,00 "
21/10/2024 07:26:09,Open Position,NSDQ100/USD," 399,99 ",0.394496," 0,00 "," 5.439,34 "," 5.039,35 ",2835837817,CFD," 0,00 "
21/10/2024 07:32:05,Open Position,NSDQ100/USD," 399,99 ",0.394360," 0,00 "," 5.439,34 "," 4.639,36 ",2835839937,CFD," 0,00 "
21/10/2024 07:33:37,Position closed,NSDQ100/USD," 401,59 ",0.394496," 1,60 "," 5.440,94 "," 5.040,95 ",2835837817,CFD," 0,00 "
21/10/2024 07:39:27,Position closed,NSDQ100/USD," 403,56 ",0.394360," 3,57 "," 5.444,51 "," 5.444,51 ",2835839937,CFD," 0,00 "
21/10/2024 07:45:50,Open Position,NSDQ100/USD," 600,00 ",0.591199," 0,00 "," 5.444,51 "," 4.844,51 ",2835846051,CFD," 0,00 "
21/10/2024 07:56:16,Open Position,NSDQ100/USD," 350,00 ",0.345075," 0,00 "," 5.444,51 "," 4.494,51 ",2835849082,CFD," 0,00 "
21/10/2024 07:58:37,Open Position,NSDQ100/USD," 399,99 ",0.394436," 0,00 "," 5.444,51 "," 4.094,52 ",2835849479,CFD," 0,00 "
21/10/2024 08:02:36,Position closed,NSDQ100/USD," 403,45 ",0.394436," 3,46 "," 5.447,97 "," 4.497,97 ",2835849479,CFD," 0,00 "
21/10/2024 08:02:46,Position closed,NSDQ100/USD," 351,75 ",0.345075," 1,75 "," 5.449,72 "," 4.849,72 ",2835849082,CFD," 0,00 "
21/10/2024 08:14:10,Open Position,NSDQ100/USD," 500,00 ",0.493103," 0,00 "," 5.449,72 "," 4.349,72 ",2835863041,CFD," 0,00 "
21/10/2024 08:29:09,Position closed,NSDQ100/USD," 502,35 ",0.493103," 2,35 "," 5.452,07 "," 4.852,07 ",2835863041,CFD," 0,00 "
21/10/2024 08:31:20,Open Position,NSDQ100/USD," 499,98 ",0.492996," 0,00 "," 5.452,07 "," 4.352,09 ",2835866261,CFD," 0,00 "
21/10/2024 08:41:14,Position closed,NSDQ100/USD," 500,70 ",0.492996," 0,72 "," 5.452,79 "," 4.852,79 ",2835866261,CFD," 0,00 "
21/10/2024 08:44:15,Open Position,NSDQ100/USD," 399,99 ",0.394224," 0,00 "," 5.452,79 "," 4.452,80 ",2835868464,CFD," 0,00 "
21/10/2024 08:53:39,Position closed,NSDQ100/USD," 598,91 ",0.591199,"(1,09)"," 5.451,70 "," 5.051,71 ",2835846051,CFD," 0,00 "
21/10/2024 08:54:07,Position closed,NSDQ100/USD," 401,43 ",0.394224," 1,44 "," 5.453,14 "," 5.453,14 ",2835868464,CFD," 0,00 "
21/10/2024 08:55:05,Open Position,NSDQ100/USD," 350,00 ",0.344825," 0,00 "," 5.453,14 "," 5.103,14 ",2835870145,CFD," 0,00 "
21/10/2024 09:09:49,Open Position,NSDQ100/USD," 500,00 ",0.493011," 0,00 "," 5.453,14 "," 4.603,14 ",2835872370,CFD," 0,00 "
21/10/2024 09:14:24,Open Position,NSDQ100/USD," 250,00 ",0.246490," 0,00 "," 5.453,14 "," 4.353,14 ",2835873088,CFD," 0,00 "
21/10/2024 09:17:01,Open Position,NSDQ100/USD," 199,99 ",0.197231," 0,00 "," 5.453,14 "," 4.153,15 ",2835873618,CFD," 0,00 "
21/10/2024 09:21:44,Open Position,NSDQ100/USD," 250,00 ",0.246577," 0,00 "," 5.453,14 "," 3.903,15 ",2835874841,CFD," 0,00 "
21/10/2024 09:48:36,Open Position,NSDQ100/USD," 50,00 ",0.049326," 0,00 "," 5.453,14 "," 3.853,15 ",2835881261,CFD," 0,00 "
21/10/2024 09:49:43,Open Position,NSDQ100/USD," 399,99 ",0.394731," 0,00 "," 5.453,14 "," 3.453,16 ",2835881420,CFD," 0,00 "
21/10/2024 10:05:35,Open Position,NSDQ100/USD," 349,99 ",0.345514," 0,00 "," 5.453,14 "," 3.103,17 ",2835884862,CFD," 0,00 "
21/10/2024 11:11:00,Open Position,NSDQ100/USD," 800,00 ",0.791545," 0,00 "," 5.453,14 "," 2.303,17 ",2835899993,CFD," 0,00 "
21/10/2024 11:11:35,Open Position,NSDQ100/USD," 399,99 ",0.395741," 0,00 "," 5.453,14 "," 1.903,18 ",2835900143,CFD," 0,00 "
21/10/2024 11:44:46,Open Position,NSDQ100/USD," 399,99 ",0.396025," 0,00 "," 5.453,14 "," 1.503,19 ",2835907491,CFD," 0,00 "
21/10/2024 12:43:03,Position closed,NSDQ100/USD," 409,68 ",0.396025," 9,69 "," 5.462,83 "," 1.912,87 ",2835907491,CFD," 0,00 "
21/10/2024 12:43:11,Position closed,NSDQ100/USD," 808,68 ",0.791545," 8,68 "," 5.471,51 "," 2.721,55 ",2835899993,CFD," 0,00 "
21/10/2024 12:43:23,Position closed,NSDQ100/USD," 403,94 ",0.395741," 3,95 "," 5.475,46 "," 3.125,49 ",2835900143,CFD," 0,00 "
21/10/2024 12:44:28,Open Position,NSDQ100/USD," 550,00 ",0.543754," 0,00 "," 5.475,46 "," 2.575,49 ",2835926294,CFD," 0,00 "
21/10/2024 13:18:22,Position closed,NSDQ100/USD," 566,57 ",0.543754," 16,57 "," 5.492,03 "," 3.142,06 ",2835926294,CFD," 0,00 "
21/10/2024 13:19:17,Open Position,NSDQ100/USD," 250,00 ",0.246795," 0,00 "," 5.492,03 "," 2.892,06 ",2835935984,CFD," 0,00 "
21/10/2024 13:31:39,Position closed,NSDQ100/USD," 202,04 ",0.197231," 2,05 "," 5.494,08 "," 3.094,10 ",2835873618,CFD," 0,00 "
21/10/2024 13:31:58,Position closed,NSDQ100/USD," 350,00 ",0.344825," 0,00 "," 5.494,08 "," 3.444,10 ",2835870145,CFD," 0,00 "
21/10/2024 13:31:59,Position closed,NSDQ100/USD," 259,97 ",0.246795," 9,97 "," 5.504,05 "," 3.704,07 ",2835935984,CFD," 0,00 "
21/10/2024 13:31:59,Position closed,NSDQ100/USD," 255,55 ",0.246577," 5,55 "," 5.509,60 "," 3.959,62 ",2835874841,CFD," 0,00 "
21/10/2024 13:32:26,Position closed,NSDQ100/USD," 249,66 ",0.246490,"(0,34)"," 5.509,26 "," 4.209,28 ",2835873088,CFD," 0,00 "
21/10/2024 13:32:27,Position closed,NSDQ100/USD," 500,30 ",0.493011," 0,30 "," 5.509,56 "," 4.709,58 ",2835872370,CFD," 0,00 "
21/10/2024 13:32:32,Position closed,NSDQ100/USD," 355,87 ",0.345514," 5,88 "," 5.515,44 "," 5.065,45 ",2835884862,CFD," 0,00 "
21/10/2024 13:36:22,Position closed,NSDQ100/USD," 51,47 ",0.049326," 1,47 "," 5.516,91 "," 5.116,92 ",2835881261,CFD," 0,00 "
21/10/2024 13:36:22,Position closed,NSDQ100/USD," 414,16 ",0.394731," 14,17 "," 5.531,08 "," 5.531,08 ",2835881420,CFD," 0,00 "
21/10/2024 13:48:32,Open Position,NSDQ100/USD," 350,00 ",0.344473," 0,00 "," 5.531,08 "," 5.181,08 ",2836168992,CFD," 0,00 "
21/10/2024 13:58:46,Position closed,NSDQ100/USD," 352,64 ",0.344473," 2,64 "," 5.533,72 "," 5.533,72 ",2836168992,CFD," 0,00 "
21/10/2024 13:59:20,Open Position,NSDQ100/USD," 249,99 ",0.245928," 0,00 "," 5.533,72 "," 5.283,73 ",2836304951,CFD," 0,00 "
21/10/2024 15:07:00,Open Position,NSDQ100/USD," 560,00 ",0.553661," 0,00 "," 5.533,72 "," 4.723,73 ",2836428348,CFD," 0,00 "
21/10/2024 15:08:53,Open Position,NSDQ100/USD," 550,00 ",0.544539," 0,00 "," 5.533,72 "," 4.173,73 ",2836431600,CFD," 0,00 "
21/10/2024 15:10:20,Open Position,NSDQ100/USD," 999,99 ",0.990198," 0,00 "," 5.533,72 "," 3.173,74 ",2836433728,CFD," 0,00 "
21/10/2024 15:10:44,Open Position,NSDQ100/USD," 499,98 ",0.495133," 0,00 "," 5.533,72 "," 2.673,76 ",2836434377,CFD," 0,00 "
21/10/2024 15:11:16,Open Position,NSDQ100/USD," 799,99 ",0.792014," 0,00 "," 5.533,72 "," 1.873,77 ",2836434928,CFD," 0,00 "
21/10/2024 15:11:29,Open Position,NSDQ100/USD," 499,98 ",0.495001," 0,00 "," 5.533,72 "," 1.373,79 ",2836435150,CFD," 0,00 "
21/10/2024 15:14:09,Position closed,NSDQ100/USD," 560,37 ",0.553661," 0,37 "," 5.534,09 "," 1.934,16 ",2836428348,CFD," 0,00 "
21/10/2024 15:14:09,Position closed,NSDQ100/USD," 225,04 ",0.245928,"(24,95)"," 5.509,14 "," 2.159,20 ",2836304951,CFD," 0,00 "
21/10/2024 15:14:09,Position closed,NSDQ100/USD," 565,82 ",0.544539," 15,82 "," 5.524,96 "," 2.725,02 ",2836431600,CFD," 0,00 "
21/10/2024 15:14:09,Position closed,NSDQ100/USD," 516,55 ",0.495133," 16,57 "," 5.541,53 "," 3.241,57 ",2836434377,CFD," 0,00 "
21/10/2024 15:14:09,Position closed,NSDQ100/USD," 513,83 ",0.495001," 13,85 "," 5.555,38 "," 3.755,40 ",2836435150,CFD," 0,00 "
21/10/2024 15:14:09,Position closed,NSDQ100/USD," 822,29 ",0.792014," 22,30 "," 5.577,68 "," 4.577,69 ",2836434928,CFD," 0,00 "
21/10/2024 15:14:09,Position closed,NSDQ100/USD," 1.031,34 ",0.990198," 31,35 "," 5.609,03 "," 5.609,03 ",2836433728,CFD," 0,00 "
21/10/2024 15:14:55,Open Position,NSDQ100/USD," 499,98 ",0.494296," 0,00 "," 5.609,03 "," 5.109,05 ",2836447588,CFD," 0,00 "
21/10/2024 15:15:18,Open Position,NSDQ100/USD," 570,00 ",0.563501," 0,00 "," 5.609,03 "," 4.539,05 ",2836448031,CFD," 0,00 "
21/10/2024 15:15:38,Open Position,NSDQ100/USD," 600,00 ",0.593335," 0,00 "," 5.609,03 "," 3.939,05 ",2836448898,CFD," 0,00 "
21/10/2024 15:18:09,Open Position,NSDQ100/USD," 1.499,99 ",1.484423," 0,00 "," 5.609,03 "," 2.439,06 ",2836458929,CFD," 0,00 "
21/10/2024 15:19:49,Open Position,NSDQ100/USD," 400,00 ",0.395754," 0,00 "," 5.609,03 "," 2.039,06 ",2836462339,CFD," 0,00 "
21/10/2024 15:25:16,Open Position,NSDQ100/USD," 499,99 ",0.494930," 0,00 "," 5.609,03 "," 1.539,07 ",2836471743,CFD," 0,00 "
21/10/2024 15:27:18,Open Position,NSDQ100/USD," 350,00 ",0.346595," 0,00 "," 5.609,03 "," 1.189,07 ",2836473671,CFD," 0,00 "
21/10/2024 15:32:28,Position closed,NSDQ100/USD," 355,15 ",0.346595," 5,15 "," 5.614,18 "," 1.544,22 ",2836473671,CFD," 0,00 "
21/10/2024 15:33:01,Position closed,NSDQ100/USD," 504,58 ",0.494930," 4,59 "," 5.618,77 "," 2.048,80 ",2836471743,CFD," 0,00 "
21/10/2024 15:33:23,Position closed,NSDQ100/USD," 1.501,73 ",1.484423," 1,74 "," 5.620,51 "," 3.550,53 ",2836458929,CFD," 0,00 "
21/10/2024 15:33:41,Open Position,NSDQ100/USD," 559,99 ",0.553987," 0,00 "," 5.620,51 "," 2.990,54 ",2836483323,CFD," 0,00 "
21/10/2024 15:34:09,Open Position,NSDQ100/USD," 560,00 ",0.553825," 0,00 "," 5.620,51 "," 2.430,54 ",2836483632,CFD," 0,00 "
21/10/2024 15:35:47,Position closed,NSDQ100/USD," 400,50 ",0.395754," 0,50 "," 5.621,01 "," 2.831,04 ",2836462339,CFD," 0,00 "
21/10/2024 15:36:36,Open Position,NSDQ100/USD," 499,99 ",0.494595," 0,00 "," 5.621,01 "," 2.331,05 ",2836487685,CFD," 0,00 "
21/10/2024 15:40:18,Position closed,NSDQ100/USD," 574,89 ",0.563501," 4,89 "," 5.625,90 "," 2.905,94 ",2836448031,CFD," 0,00 "
21/10/2024 15:40:18,Position closed,NSDQ100/USD," 504,41 ",0.494296," 4,43 "," 5.630,33 "," 3.410,35 ",2836447588,CFD," 0,00 "
21/10/2024 15:40:18,Position closed,NSDQ100/USD," 608,70 ",0.593335," 8,70 "," 5.639,03 "," 4.019,05 ",2836448898,CFD," 0,00 "
21/10/2024 15:40:18,Position closed,NSDQ100/USD," 569,07 ",0.553825," 9,07 "," 5.648,10 "," 4.588,12 ",2836483632,CFD," 0,00 "
21/10/2024 15:40:18,Position closed,NSDQ100/USD," 572,44 ",0.553987," 12,45 "," 5.660,55 "," 5.160,56 ",2836483323,CFD," 0,00 "
21/10/2024 15:40:18,Position closed,NSDQ100/USD," 510,26 ",0.494595," 10,27 "," 5.670,82 "," 5.670,82 ",2836487685,CFD," 0,00 "
21/10/2024 15:40:51,Open Position,NSDQ100/USD," 299,99 ",0.296254," 0,00 "," 5.670,82 "," 5.370,83 ",2836491096,CFD," 0,00 "
21/10/2024 15:41:26,Open Position,NSDQ100/USD," 299,99 ",0.296334," 0,00 "," 5.670,82 "," 5.070,84 ",2836491844,CFD," 0,00 "
21/10/2024 15:46:21,Position closed,NSDQ100/USD," 300,99 ",0.296334," 1,00 "," 5.671,82 "," 5.371,83 ",2836491844,CFD," 0,00 "
21/10/2024 15:47:15,Open Position,NSDQ100/USD," 350,00 ",0.345643," 0,00 "," 5.671,82 "," 5.021,83 ",2836501410,CFD," 0,00 "
21/10/2024 15:48:44,Position closed,NSDQ100/USD," 355,10 ",0.345643," 5,10 "," 5.676,92 "," 5.376,93 ",2836501410,CFD," 0,00 "
21/10/2024 15:48:44,Position closed,NSDQ100/USD," 304,13 ",0.296254," 4,14 "," 5.681,06 "," 5.681,06 ",2836491096,CFD," 0,00 "
21/10/2024 15:54:50,Open Position,NSDQ100/USD," 299,99 ",0.296005," 0,00 "," 5.681,06 "," 5.381,07 ",2836509034,CFD," 0,00 "
21/10/2024 15:57:11,Position closed,NSDQ100/USD," 309,30 ",0.296005," 9,31 "," 5.690,37 "," 5.690,37 ",2836509034,CFD," 0,00 "
21/10/2024 15:59:10,Open Position,NSDQ100/USD," 299,99 ",0.295603," 0,00 "," 5.690,37 "," 5.390,38 ",2836512656,CFD," 0,00 "
21/10/2024 16:36:34,Open Position,NSDQ100/USD," 249,99 ",0.246504," 0,00 "," 5.690,37 "," 5.140,39 ",2836569540,CFD," 0,00 "
21/10/2024 16:55:37,Position closed,NSDQ100/USD," 256,81 ",0.246504," 6,82 "," 5.697,19 "," 5.397,20 ",2836569540,CFD," 0,00 "
21/10/2024 17:13:43,Position closed,NSDQ100/USD," 306,72 ",0.295603," 6,73 "," 5.703,92 "," 5.703,92 ",2836512656,CFD," 0,00 "
21/10/2024 17:15:55,Open Position,NSDQ100/USD," 299,99 ",0.295127," 0,00 "," 5.703,92 "," 5.403,93 ",2836601889,CFD," 0,00 "
21/10/2024 17:54:23,Position closed,NSDQ100/USD," 299,38 ",0.295127,"(0,61)"," 5.703,31 "," 5.703,31 ",2836601889,CFD," 0,00 "
21/10/2024 18:09:12,Open Position,NSDQ100/USD," 200,00 ",0.196857," 0,00 "," 5.703,31 "," 5.503,31 ",2836637858,CFD," 0,00 "
21/10/2024 20:23:45,Position closed,NSDQ100/USD," 211,40 ",0.196857," 11,40 "," 5.714,71 "," 5.714,71 ",2836637858,CFD," 0,00 "
22/10/2024 00:49:43,Open Position,NSDQ100/USD," 300,00 ",0.295108," 0,00 "," 5.714,71 "," 5.414,71 ",2836744488,CFD," 0,00 "
22/10/2024 00:57:23,Open Position,NSDQ100/USD," 500,00 ",0.492130," 0,00 "," 5.714,71 "," 4.914,71 ",2836744676,CFD," 0,00 "
22/10/2024 04:43:48,Position closed,NSDQ100/USD," 495,15 ",0.492130,"(4,85)"," 5.709,86 "," 5.409,86 ",2836744676,CFD," 0,00 "
22/10/2024 04:44:22,Position closed,NSDQ100/USD," 293,79 ",0.295108,"(6,21)"," 5.703,65 "," 5.703,65 ",2836744488,CFD," 0,00 "
22/10/2024 06:18:06,Open Position,NSDQ100/USD," 308,00 ",0.303488," 0,00 "," 5.703,65 "," 5.395,65 ",2836768365,CFD," 0,00 "
22/10/2024 06:44:02,Open Position,NSDQ100/USD," 580,00 ",0.572002," 0,00 "," 5.703,65 "," 4.815,65 ",2836770873,CFD," 0,00 "
22/10/2024 07:06:51,Position closed,NSDQ100/USD," 587,70 ",0.572002," 7,70 "," 5.711,35 "," 5.403,35 ",2836770873,CFD," 0,00 "
22/10/2024 07:07:53,Open Position,NSDQ100/USD," 599,99 ",0.591315," 0,00 "," 5.711,35 "," 4.803,36 ",2836799565,CFD," 0,00 "
22/10/2024 07:08:55,Open Position,NSDQ100/USD," 399,99 ",0.394183," 0,00 "," 5.711,35 "," 4.403,37 ",2836803289,CFD," 0,00 "
22/10/2024 07:09:05,Open Position,NSDQ100/USD," 350,00 ",0.344873," 0,00 "," 5.711,35 "," 4.053,37 ",2836803315,CFD," 0,00 "
22/10/2024 07:09:16,Open Position,NSDQ100/USD," 580,00 ",0.571549," 0,00 "," 5.711,35 "," 3.473,37 ",2836805024,CFD," 0,00 "
22/10/2024 07:10:33,Position closed,NSDQ100/USD," 605,64 ",0.591315," 5,65 "," 5.717,00 "," 4.079,01 ",2836799565,CFD," 0,00 "
22/10/2024 07:10:33,Position closed,NSDQ100/USD," 309,81 ",0.303488," 1,81 "," 5.718,81 "," 4.388,82 ",2836768365,CFD," 0,00 "
22/10/2024 07:10:33,Position closed,NSDQ100/USD," 403,21 ",0.394183," 3,22 "," 5.722,03 "," 4.792,03 ",2836803289,CFD," 0,00 "
22/10/2024 07:10:33,Position closed,NSDQ100/USD," 352,06 ",0.344873," 2,06 "," 5.724,09 "," 5.144,09 ",2836803315,CFD," 0,00 "
22/10/2024 07:10:33,Position closed,NSDQ100/USD," 584,32 ",0.571549," 4,32 "," 5.728,41 "," 5.728,41 ",2836805024,CFD," 0,00 "
22/10/2024 07:11:14,Open Position,NSDQ100/USD," 580,00 ",0.571216," 0,00 "," 5.728,41 "," 5.148,41 ",2836805554,CFD," 0,00 "
22/10/2024 07:11:58,Open Position,NSDQ100/USD," 580,00 ",0.571227," 0,00 "," 5.728,41 "," 4.568,41 ",2836805750,CFD," 0,00 "
22/10/2024 07:12:44,Open Position,NSDQ100/USD," 580,00 ",0.571295," 0,00 "," 5.728,41 "," 3.988,41 ",2836805855,CFD," 0,00 "
22/10/2024 07:14:14,Position closed,NSDQ100/USD," 581,74 ",0.571216," 1,74 "," 5.730,15 "," 4.570,15 ",2836805554,CFD," 0,00 "
22/10/2024 07:14:14,Position closed,NSDQ100/USD," 583,34 ",0.571295," 3,34 "," 5.733,49 "," 5.153,49 ",2836805855,CFD," 0,00 "
22/10/2024 07:14:14,Position closed,NSDQ100/USD," 581,97 ",0.571227," 1,97 "," 5.735,46 "," 5.735,46 ",2836805750,CFD," 0,00 "
22/10/2024 07:14:39,Open Position,NSDQ100/USD," 580,00 ",0.570831," 0,00 "," 5.735,46 "," 5.155,46 ",2836806260,CFD," 0,00 "
22/10/2024 07:44:12,Position closed,NSDQ100/USD," 583,57 ",0.570831," 3,57 "," 5.739,03 "," 5.739,03 ",2836806260,CFD," 0,00 "
22/10/2024 07:48:14,Open Position,NSDQ100/USD," 699,99 ",0.689070," 0,00 "," 5.739,03 "," 5.039,04 ",2836825897,CFD," 0,00 "
22/10/2024 07:54:58,Open Position,NSDQ100/USD," 399,99 ",0.393890," 0,00 "," 5.739,03 "," 4.639,05 ",2836827174,CFD," 0,00 "
22/10/2024 08:00:36,Open Position,NSDQ100/USD," 300,00 ",0.295477," 0,00 "," 5.739,03 "," 4.339,05 ",2836829245,CFD," 0,00 "
22/10/2024 08:01:56,Position closed,NSDQ100/USD," 401,78 ",0.393890," 1,79 "," 5.740,82 "," 4.740,83 ",2836827174,CFD," 0,00 "
22/10/2024 08:02:01,Position closed,NSDQ100/USD," 301,91 ",0.295477," 1,91 "," 5.742,73 "," 5.042,74 ",2836829245,CFD," 0,00 "
22/10/2024 08:04:43,Open Position,NSDQ100/USD," 369,99 ",0.364502," 0,00 "," 5.742,73 "," 4.672,75 ",2836829922,CFD," 0,00 "
22/10/2024 08:08:10,Position closed,NSDQ100/USD," 370,74 ",0.364502," 0,75 "," 5.743,48 "," 5.043,49 ",2836829922,CFD," 0,00 "
22/10/2024 08:11:37,Open Position,NSDQ100/USD," 399,99 ",0.394020," 0,00 "," 5.743,48 "," 4.643,50 ",2836830915,CFD," 0,00 "
22/10/2024 08:13:11,Position closed,NSDQ100/USD," 399,42 ",0.394020,"(0,57)"," 5.742,91 "," 5.042,92 ",2836830915,CFD," 0,00 "
22/10/2024 08:14:43,Position closed,NSDQ100/USD," 696,10 ",0.689070,"(3,89)"," 5.739,02 "," 5.739,02 ",2836825897,CFD," 0,00 "
22/10/2024 08:23:02,Open Position,NSDQ100/USD," 249,99 ",0.246170," 0,00 "," 5.739,02 "," 5.489,03 ",2836832613,CFD," 0,00 "
22/10/2024 08:36:21,Open Position,NSDQ100/USD," 580,00 ",0.571780," 0,00 "," 5.739,02 "," 4.909,03 ",2836835805,CFD," 0,00 "
22/10/2024 08:40:13,Open Position,NSDQ100/USD," 250,00 ",0.246435," 0,00 "," 5.739,02 "," 4.659,03 ",2836836576,CFD," 0,00 "
22/10/2024 08:45:14,Position closed,NSDQ100/USD," 585,75 ",0.571780," 5,75 "," 5.744,77 "," 5.244,78 ",2836835805,CFD," 0,00 "
22/10/2024 08:45:37,Position closed,NSDQ100/USD," 251,69 ",0.246435," 1,69 "," 5.746,46 "," 5.496,47 ",2836836576,CFD," 0,00 "
22/10/2024 08:51:13,Open Position,NSDQ100/USD," 580,00 ",0.571520," 0,00 "," 5.746,46 "," 4.916,47 ",2836838340,CFD," 0,00 "
22/10/2024 09:00:59,Open Position,NSDQ100/USD," 580,00 ",0.572231," 0,00 "," 5.746,46 "," 4.336,47 ",2836840104,CFD," 0,00 "
22/10/2024 09:34:52,Open Position,NSDQ100/USD," 1.199,99 ",1.185904," 0,00 "," 5.746,46 "," 3.136,48 ",2836848678,CFD," 0,00 "
22/10/2024 09:35:45,Open Position,NSDQ100/USD," 699,99 ",0.691476," 0,00 "," 5.746,46 "," 2.436,49 ",2836848872,CFD," 0,00 "
22/10/2024 09:36:33,Open Position,NSDQ100/USD," 300,00 ",0.296298," 0,00 "," 5.746,46 "," 2.136,49 ",2836850053,CFD," 0,00 "
22/10/2024 09:37:08,Position closed,NSDQ100/USD," 1.211,21 ",1.185904," 11,22 "," 5.757,68 "," 3.347,70 ",2836848678,CFD," 0,00 "
22/10/2024 09:38:03,Position closed,NSDQ100/USD," 701,41 ",0.691476," 1,42 "," 5.759,10 "," 4.049,11 ",2836848872,CFD," 0,00 "
22/10/2024 09:39:04,Open Position,NSDQ100/USD," 1.000,00 ",0.987687," 0,00 "," 5.759,10 "," 3.049,11 ",2836850711,CFD," 0,00 "
22/10/2024 09:47:49,Open Position,NSDQ100/USD," 1.000,00 ",0.988556," 0,00 "," 5.759,10 "," 2.049,11 ",2836853949,CFD," 0,00 "
22/10/2024 10:36:40,Position closed,NSDQ100/USD," 1.002,15 ",0.988556," 2,15 "," 5.761,25 "," 3.051,26 ",2836853949,CFD," 0,00 "
22/10/2024 10:39:57,Open Position,NSDQ100/USD," 1.000,00 ",0.988312," 0,00 "," 5.761,25 "," 2.051,26 ",2836865894,CFD," 0,00 "
22/10/2024 11:17:13,Position closed,NSDQ100/USD," 1.013,11 ",0.988312," 13,11 "," 5.774,36 "," 3.064,37 ",2836865894,CFD," 0,00 "
22/10/2024 11:21:53,Position closed,NSDQ100/USD," 1.014,08 ",0.987687," 14,08 "," 5.788,44 "," 4.078,45 ",2836850711,CFD," 0,00 "
22/10/2024 11:28:04,Position closed,NSDQ100/USD," 305,41 ",0.296298," 5,41 "," 5.793,85 "," 4.383,86 ",2836850053,CFD," 0,00 "
22/10/2024 11:28:24,Open Position,NSDQ100/USD," 300,00 ",0.295991," 0,00 "," 5.793,85 "," 4.083,86 ",2836875129,CFD," 0,00 "
22/10/2024 12:24:39,Position closed,NSDQ100/USD," 584,10 ",0.572231," 4,10 "," 5.797,95 "," 4.667,96 ",2836840104,CFD," 0,00 "
22/10/2024 12:24:46,Position closed,NSDQ100/USD," 302,15 ",0.295991," 2,15 "," 5.800,10 "," 4.970,11 ",2836875129,CFD," 0,00 "
22/10/2024 12:50:36,Open Position,NSDQ100/USD," 800,00 ",0.791463," 0,00 "," 5.800,10 "," 4.170,11 ",2836894115,CFD," 0,00 "
22/10/2024 12:55:02,Open Position,NSDQ100/USD," 1.000,00 ",0.989011," 0,00 "," 5.800,10 "," 3.170,11 ",2836894793,CFD," 0,00 "
22/10/2024 12:58:36,Position closed,NSDQ100/USD," 813,51 ",0.791463," 13,51 "," 5.813,61 "," 3.983,62 ",2836894115,CFD," 0,00 "
22/10/2024 12:59:58,Position closed,NSDQ100/USD," 1.014,31 ",0.989011," 14,31 "," 5.827,92 "," 4.997,93 ",2836894793,CFD," 0,00 "
22/10/2024 13:00:08,Open Position,NSDQ100/USD," 500,00 ",0.494212," 0,00 "," 5.827,92 "," 4.497,93 ",2836895625,CFD," 0,00 "
22/10/2024 13:00:28,Open Position,NSDQ100/USD," 250,00 ",0.247129," 0,00 "," 5.827,92 "," 4.247,93 ",2836895717,CFD," 0,00 "
22/10/2024 13:09:30,Open Position,NSDQ100/USD," 999,99 ",0.989657," 0,00 "," 5.827,92 "," 3.247,94 ",2836898988,CFD," 0,00 "
22/10/2024 13:10:05,Open Position,NSDQ100/USD," 300,00 ",0.296882," 0,00 "," 5.827,92 "," 2.947,94 ",2836899120,CFD," 0,00 "
22/10/2024 13:12:07,Position closed,NSDQ100/USD," 1.019,16 ",0.989657," 19,17 "," 5.847,09 "," 3.967,10 ",2836898988,CFD," 0,00 "
22/10/2024 13:12:21,Position closed,NSDQ100/USD," 305,22 ",0.296882," 5,22 "," 5.852,31 "," 4.272,32 ",2836899120,CFD," 0,00 "
22/10/2024 13:12:38,Open Position,NSDQ100/USD," 500,00 ",0.494227," 0,00 "," 5.852,31 "," 3.772,32 ",2836899757,CFD," 0,00 "
22/10/2024 13:15:59,Position closed,NSDQ100/USD," 500,97 ",0.494227," 0,97 "," 5.853,28 "," 4.273,29 ",2836899757,CFD," 0,00 "
22/10/2024 13:17:03,Position closed,NSDQ100/USD," 500,73 ",0.494212," 0,73 "," 5.854,01 "," 4.774,02 ",2836895625,CFD," 0,00 "
22/10/2024 13:17:07,Position closed,NSDQ100/USD," 250,78 ",0.247129," 0,78 "," 5.854,79 "," 5.024,80 ",2836895717,CFD," 0,00 "
22/10/2024 13:18:09,Open Position,NSDQ100/USD," 300,00 ",0.296498," 0,00 "," 5.854,79 "," 4.724,80 ",2836900812,CFD," 0,00 "
22/10/2024 13:30:41,Position closed,NSDQ100/USD," 305,73 ",0.296498," 5,73 "," 5.860,52 "," 5.030,53 ",2836900812,CFD," 0,00 "
22/10/2024 13:30:45,Open Position,TSLA/USD," 299,97 ",6.919174," 0,00 "," 5.860,52 "," 4.730,56 ",2836943188,CFD," 0,00 "
22/10/2024 13:30:46,Open Position,TSLA/USD," 299,97 ",6.919494," 0,00 "," 5.860,52 "," 4.430,59 ",2836944063,CFD," 0,00 "
22/10/2024 13:36:52,Position closed,NSDQ100/USD," 236,75 ",0.246170,"(13,24)"," 5.847,28 "," 4.667,34 ",2836832613,CFD," 0,00 "
22/10/2024 13:38:53,Open Position,NSDQ100/USD," 299,99 ",0.295981," 0,00 "," 5.847,28 "," 4.367,35 ",2837015810,CFD," 0,00 "
22/10/2024 13:40:12,Position closed,NSDQ100/USD," 297,76 ",0.295981,"(2,23)"," 5.845,05 "," 4.665,11 ",2837015810,CFD," 0,00 "
22/10/2024 13:41:03,Position closed,NSDQ100/USD," 562,35 ",0.571520,"(17,65)"," 5.827,40 "," 5.227,46 ",2836838340,CFD," 0,00 "
22/10/2024 13:41:51,Open Position,NSDQ100/USD," 200,00 ",0.197328," 0,00 "," 5.827,40 "," 5.027,46 ",2837031899,CFD," 0,00 "
22/10/2024 13:43:33,Position closed,NSDQ100/USD," 204,31 ",0.197328," 4,31 "," 5.831,71 "," 5.231,77 ",2837031899,CFD," 0,00 "
22/10/2024 13:44:24,Open Position,TSLA/USD," 199,94 ",0.924492," 0,00 "," 5.831,71 "," 5.031,83 ",2837041015,CFD," 0,00 "
22/10/2024 14:05:31,Open Position,NSDQ100/USD," 350,00 ",0.344683," 0,00 "," 5.831,71 "," 4.681,83 ",2837143186,CFD," 0,00 "
22/10/2024 14:05:51,Position closed,NSDQ100/USD," 352,22 ",0.344683," 2,22 "," 5.833,93 "," 5.034,05 ",2837143186,CFD," 0,00 "
22/10/2024 14:06:04,Open Position,NSDQ100/USD," 350,00 ",0.344546," 0,00 "," 5.833,93 "," 4.684,05 ",2837143940,CFD," 0,00 "
22/10/2024 14:06:32,Position closed,NSDQ100/USD," 359,35 ",0.344546," 9,35 "," 5.843,28 "," 5.043,40 ",2837143940,CFD," 0,00 "
22/10/2024 14:07:31,Open Position,NSDQ100/USD," 299,98 ",0.294855," 0,00 "," 5.843,28 "," 4.743,42 ",2837146681,CFD," 0,00 "
22/10/2024 14:10:52,Position closed,NSDQ100/USD," 296,78 ",0.294855,"(3,20)"," 5.840,08 "," 5.040,20 ",2837146681,CFD," 0,00 "
22/10/2024 14:15:30,Open Position,TSLA/USD," 299,98 ",1.381590," 0,00 "," 5.840,08 "," 4.740,22 ",2837159026,CFD," 0,00 "
22/10/2024 14:15:53,Position closed,TSLA/USD," 299,37 ",1.381590,"(0,61)"," 5.839,47 "," 5.039,59 ",2837159026,CFD," 0,00 "
22/10/2024 14:16:12,Open Position,TSLA/USD," 299,87 ",6.919636," 0,00 "," 5.839,47 "," 4.739,72 ",2837160161,CFD," 0,00 "
22/10/2024 14:42:12,Open Position,NSDQ100/USD," 200,00 ",0.196730," 0,00 "," 5.839,47 "," 4.539,72 ",2837197472,CFD," 0,00 "
22/10/2024 14:55:32,Position closed,NSDQ100/USD," 201,56 ",0.196730," 1,56 "," 5.841,03 "," 4.741,28 ",2837197472,CFD," 0,00 "
22/10/2024 15:18:53,Position closed,TSLA/USD," 302,43 ",6.919636," 2,56 "," 5.843,59 "," 5.043,71 ",2837160161,CFD," 0,00 "
22/10/2024 15:18:57,Position closed,TSLA/USD," 303,29 ",6.919494," 3,32 "," 5.846,91 "," 5.347,00 ",2836944063,CFD," 0,00 "
22/10/2024 15:18:57,Position closed,TSLA/USD," 199,94 ",0.924492," 0,00 "," 5.846,91 "," 5.546,94 ",2837041015,CFD," 0,00 "
22/10/2024 15:18:57,Position closed,TSLA/USD," 303,36 ",6.919174," 3,39 "," 5.850,30 "," 5.850,30 ",2836943188,CFD," 0,00 "
22/10/2024 15:19:26,Open Position,TSLA/USD," 299,99 ",6.957454," 0,00 "," 5.850,30 "," 5.550,31 ",2837242579,CFD," 0,00 "
22/10/2024 15:20:12,Open Position,NSDQ100/USD," 299,99 ",0.295252," 0,00 "," 5.850,30 "," 5.250,32 ",2837244249,CFD," 0,00 "
22/10/2024 16:29:16,Open Position,NSDQ100/USD," 350,00 ",0.345161," 0,00 "," 5.850,30 "," 4.900,32 ",2837309987,CFD," 0,00 "
22/10/2024 16:35:23,Position closed,NSDQ100/USD," 356,58 ",0.345161," 6,58 "," 5.856,88 "," 5.256,90 ",2837309987,CFD," 0,00 "
22/10/2024 16:36:50,Open Position,NSDQ100/USD," 349,99 ",0.344991," 0,00 "," 5.856,88 "," 4.906,91 ",2837314479,CFD," 0,00 "
22/10/2024 16:47:54,Position closed,NSDQ100/USD," 351,18 ",0.344991," 1,19 "," 5.858,07 "," 5.258,09 ",2837314479,CFD," 0,00 "
22/10/2024 16:58:31,Position closed,NSDQ100/USD," 307,12 ",0.295252," 7,13 "," 5.865,20 "," 5.565,21 ",2837244249,CFD," 0,00 "
22/10/2024 17:43:52,Open Position,NSDQ100/USD," 399,99 ",0.392599," 0,00 "," 5.865,20 "," 5.165,22 ",2837358046,CFD," 0,00 "
22/10/2024 17:44:49,Open Position,NSDQ100/USD," 399,99 ",0.392589," 0,00 "," 5.865,20 "," 4.765,23 ",2837358480,CFD," 0,00 "
22/10/2024 17:46:05,Open Position,NSDQ100/USD," 399,99 ",0.392458," 0,00 "," 5.865,20 "," 4.365,24 ",2837359063,CFD," 0,00 "
22/10/2024 18:10:31,Open Position,NSDQ100/USD," 500,00 ",0.490003," 0,00 "," 5.865,20 "," 3.865,24 ",2837379736,CFD," 0,00 "
22/10/2024 18:21:21,Position closed,NSDQ100/USD," 508,79 ",0.490003," 8,79 "," 5.873,99 "," 4.374,03 ",2837379736,CFD," 0,00 "
22/10/2024 18:25:26,Open Position,NSDQ100/USD," 399,99 ",0.392185," 0,00 "," 5.873,99 "," 3.974,04 ",2837386689,CFD," 0,00 "
22/10/2024 19:28:18,Position closed,NSDQ100/USD," 404,08 ",0.392185," 4,09 "," 5.878,08 "," 4.378,12 ",2837386689,CFD," 0,00 "
22/10/2024 19:40:03,Open Position,NSDQ100/USD," 800,00 ",0.784936," 0,00 "," 5.878,08 "," 3.578,12 ",2837433463,CFD," 0,00 "
22/10/2024 19:56:22,Open Position,NSDQ100/USD," 300,00 ",0.294002," 0,00 "," 5.878,08 "," 3.278,12 ",2837441807,CFD," 0,00 "
22/10/2024 20:16:49,Position closed,NSDQ100/USD," 313,58 ",0.294002," 13,58 "," 5.891,66 "," 3.591,70 ",2837441807,CFD," 0,00 "
22/10/2024 20:16:55,Position closed,NSDQ100/USD," 405,84 ",0.392599," 5,85 "," 5.897,51 "," 3.997,54 ",2837358046,CFD," 0,00 "
22/10/2024 20:16:59,Position closed,NSDQ100/USD," 405,45 ",0.392589," 5,46 "," 5.902,97 "," 4.402,99 ",2837358480,CFD," 0,00 "
22/10/2024 20:17:05,Position closed,NSDQ100/USD," 408,04 ",0.392458," 8,05 "," 5.911,02 "," 4.811,03 ",2837359063,CFD," 0,00 "
22/10/2024 20:17:53,Position closed,NSDQ100/USD," 816,48 ",0.784936," 16,48 "," 5.927,50 "," 5.627,51 ",2837433463,CFD," 0,00 "
22/10/2024 20:22:58,Open Position,NSDQ100/USD," 599,99 ",0.589403," 0,00 "," 5.927,50 "," 5.027,52 ",2837447020,CFD," 0,00 "
22/10/2024 20:23:40,Open Position,NSDQ100/USD," 249,99 ",0.245584," 0,00 "," 5.927,50 "," 4.777,53 ",2837447066,CFD," 0,00 "
22/10/2024 20:24:16,Open Position,NSDQ100/USD," 299,99 ",0.294701," 0,00 "," 5.927,50 "," 4.477,54 ",2837447100,CFD," 0,00 "
23/10/2024 00:48:36,Overnight fee,Daily,"(0,02)",-,"(0,02)"," 5.927,48 "," 4.477,52 ",2837447100,CFD," 0,00 "
23/10/2024 00:48:36,Overnight fee,Daily,"(0,02)",-,"(0,02)"," 5.927,46 "," 4.477,50 ",2837447066,CFD," 0,00 "
23/10/2024 00:48:36,Overnight fee,Daily,"(0,05)",-,"(0,05)"," 5.927,41 "," 4.477,45 ",2837447020,CFD," 0,00 "
23/10/2024 06:30:39,Position closed,NSDQ100/USD," 251,87 ",0.245584," 1,88 "," 5.929,29 "," 4.729,32 ",2837447066,CFD," 0,00 "
23/10/2024 06:30:39,Position closed,NSDQ100/USD," 302,24 ",0.294701," 2,25 "," 5.931,54 "," 5.031,56 ",2837447100,CFD," 0,00 "
23/10/2024 06:30:39,Position closed,NSDQ100/USD," 604,50 ",0.589403," 4,51 "," 5.936,05 "," 5.636,06 ",2837447020,CFD," 0,00 "
23/10/2024 06:32:13,Open Position,NSDQ100/USD," 199,99 ",0.196564," 0,00 "," 5.936,05 "," 5.436,07 ",2837482249,CFD," 0,00 "
23/10/2024 07:11:02,Position closed,NSDQ100/USD," 202,52 ",0.196564," 2,53 "," 5.938,58 "," 5.638,59 ",2837482249,CFD," 0,00 "
23/10/2024 07:22:00,Open Position,NSDQ100/USD," 400,00 ",0.392526," 0,00 "," 5.938,58 "," 5.238,59 ",2837513861,CFD," 0,00 "
23/10/2024 07:30:13,Position closed,NSDQ100/USD," 402,65 ",0.392526," 2,65 "," 5.941,23 "," 5.641,24 ",2837513861,CFD," 0,00 "
23/10/2024 07:31:41,Open Position,NSDQ100/USD," 299,99 ",0.294575," 0,00 "," 5.941,23 "," 5.341,25 ",2837517147,CFD," 0,00 "
23/10/2024 07:44:42,Position closed,NSDQ100/USD," 301,98 ",0.294575," 1,99 "," 5.943,22 "," 5.643,23 ",2837517147,CFD," 0,00 "
23/10/2024 07:46:44,Open Position,NSDQ100/USD," 400,00 ",0.392966," 0,00 "," 5.943,22 "," 5.243,23 ",2837527495,CFD," 0,00 "
23/10/2024 07:50:52,Position closed,NSDQ100/USD," 399,90 ",0.392966,"(0,10)"," 5.943,12 "," 5.643,13 ",2837527495,CFD," 0,00 "
23/10/2024 07:52:58,Open Position,NSDQ100/USD," 199,99 ",0.196490," 0,00 "," 5.943,12 "," 5.443,14 ",2837528555,CFD," 0,00 "
23/10/2024 08:30:08,Open Position,NSDQ100/USD," 250,00 ",0.245598," 0,00 "," 5.943,12 "," 5.193,14 ",2837535298,CFD," 0,00 "
23/10/2024 09:01:34,Open Position,NSDQ100/USD," 149,99 ",0.147481," 0,00 "," 5.943,12 "," 5.043,15 ",2837542019,CFD," 0,00 "
23/10/2024 09:07:15,Position closed,NSDQ100/USD," 150,19 ",0.147481," 0,20 "," 5.943,32 "," 5.193,34 ",2837542019,CFD," 0,00 "
23/10/2024 09:07:25,Position closed,NSDQ100/USD," 246,30 ",0.245598,"(3,70)"," 5.939,62 "," 5.439,64 ",2837535298,CFD," 0,00 "
23/10/2024 11:12:41,Open Position,NSDQ100/USD," 350,00 ",0.344313," 0,00 "," 5.939,62 "," 5.089,64 ",2837570175,CFD," 0,00 "
23/10/2024 11:46:47,Open Position,NSDQ100/USD," 250,00 ",0.246055," 0,00 "," 5.939,62 "," 4.839,64 ",2837576820,CFD," 0,00 "
23/10/2024 12:07:49,Open Position,NSDQ100/USD," 300,00 ",0.295275," 0,00 "," 5.939,62 "," 4.539,64 ",2837582724,CFD," 0,00 "
23/10/2024 12:18:20,Position closed,NSDQ100/USD," 351,87 ",0.344313," 1,87 "," 5.941,49 "," 4.891,51 ",2837570175,CFD," 0,00 "
23/10/2024 12:18:42,Position closed,NSDQ100/USD," 254,07 ",0.246055," 4,07 "," 5.945,56 "," 5.145,58 ",2837576820,CFD," 0,00 "
23/10/2024 12:18:57,Position closed,NSDQ100/USD," 304,94 ",0.295275," 4,94 "," 5.950,50 "," 5.450,52 ",2837582724,CFD," 0,00 "
23/10/2024 12:20:22,Open Position,NSDQ100/USD," 299,99 ",0.295027," 0,00 "," 5.950,50 "," 5.150,53 ",2837585207,CFD," 0,00 "
23/10/2024 12:20:50,Position closed,NSDQ100/USD," 300,71 ",0.295027," 0,72 "," 5.951,22 "," 5.451,24 ",2837585207,CFD," 0,00 "
23/10/2024 13:24:39,Open Position,NSDQ100/USD," 350,00 ",0.345250," 0,00 "," 5.951,22 "," 5.101,24 ",2837601678,CFD," 0,00 "
23/10/2024 13:25:09,Open Position,NSDQ100/USD," 500,00 ",0.493120," 0,00 "," 5.951,22 "," 4.601,24 ",2837601807,CFD," 0,00 "
23/10/2024 13:25:55,Open Position,NSDQ100/USD," 350,00 ",0.345148," 0,00 "," 5.951,22 "," 4.251,24 ",2837602104,CFD," 0,00 "
23/10/2024 13:31:07,Position closed,NSDQ100/USD," 355,32 ",0.345148," 5,32 "," 5.956,54 "," 4.606,56 ",2837602104,CFD," 0,00 "
23/10/2024 13:31:08,Position closed,NSDQ100/USD," 355,32 ",0.345250," 5,32 "," 5.961,86 "," 4.961,88 ",2837601678,CFD," 0,00 "
23/10/2024 13:31:08,Position closed,NSDQ100/USD," 507,01 ",0.493120," 7,01 "," 5.968,87 "," 5.468,89 ",2837601807,CFD," 0,00 "
23/10/2024 13:32:05,Open Position,NSDQ100/USD," 499,99 ",0.492851," 0,00 "," 5.968,87 "," 4.968,90 ",2837668429,CFD," 0,00 "
23/10/2024 13:32:21,Position closed,NSDQ100/USD," 501,70 ",0.492851," 1,71 "," 5.970,58 "," 5.470,60 ",2837668429,CFD," 0,00 "
23/10/2024 13:32:54,Open Position,NSDQ100/USD," 350,00 ",0.345234," 0,00 "," 5.970,58 "," 5.120,60 ",2837671061,CFD," 0,00 "
23/10/2024 13:34:18,Open Position,NSDQ100/USD," 299,99 ",0.295905," 0,00 "," 5.970,58 "," 4.820,61 ",2837674680,CFD," 0,00 "
23/10/2024 13:36:44,Position closed,NSDQ100/USD," 353,09 ",0.345234," 3,09 "," 5.973,67 "," 5.173,70 ",2837671061,CFD," 0,00 "
23/10/2024 13:36:57,Position closed,NSDQ100/USD," 302,29 ",0.295905," 2,30 "," 5.975,97 "," 5.475,99 ",2837674680,CFD," 0,00 "
23/10/2024 13:37:24,Open Position,NSDQ100/USD," 299,99 ",0.295824," 0,00 "," 5.975,97 "," 5.176,00 ",2837681700,CFD," 0,00 "
23/10/2024 13:42:18,Position closed,NSDQ100/USD," 300,07 ",0.295824," 0,08 "," 5.976,05 "," 5.476,07 ",2837681700,CFD," 0,00 "
23/10/2024 13:48:09,Open Position,NSDQ100/USD," 400,00 ",0.394308," 0,00 "," 5.976,05 "," 5.076,07 ",2837703857,CFD," 0,00 "
23/10/2024 13:52:38,Open Position,NSDQ100/USD," 299,99 ",0.295894," 0,00 "," 5.976,05 "," 4.776,08 ",2837767018,CFD," 0,00 "
23/10/2024 13:56:48,Position closed,NSDQ100/USD," 301,55 ",0.295894," 1,56 "," 5.977,61 "," 5.077,63 ",2837767018,CFD," 0,00 "
23/10/2024 13:57:35,Open Position,NSDQ100/USD," 400,00 ",0.394341," 0,00 "," 5.977,61 "," 4.677,63 ",2837773024,CFD," 0,00 "
23/10/2024 14:11:02,Open Position,NSDQ100/USD," 799,99 ",0.790886," 0,00 "," 5.977,61 "," 3.877,64 ",2837799210,CFD," 0,00 "
23/10/2024 14:11:14,Open Position,NSDQ100/USD," 799,99 ",0.790444," 0,00 "," 5.977,61 "," 3.077,65 ",2837799418,CFD," 0,00 "
23/10/2024 14:11:23,Open Position,NSDQ100/USD," 499,99 ",0.493971," 0,00 "," 5.977,61 "," 2.577,66 ",2837799958,CFD," 0,00 "
23/10/2024 14:11:40,Position closed,NSDQ100/USD," 807,08 ",0.790886," 7,09 "," 5.984,70 "," 3.384,74 ",2837799210,CFD," 0,00 "
23/10/2024 14:12:19,Position closed,NSDQ100/USD," 801,54 ",0.790444," 1,55 "," 5.986,25 "," 4.186,28 ",2837799418,CFD," 0,00 "
23/10/2024 14:13:59,Open Position,NSDQ100/USD," 700,00 ",0.691673," 0,00 "," 5.986,25 "," 3.486,28 ",2837805929,CFD," 0,00 "
23/10/2024 14:14:38,Position closed,NSDQ100/USD," 700,46 ",0.691673," 0,46 "," 5.986,71 "," 4.186,74 ",2837805929,CFD," 0,00 "
23/10/2024 14:14:56,Position closed,NSDQ100/USD," 502,64 ",0.493971," 2,65 "," 5.989,36 "," 4.689,38 ",2837799958,CFD," 0,00 "
23/10/2024 14:15:27,Open Position,NSDQ100/USD," 600,00 ",0.592731," 0,00 "," 5.989,36 "," 4.089,38 ",2837808372,CFD," 0,00 "
23/10/2024 14:18:17,Open Position,NSDQ100/USD," 400,00 ",0.395296," 0,00 "," 5.989,36 "," 3.689,38 ",2837813108,CFD," 0,00 "
23/10/2024 14:47:23,Position closed,NSDQ100/USD," 632,70 ",0.592731," 32,70 "," 6.022,06 "," 4.322,08 ",2837808372,CFD," 0,00 "
23/10/2024 14:47:24,Position closed,NSDQ100/USD," 405,27 ",0.394308," 5,27 "," 6.027,33 "," 4.727,35 ",2837703857,CFD," 0,00 "
23/10/2024 14:47:24,Position closed,NSDQ100/USD," 405,94 ",0.394341," 5,94 "," 6.033,27 "," 5.133,29 ",2837773024,CFD," 0,00 "
23/10/2024 14:47:24,Position closed,NSDQ100/USD," 425,32 ",0.395296," 25,32 "," 6.058,59 "," 5.558,61 ",2837813108,CFD," 0,00 "
23/10/2024 14:53:17,Open Position,NSDQ100/USD," 299,99 ",0.296163," 0,00 "," 6.058,59 "," 5.258,62 ",2837864513,CFD," 0,00 "
23/10/2024 14:53:55,Open Position,NSDQ100/USD," 299,99 ",0.296070," 0,00 "," 6.058,59 "," 4.958,63 ",2837864985,CFD," 0,00 "
23/10/2024 14:57:52,Open Position,NSDQ100/USD," 299,99 ",0.296312," 0,00 "," 6.058,59 "," 4.658,64 ",2837872497,CFD," 0,00 "
23/10/2024 15:03:47,Open Position,NSDQ100/USD," 350,00 ",0.345601," 0,00 "," 6.058,59 "," 4.308,64 ",2837878696,CFD," 0,00 "
23/10/2024 15:04:22,Position closed,NSDQ100/USD," 303,36 ",0.296312," 3,37 "," 6.061,96 "," 4.612,00 ",2837872497,CFD," 0,00 "
23/10/2024 15:04:26,Position closed,NSDQ100/USD," 352,82 ",0.345601," 2,82 "," 6.064,78 "," 4.964,82 ",2837878696,CFD," 0,00 "
23/10/2024 15:04:35,Open Position,NSDQ100/USD," 350,00 ",0.345483," 0,00 "," 6.064,78 "," 4.614,82 ",2837879758,CFD," 0,00 "
23/10/2024 15:15:12,Open Position,NSDQ100/USD," 799,99 ",0.792598," 0,00 "," 6.064,78 "," 3.814,83 ",2837890287,CFD," 0,00 "
23/10/2024 15:15:44,Open Position,NSDQ100/USD," 499,98 ",0.495435," 0,00 "," 6.064,78 "," 3.314,85 ",2837891020,CFD," 0,00 "
23/10/2024 15:15:58,Open Position,NSDQ100/USD," 299,99 ",0.297194," 0,00 "," 6.064,78 "," 3.014,86 ",2837891193,CFD," 0,00 "
23/10/2024 15:16:47,Open Position,NSDQ100/USD," 299,99 ",0.297133," 0,00 "," 6.064,78 "," 2.714,87 ",2837892328,CFD," 0,00 "
23/10/2024 15:17:32,Open Position,NSDQ100/USD," 250,00 ",0.247586," 0,00 "," 6.064,78 "," 2.464,87 ",2837893402,CFD," 0,00 "
23/10/2024 15:45:20,Open Position,NSDQ100/USD," 250,00 ",0.247564," 0,00 "," 6.064,78 "," 2.214,87 ",2837926389,CFD," 0,00 "
23/10/2024 15:57:48,Position closed,NSDQ100/USD," 808,45 ",0.792598," 8,46 "," 6.073,24 "," 3.023,32 ",2837890287,CFD," 0,00 "
23/10/2024 15:58:09,Position closed,NSDQ100/USD," 505,51 ",0.495435," 5,53 "," 6.078,77 "," 3.528,83 ",2837891020,CFD," 0,00 "
23/10/2024 16:26:06,Open Position,NSDQ100/USD," 599,99 ",0.596176," 0,00 "," 6.078,77 "," 2.928,84 ",2837953732,CFD," 0,00 "
23/10/2024 16:26:24,Open Position,NSDQ100/USD," 599,99 ",0.596081," 0,00 "," 6.078,77 "," 2.328,85 ",2837953862,CFD," 0,00 "
23/10/2024 16:26:33,Open Position,NSDQ100/USD," 200,00 ",0.198720," 0,00 "," 6.078,77 "," 2.128,85 ",2837953914,CFD," 0,00 "
23/10/2024 16:31:15,Position closed,TSLA/USD," 304,96 ",6.957454," 4,97 "," 6.083,74 "," 2.433,81 ",2837242579,CFD," 0,00 "
23/10/2024 16:46:56,Open Position,NSDQ100/USD," 609,99 ",0.606275," 0,00 "," 6.083,74 "," 1.823,82 ",2837967628,CFD," 0,00 "
23/10/2024 16:49:06,Open Position,NSDQ100/USD," 499,99 ",0.496900," 0,00 "," 6.083,74 "," 1.323,83 ",2837969204,CFD," 0,00 "
23/10/2024 17:02:43,Open Position,NSDQ100/USD," 339,99 ",0.338894," 0,00 "," 6.083,74 "," 983,84 ",2837981195,CFD," 0,00 "
23/10/2024 17:16:44,Open Position,NSDQ100/USD," 400,00 ",0.399409," 0,00 "," 6.083,74 "," 583,84 ",2837993976,CFD," 0,00 "
23/10/2024 17:28:36,Position closed,NSDQ100/USD," 402,32 ",0.399409," 2,32 "," 6.086,06 "," 986,16 ",2837993976,CFD," 0,00 "
23/10/2024 17:34:22,Open Position,NSDQ100/USD," 400,00 ",0.399533," 0,00 "," 6.086,06 "," 586,16 ",2838021399,CFD," 0,00 "
23/10/2024 17:43:00,Open Position,NSDQ100/USD," 350,00 ",0.349818," 0,00 "," 6.086,06 "," 236,16 ",2838040158,CFD," 0,00 "
23/10/2024 17:56:12,Open Position,NSDQ100/USD," 99,99 ",0.100099," 0,00 "," 6.086,06 "," 136,17 ",2838049483,CFD," 0,00 "
23/10/2024 18:28:08,Position closed,NSDQ100/USD," 99,96 ",0.100099,"(0,03)"," 6.086,03 "," 236,13 ",2838049483,CFD," 0,00 "
23/10/2024 18:34:24,Position closed,NSDQ100/USD," 343,25 ",0.349818,"(6,75)"," 6.079,28 "," 579,38 ",2838040158,CFD," 0,00 "
23/10/2024 18:41:21,Position closed,NSDQ100/USD," 397,20 ",0.399533,"(2,80)"," 6.076,48 "," 976,58 ",2838021399,CFD," 0,00 "
23/10/2024 19:03:06,Open Position,TSLA/USD," 399,99 ",9.377361," 0,00 "," 6.076,48 "," 576,59 ",2838140931,CFD," 0,00 "
23/10/2024 19:07:38,Position closed,NSDQ100/USD," 323,92 ",0.338894,"(16,07)"," 6.060,41 "," 900,51 ",2837981195,CFD," 0,00 "
23/10/2024 19:08:23,Open Position,TSLA/USD," 399,99 ",9.379996," 0,00 "," 6.060,41 "," 500,52 ",2838144262,CFD," 0,00 "
23/10/2024 19:09:17,Open Position,TSLA/USD," 199,98 ",4.692414," 0,00 "," 6.060,41 "," 300,54 ",2838144927,CFD," 0,00 "
23/10/2024 19:26:29,Position closed,NSDQ100/USD," 453,52 ",0.496900,"(46,47)"," 6.013,94 "," 754,06 ",2837969204,CFD," 0,00 "
23/10/2024 19:26:37,Position closed,NSDQ100/USD," 554,57 ",0.606275,"(55,42)"," 5.958,52 "," 1.308,63 ",2837967628,CFD," 0,00 "
23/10/2024 19:27:02,Position closed,NSDQ100/USD," 182,15 ",0.198720,"(17,85)"," 5.940,67 "," 1.490,78 ",2837953914,CFD," 0,00 "
23/10/2024 19:27:32,Position closed,NSDQ100/USD," 547,94 ",0.596176,"(52,05)"," 5.888,62 "," 2.038,72 ",2837953732,CFD," 0,00 "
23/10/2024 19:32:01,Position closed,NSDQ100/USD," 536,14 ",0.596081,"(63,85)"," 5.824,77 "," 2.574,86 ",2837953862,CFD," 0,00 "
23/10/2024 19:32:24,Open Position,TSLA/USD," 599,99 ",14.066702," 0,00 "," 5.824,77 "," 1.974,87 ",2838159555,CFD," 0,00 "
23/10/2024 20:10:20,Open Position,NSDQ100/USD," 600,00 ",0.597023," 0,00 "," 5.824,77 "," 1.374,87 ",2838180767,CFD," 0,00 "
23/10/2024 20:13:24,Open Position,NSDQ100/USD," 599,99 ",0.596886," 0,00 "," 5.824,77 "," 774,88 ",2838181235,CFD," 0,00 "
23/10/2024 20:20:21,Position closed,NSDQ100/USD," 617,90 ",0.597023," 17,90 "," 5.842,67 "," 1.392,78 ",2838180767,CFD," 0,00 "
23/10/2024 20:20:54,Open Position,NSDQ100/USD," 500,00 ",0.496731," 0,00 "," 5.842,67 "," 892,78 ",2838182157,CFD," 0,00 "
23/10/2024 20:23:07,Open Position,NSDQ100/USD," 500,00 ",0.496598," 0,00 "," 5.842,67 "," 392,78 ",2838182394,CFD," 0,00 "
23/10/2024 20:39:45,Position closed,NSDQ100/USD," 619,20 ",0.596886," 19,21 "," 5.861,88 "," 1.011,98 ",2838181235,CFD," 0,00 "
23/10/2024 20:45:06,Open Position,NSDQ100/USD," 500,00 ",0.496598," 0,00 "," 5.861,88 "," 511,98 ",2838184585,CFD," 0,00 "
23/10/2024 22:03:34,Position closed,NSDQ100/USD," 502,28 ",0.496731," 2,28 "," 5.864,16 "," 1.014,26 ",2838182157,CFD," 0,00 "
23/10/2024 22:29:08,Open Position,NSDQ100/USD," 500,00 ",0.496541," 0,00 "," 5.864,16 "," 514,26 ",2838190393,CFD," 0,00 "
24/10/2024 00:48:53,Overnight fee,Daily,"(1,01)",-,"(1,01)"," 5.863,15 "," 513,25 ",2837528555,CFD," 0,00 "
24/10/2024 00:48:53,Overnight fee,Daily,"(1,27)",-,"(1,27)"," 5.861,88 "," 511,98 ",2837926389,CFD," 0,00 "
24/10/2024 00:48:53,Overnight fee,Daily,"(1,27)",-,"(1,27)"," 5.860,61 "," 510,71 ",2837893402,CFD," 0,00 "
24/10/2024 00:48:53,Overnight fee,Daily,"(1,52)",-,"(1,52)"," 5.859,09 "," 509,19 ",2837864985,CFD," 0,00 "
24/10/2024 00:48:53,Overnight fee,Daily,"(1,52)",-,"(1,52)"," 5.857,57 "," 507,67 ",2837864513,CFD," 0,00 "
24/10/2024 00:48:53,Overnight fee,Daily,"(1,53)",-,"(1,53)"," 5.856,04 "," 506,14 ",2837891193,CFD," 0,00 "
24/10/2024 00:48:53,Overnight fee,Daily,"(1,53)",-,"(1,53)"," 5.854,51 "," 504,61 ",2837892328,CFD," 0,00 "
24/10/2024 00:48:53,Overnight fee,Daily,"(1,78)",-,"(1,78)"," 5.852,73 "," 502,83 ",2837879758,CFD," 0,00 "
24/10/2024 00:48:53,Overnight fee,Daily,"(2,56)",-,"(2,56)"," 5.850,17 "," 500,27 ",2838182157,CFD," 0,00 "
24/10/2024 00:48:53,Overnight fee,Daily,"(2,56)",-,"(2,56)"," 5.847,61 "," 497,71 ",2838182394,CFD," 0,00 "
24/10/2024 00:48:53,Overnight fee,Daily,"(2,56)",-,"(2,56)"," 5.845,05 "," 495,15 ",2838184585,CFD," 0,00 "
24/10/2024 05:30:56,Position closed,NSDQ100/USD," 509,28 ",0.496541," 9,28 "," 5.854,33 "," 1.004,43 ",2838190393,CFD," 0,00 "
24/10/2024 05:31:07,Position closed,NSDQ100/USD," 510,96 ",0.496598," 10,96 "," 5.865,29 "," 1.515,39 ",2838184585,CFD," 0,00 "
24/10/2024 05:31:14,Position closed,NSDQ100/USD," 511,66 ",0.496598," 11,66 "," 5.876,95 "," 2.027,05 ",2838182394,CFD," 0,00 "
24/10/2024 05:33:32,Open Position,NSDQ100/USD," 510,00 ",0.505643," 0,00 "," 5.876,95 "," 1.517,05 ",2838211789,CFD," 0,00 "
24/10/2024 05:33:45,Open Position,NSDQ100/USD," 379,99 ",0.376757," 0,00 "," 5.876,95 "," 1.137,06 ",2838211801,CFD," 0,00 "
24/10/2024 07:13:32,Position closed,NSDQ100/USD," 389,89 ",0.376757," 9,90 "," 5.886,85 "," 1.526,95 ",2838211801,CFD," 0,00 "
24/10/2024 07:13:56,Position closed,NSDQ100/USD," 523,18 ",0.505643," 13,18 "," 5.900,03 "," 2.050,13 ",2838211789,CFD," 0,00 "
24/10/2024 07:15:05,Position closed,NSDQ100/USD," 304,03 ",0.297194," 4,04 "," 5.904,07 "," 2.354,16 ",2837891193,CFD," 0,00 "
24/10/2024 07:17:21,Position closed,NSDQ100/USD," 307,75 ",0.297133," 7,76 "," 5.911,83 "," 2.661,91 ",2837892328,CFD," 0,00 "
24/10/2024 07:17:25,Position closed,NSDQ100/USD," 255,92 ",0.247586," 5,92 "," 5.917,75 "," 2.917,83 ",2837893402,CFD," 0,00 "
24/10/2024 07:17:32,Position closed,NSDQ100/USD," 255,60 ",0.247564," 5,60 "," 5.923,35 "," 3.173,43 ",2837926389,CFD," 0,00 "
24/10/2024 07:21:04,Open Position,NSDQ100/USD," 500,00 ",0.494657," 0,00 "," 5.923,35 "," 2.673,43 ",2838247007,CFD," 0,00 "
24/10/2024 07:29:14,Position closed,NSDQ100/USD," 504,63 ",0.494657," 4,63 "," 5.927,98 "," 3.178,06 ",2838247007,CFD," 0,00 "
24/10/2024 07:29:24,Open Position,NSDQ100/USD," 1.000,00 ",0.988757," 0,00 "," 5.927,98 "," 2.178,06 ",2838250714,CFD," 0,00 "
24/10/2024 07:29:39,Open Position,NSDQ100/USD," 500,00 ",0.494368," 0,00 "," 5.927,98 "," 1.678,06 ",2838250748,CFD," 0,00 "
24/10/2024 07:31:29,Position closed,NSDQ100/USD," 1.000,96 ",0.988757," 0,96 "," 5.928,94 "," 2.679,02 ",2838250714,CFD," 0,00 "
24/10/2024 07:35:50,Position closed,NSDQ100/USD," 500,13 ",0.494368," 0,13 "," 5.929,07 "," 3.179,15 ",2838250748,CFD," 0,00 "
24/10/2024 07:36:20,Open Position,NSDQ100/USD," 600,00 ",0.593137," 0,00 "," 5.929,07 "," 2.579,15 ",2838252829,CFD," 0,00 "
24/10/2024 07:36:35,Open Position,NSDQ100/USD," 300,00 ",0.296553," 0,00 "," 5.929,07 "," 2.279,15 ",2838252868,CFD," 0,00 "
24/10/2024 07:50:56,Open Position,NSDQ100/USD," 1.000,00 ",0.988185," 0,00 "," 5.929,07 "," 1.279,15 ",2838255793,CFD," 0,00 "
24/10/2024 07:51:16,Open Position,NSDQ100/USD," 199,99 ",0.197638," 0,00 "," 5.929,07 "," 1.079,16 ",2838255850,CFD," 0,00 "
24/10/2024 08:41:25,Position closed,NSDQ100/USD," 602,41 ",0.593137," 2,41 "," 5.931,48 "," 1.681,57 ",2838252829,CFD," 0,00 "
24/10/2024 08:42:36,Open Position,NSDQ100/USD," 590,00 ",0.583165," 0,00 "," 5.931,48 "," 1.091,57 ",2838266632,CFD," 0,00 "
24/10/2024 08:54:18,Open Position,NSDQ100/USD," 300,00 ",0.296898," 0,00 "," 5.931,48 "," 791,57 ",2838268962,CFD," 0,00 "
24/10/2024 09:04:40,Position closed,NSDQ100/USD," 302,72 ",0.296898," 2,72 "," 5.934,20 "," 1.094,29 ",2838268962,CFD," 0,00 "
24/10/2024 10:34:38,Position closed,NSDQ100/USD," 301,06 ",0.296553," 1,06 "," 5.935,26 "," 1.395,35 ",2838252868,CFD," 0,00 "
24/10/2024 10:34:51,Open Position,NSDQ100/USD," 300,00 ",0.296473," 0,00 "," 5.935,26 "," 1.095,35 ",2838285254,CFD," 0,00 "
24/10/2024 10:41:08,Position closed,NSDQ100/USD," 594,30 ",0.583165," 4,30 "," 5.939,56 "," 1.689,65 ",2838266632,CFD," 0,00 "
24/10/2024 10:41:15,Position closed,NSDQ100/USD," 1.001,74 ",0.988185," 1,74 "," 5.941,30 "," 2.691,39 ",2838255793,CFD," 0,00 "
24/10/2024 10:43:41,Open Position,NSDQ100/USD," 590,00 ",0.582885," 0,00 "," 5.941,30 "," 2.101,39 ",2838286586,CFD," 0,00 "
24/10/2024 10:54:55,Open Position,NSDQ100/USD," 590,00 ",0.583165," 0,00 "," 5.941,30 "," 1.511,39 ",2838288533,CFD," 0,00 "
24/10/2024 11:10:49,Position closed,NSDQ100/USD," 601,06 ",0.583165," 11,06 "," 5.952,36 "," 2.112,45 ",2838288533,CFD," 0,00 "
24/10/2024 11:10:55,Position closed,NSDQ100/USD," 594,81 ",0.582885," 4,81 "," 5.957,17 "," 2.707,26 ",2838286586,CFD," 0,00 "
24/10/2024 11:11:03,Position closed,NSDQ100/USD," 303,75 ",0.296473," 3,75 "," 5.960,92 "," 3.011,01 ",2838285254,CFD," 0,00 "
24/10/2024 11:11:20,Position closed,NSDQ100/USD," 201,94 ",0.197638," 1,95 "," 5.962,87 "," 3.212,95 ",2838255850,CFD," 0,00 "
24/10/2024 11:12:19,Open Position,NSDQ100/USD," 590,00 ",0.582669," 0,00 "," 5.962,87 "," 2.622,95 ",2838291342,CFD," 0,00 "
24/10/2024 11:12:24,Open Position,NSDQ100/USD," 590,00 ",0.582663," 0,00 "," 5.962,87 "," 2.032,95 ",2838291354,CFD," 0,00 "
24/10/2024 11:15:39,Open Position,NSDQ100/USD," 350,00 ",0.345825," 0,00 "," 5.962,87 "," 1.682,95 ",2838291951,CFD," 0,00 "
24/10/2024 12:18:00,Position closed,NSDQ100/USD," 593,30 ",0.582669," 3,30 "," 5.966,17 "," 2.276,25 ",2838291342,CFD," 0,00 "
24/10/2024 12:18:08,Position closed,NSDQ100/USD," 348,48 ",0.345483,"(1,52)"," 5.964,65 "," 2.624,73 ",2837879758,CFD," 0,00 "
24/10/2024 12:18:21,Position closed,NSDQ100/USD," 354,86 ",0.345825," 4,86 "," 5.969,51 "," 2.979,59 ",2838291951,CFD," 0,00 "
24/10/2024 12:18:25,Position closed,NSDQ100/USD," 591,90 ",0.582663," 1,90 "," 5.971,41 "," 3.571,49 ",2838291354,CFD," 0,00 "
24/10/2024 12:19:49,Open Position,NSDQ100/USD," 500,00 ",0.493568," 0,00 "," 5.971,41 "," 3.071,49 ",2838304154,CFD," 0,00 "
24/10/2024 12:19:56,Open Position,NSDQ100/USD," 500,00 ",0.493585," 0,00 "," 5.971,41 "," 2.571,49 ",2838304171,CFD," 0,00 "
24/10/2024 12:35:07,Open Position,NSDQ100/USD," 600,00 ",0.592121," 0,00 "," 5.971,41 "," 1.971,49 ",2838306659,CFD," 0,00 "
24/10/2024 12:35:20,Open Position,NSDQ100/USD," 300,00 ",0.296054," 0,00 "," 5.971,41 "," 1.671,49 ",2838306688,CFD," 0,00 "
24/10/2024 12:35:28,Open Position,NSDQ100/USD," 300,00 ",0.296031," 0,00 "," 5.971,41 "," 1.371,49 ",2838306714,CFD," 0,00 "
24/10/2024 12:35:47,Open Position,NSDQ100/USD," 399,99 ",0.394654," 0,00 "," 5.971,41 "," 971,50 ",2838306753,CFD," 0,00 "
24/10/2024 13:30:06,Position closed,TSLA/USD," 99,94 ",9.377361,"(300,05)"," 5.671,36 "," 1.071,44 ",2838140931,CFD," 0,00 "
24/10/2024 13:30:06,Position closed,TSLA/USD," 149,75 ",14.066702,"(450,24)"," 5.221,12 "," 1.221,19 ",2838159555,CFD," 0,00 "
24/10/2024 13:30:17,Position closed,TSLA/USD," 101,26 ",9.379996,"(298,73)"," 4.922,39 "," 1.322,45 ",2838144262,CFD," 0,00 "
24/10/2024 13:30:17,Position closed,TSLA/USD," 49,98 ",4.692414,"(150,00)"," 4.772,39 "," 1.372,43 ",2838144927,CFD," 0,00 "
24/10/2024 13:32:40,Open Position,NSDQ100/USD," 499,99 ",0.495631," 0,00 "," 4.772,39 "," 872,44 ",2838380439,CFD," 0,00 "
24/10/2024 13:33:41,Open Position,NSDQ100/USD," 449,98 ",0.445930," 0,00 "," 4.772,39 "," 422,46 ",2838382756,CFD," 0,00 "
24/10/2024 13:34:29,Position closed,NSDQ100/USD," 504,68 ",0.495631," 4,69 "," 4.777,08 "," 927,14 ",2838380439,CFD," 0,00 "
24/10/2024 13:34:52,Position closed,NSDQ100/USD," 450,28 ",0.445930," 0,30 "," 4.777,38 "," 1.377,42 ",2838382756,CFD," 0,00 "
24/10/2024 13:35:32,Open Position,NSDQ100/USD," 499,98 ",0.494922," 0,00 "," 4.777,38 "," 877,44 ",2838387135,CFD," 0,00 "
24/10/2024 13:35:44,Open Position,NSDQ100/USD," 200,00 ",0.198026," 0,00 "," 4.777,38 "," 677,44 ",2838387566,CFD," 0,00 "
24/10/2024 13:59:44,Open Position,NSDQ100/USD," 299,99 ",0.297286," 0,00 "," 4.777,38 "," 377,45 ",2838505145,CFD," 0,00 "
24/10/2024 14:06:55,Position closed,NSDQ100/USD," 303,13 ",0.297286," 3,14 "," 4.780,52 "," 680,58 ",2838505145,CFD," 0,00 "
24/10/2024 14:40:07,Position closed,NSDQ100/USD," 503,97 ",0.494922," 3,99 "," 4.784,51 "," 1.184,55 ",2838387135,CFD," 0,00 "
24/10/2024 14:41:48,Position closed,NSDQ100/USD," 202,43 ",0.198026," 2,43 "," 4.786,94 "," 1.386,98 ",2838387566,CFD," 0,00 "
24/10/2024 14:44:09,Open Position,NSDQ100/USD," 499,99 ",0.494643," 0,00 "," 4.786,94 "," 886,99 ",2838566336,CFD," 0,00 "
24/10/2024 15:07:27,Open Position,NSDQ100/USD," 449,99 ",0.446015," 0,00 "," 4.786,94 "," 437,00 ",2838593836,CFD," 0,00 "
24/10/2024 15:12:17,Position closed,NSDQ100/USD," 455,19 ",0.446015," 5,20 "," 4.792,14 "," 892,19 ",2838593836,CFD," 0,00 "
24/10/2024 15:13:36,Open Position,NSDQ100/USD," 459,99 ",0.455410," 0,00 "," 4.792,14 "," 432,20 ",2838600507,CFD," 0,00 "
24/10/2024 16:13:22,Open Position,NSDQ100/USD," 400,00 ",0.397658," 0,00 "," 4.792,14 "," 32,20 ",2838687800,CFD," 0,00 "
24/10/2024 16:20:12,Position closed,NSDQ100/USD," 406,16 ",0.397658," 6,16 "," 4.798,30 "," 438,36 ",2838687800,CFD," 0,00 "
24/10/2024 17:06:20,Position closed,NSDQ100/USD," 469,81 ",0.455410," 9,82 "," 4.808,12 "," 908,17 ",2838600507,CFD," 0,00 "
24/10/2024 17:06:39,Position closed,NSDQ100/USD," 505,42 ",0.494643," 5,43 "," 4.813,55 "," 1.413,59 ",2838566336,CFD," 0,00 "
24/10/2024 17:07:18,Position closed,NSDQ100/USD," 483,03 ",0.493568,"(16,97)"," 4.796,58 "," 1.896,62 ",2838304154,CFD," 0,00 "
24/10/2024 17:30:11,Open Position,NSDQ100/USD," 299,99 ",0.296903," 0,00 "," 4.796,58 "," 1.596,63 ",2838732658,CFD," 0,00 "
24/10/2024 18:02:23,Open Position,NSDQ100/USD," 350,00 ",0.346572," 0,00 "," 4.796,58 "," 1.246,63 ",2838745872,CFD," 0,00 "
24/10/2024 18:14:07,Position closed,NSDQ100/USD," 357,19 ",0.346572," 7,19 "," 4.803,77 "," 1.603,82 ",2838745872,CFD," 0,00 "
24/10/2024 18:14:11,Position closed,NSDQ100/USD," 303,01 ",0.296903," 3,02 "," 4.806,79 "," 1.906,83 ",2838732658,CFD," 0,00 "
24/10/2024 18:20:58,Open Position,NSDQ100/USD," 350,00 ",0.346057," 0,00 "," 4.806,79 "," 1.556,83 ",2838757902,CFD," 0,00 "
24/10/2024 18:51:25,Open Position,NSDQ100/USD," 350,00 ",0.346189," 0,00 "," 4.806,79 "," 1.206,83 ",2838771761,CFD," 0,00 "
24/10/2024 19:34:03,Position closed,NSDQ100/USD," 359,37 ",0.346189," 9,37 "," 4.816,16 "," 1.566,20 ",2838771761,CFD," 0,00 "
24/10/2024 19:34:33,Position closed,NSDQ100/USD," 357,85 ",0.346057," 7,85 "," 4.824,01 "," 1.924,05 ",2838757902,CFD," 0,00 "
24/10/2024 19:34:58,Position closed,NSDQ100/USD," 297,64 ",0.296163,"(2,35)"," 4.821,66 "," 2.221,69 ",2837864513,CFD," 0,00 "
24/10/2024 19:35:05,Position closed,NSDQ100/USD," 392,02 ",0.394654,"(7,97)"," 4.813,69 "," 2.613,71 ",2838306753,CFD," 0,00 "
24/10/2024 19:35:17,Position closed,NSDQ100/USD," 495,12 ",0.493585,"(4,88)"," 4.808,81 "," 3.108,83 ",2838304171,CFD," 0,00 "
24/10/2024 19:35:38,Position closed,NSDQ100/USD," 294,08 ",0.296031,"(5,92)"," 4.802,89 "," 3.402,91 ",2838306714,CFD," 0,00 "
24/10/2024 19:36:18,Position closed,NSDQ100/USD," 588,40 ",0.592121,"(11,60)"," 4.791,29 "," 3.991,31 ",2838306659,CFD," 0,00 "
24/10/2024 19:36:26,Position closed,NSDQ100/USD," 294,29 ",0.296054,"(5,71)"," 4.785,58 "," 4.285,60 ",2838306688,CFD," 0,00 "
24/10/2024 19:36:33,Position closed,NSDQ100/USD," 294,59 ",0.296070,"(5,40)"," 4.780,18 "," 4.580,19 ",2837864985,CFD," 0,00 "
24/10/2024 19:40:38,Open Position,NSDQ100/USD," 200,00 ",0.197639," 0,00 "," 4.780,18 "," 4.380,19 ",2838796726,CFD," 0,00 "
24/10/2024 20:34:31,Position closed,NSDQ100/USD," 200,30 ",0.197639," 0,30 "," 4.780,48 "," 4.580,49 ",2838796726,CFD," 0,00 "
24/10/2024 20:36:45,Position closed,NSDQ100/USD," 177,78 ",0.196490,"(22,21)"," 4.758,27 "," 4.758,27 ",2837528555,CFD," 0,00 "
24/10/2024 22:02:07,Open Position,NSDQ100/USD," 199,99 ",0.197647," 0,00 "," 4.758,27 "," 4.558,28 ",2838815248,CFD," 0,00 "
24/10/2024 22:17:36,Open Position,NSDQ100/USD," 199,99 ",0.197673," 0,00 "," 4.758,27 "," 4.358,29 ",2838816337,CFD," 0,00 "
24/10/2024 22:48:09,Position closed,NSDQ100/USD," 197,71 ",0.197647,"(2,28)"," 4.755,99 "," 4.556,00 ",2838815248,CFD," 0,00 "
24/10/2024 22:48:09,Position closed,NSDQ100/USD," 198,22 ",0.197673,"(1,77)"," 4.754,22 "," 4.754,22 ",2838816337,CFD," 0,00 "
25/10/2024 00:26:43,Index price adjustment,NSDQ100/USD," 0,06 ",-," 0,06 "," 4.754,28 "," 4.754,28 ",2837528555,CFD," 0,00 "
25/10/2024 00:26:43,Index price adjustment,NSDQ100/USD," 0,06 ",-," 0,06 "," 4.754,34 "," 4.754,34 ",2838796726,CFD," 0,00 "
25/10/2024 07:20:02,Open Position,NSDQ100/USD," 350,00 ",0.345494," 0,00 "," 4.754,34 "," 4.404,34 ",2838866776,CFD," 0,00 "
25/10/2024 08:52:23,Position closed,NSDQ100/USD," 352,96 ",0.345494," 2,96 "," 4.757,30 "," 4.757,30 ",2838866776,CFD," 0,00 "
25/10/2024 08:53:15,Open Position,NSDQ100/USD," 350,00 ",0.345358," 0,00 "," 4.757,30 "," 4.407,30 ",2838896520,CFD," 0,00 "
25/10/2024 09:09:45,Position closed,NSDQ100/USD," 355,55 ",0.345358," 5,55 "," 4.762,85 "," 4.762,85 ",2838896520,CFD," 0,00 "
25/10/2024 09:24:21,Open Position,NSDQ100/USD," 250,00 ",0.246320," 0,00 "," 4.762,85 "," 4.512,85 ",2838905599,CFD," 0,00 "
25/10/2024 11:46:26,Position closed,NSDQ100/USD," 252,87 ",0.246320," 2,87 "," 4.765,72 "," 4.765,72 ",2838905599,CFD," 0,00 "
25/10/2024 12:42:44,Open Position,NSDQ100/USD," 250,00 ",0.245907," 0,00 "," 4.765,72 "," 4.515,72 ",2838945865,CFD," 0,00 "
25/10/2024 13:01:57,Position closed,NSDQ100/USD," 254,51 ",0.245907," 4,51 "," 4.770,23 "," 4.770,23 ",2838945865,CFD," 0,00 "
25/10/2024 13:30:45,Open Position,TSLA/USD," 299,98 ",5.845149," 0,00 "," 4.770,23 "," 4.470,25 ",2838997855,CFD," 0,00 "
25/10/2024 13:32:08,Position closed,TSLA/USD," 284,82 ",5.845149,"(15,16)"," 4.755,07 "," 4.755,07 ",2838997855,CFD," 0,00 "
25/10/2024 13:34:53,Open Position,NSDQ100/USD," 500,00 ",0.490349," 0,00 "," 4.755,07 "," 4.255,07 ",2839052843,CFD," 0,00 "
25/10/2024 13:35:49,Open Position,NSDQ100/USD," 500,00 ",0.489641," 0,00 "," 4.755,07 "," 3.755,07 ",2839055812,CFD," 0,00 "
25/10/2024 13:36:40,Open Position,NSDQ100/USD," 500,00 ",0.490049," 0,00 "," 4.755,07 "," 3.255,07 ",2839057741,CFD," 0,00 "
25/10/2024 13:37:13,Open Position,NSDQ100/USD," 820,00 ",0.803668," 0,00 "," 4.755,07 "," 2.435,07 ",2839058920,CFD," 0,00 "
25/10/2024 13:58:53,Open Position,NSDQ100/USD," 609,99 ",0.594767," 0,00 "," 4.755,07 "," 1.825,08 ",2839160912,CFD," 0,00 "
25/10/2024 13:59:22,Open Position,NSDQ100/USD," 300,00 ",0.292540," 0,00 "," 4.755,07 "," 1.525,08 ",2839161627,CFD," 0,00 "
25/10/2024 14:03:42,Open Position,NSDQ100/USD," 389,99 ",0.379633," 0,00 "," 4.755,07 "," 1.135,09 ",2839172379,CFD," 0,00 "
25/10/2024 14:04:49,Open Position,NSDQ100/USD," 199,99 ",0.194758," 0,00 "," 4.755,07 "," 935,10 ",2839173917,CFD," 0,00 "
25/10/2024 14:25:27,Open Position,NSDQ100/USD," 299,99 ",0.291942," 0,00 "," 4.755,07 "," 635,11 ",2839210253,CFD," 0,00 "
25/10/2024 14:25:35,Position closed,NSDQ100/USD," 298,59 ",0.291942,"(1,40)"," 4.753,67 "," 933,70 ",2839210253,CFD," 0,00 "
25/10/2024 14:25:58,Open Position,NSDQ100/USD," 300,00 ",0.291963," 0,00 "," 4.753,67 "," 633,70 ",2839210809,CFD," 0,00 "
25/10/2024 15:10:34,Position closed,NSDQ100/USD," 610,42 ",0.594767," 0,43 "," 4.754,10 "," 1.244,12 ",2839160912,CFD," 0,00 "
25/10/2024 15:11:14,Open Position,NSDQ100/USD," 300,00 ",0.292356," 0,00 "," 4.754,10 "," 944,12 ",2839274327,CFD," 0,00 "
25/10/2024 15:14:05,Position closed,NSDQ100/USD," 399,34 ",0.379633," 9,35 "," 4.763,45 "," 1.343,46 ",2839172379,CFD," 0,00 "
25/10/2024 15:16:36,Position closed,NSDQ100/USD," 307,22 ",0.291963," 7,22 "," 4.770,67 "," 1.650,68 ",2839210809,CFD," 0,00 "
25/10/2024 15:17:05,Position closed,NSDQ100/USD," 202,37 ",0.194758," 2,38 "," 4.773,05 "," 1.853,05 ",2839173917,CFD," 0,00 "
25/10/2024 15:17:31,Open Position,NSDQ100/USD," 399,99 ",0.389855," 0,00 "," 4.773,05 "," 1.453,06 ",2839287073,CFD," 0,00 "
25/10/2024 15:17:41,Open Position,NSDQ100/USD," 199,99 ",0.194920," 0,00 "," 4.773,05 "," 1.253,07 ",2839287144,CFD," 0,00 "
25/10/2024 17:06:59,Open Position,NSDQ100/USD," 320,00 ",0.312272," 0,00 "," 4.773,05 "," 933,07 ",2839433323,CFD," 0,00 "
25/10/2024 17:11:39,Position closed,NSDQ100/USD," 309,19 ",0.292356," 9,19 "," 4.782,24 "," 1.242,26 ",2839274327,CFD," 0,00 "
25/10/2024 17:11:45,Position closed,NSDQ100/USD," 205,75 ",0.194920," 5,76 "," 4.788,00 "," 1.448,01 ",2839287144,CFD," 0,00 "
25/10/2024 17:11:52,Position closed,NSDQ100/USD," 410,68 ",0.389855," 10,69 "," 4.798,69 "," 1.858,69 ",2839287073,CFD," 0,00 "
25/10/2024 17:11:59,Position closed,NSDQ100/USD," 305,13 ",0.292540," 5,13 "," 4.803,82 "," 2.163,82 ",2839161627,CFD," 0,00 "
25/10/2024 17:12:09,Open Position,NSDQ100/USD," 549,99 ",0.536742," 0,00 "," 4.803,82 "," 1.613,83 ",2839435521,CFD," 0,00 "
25/10/2024 17:12:33,Open Position,NSDQ100/USD," 409,99 ",0.400157," 0,00 "," 4.803,82 "," 1.203,84 ",2839435989,CFD," 0,00 "
25/10/2024 17:41:02,Position closed,NSDQ100/USD," 512,81 ",0.490049," 12,81 "," 4.816,63 "," 1.716,65 ",2839057741,CFD," 0,00 "
25/10/2024 17:42:18,Position closed,NSDQ100/USD," 844,30 ",0.803668," 24,30 "," 4.840,93 "," 2.560,95 ",2839058920,CFD," 0,00 "
25/10/2024 17:42:18,Position closed,NSDQ100/USD," 508,55 ",0.490349," 8,55 "," 4.849,48 "," 3.069,50 ",2839052843,CFD," 0,00 "
25/10/2024 17:42:18,Position closed,NSDQ100/USD," 357,08 ",0.312272," 37,08 "," 4.886,56 "," 3.426,58 ",2839433323,CFD," 0,00 "
25/10/2024 17:42:18,Position closed,NSDQ100/USD," 522,98 ",0.489641," 22,98 "," 4.909,54 "," 3.949,56 ",2839055812,CFD," 0,00 "
25/10/2024 17:42:18,Position closed,NSDQ100/USD," 456,30 ",0.400157," 46,31 "," 4.955,85 "," 4.405,86 ",2839435989,CFD," 0,00 "
25/10/2024 17:42:18,Position closed,NSDQ100/USD," 613,23 ",0.536742," 63,24 "," 5.019,09 "," 5.019,09 ",2839435521,CFD," 0,00 "
25/10/2024 17:50:44,Open Position,NSDQ100/USD," 510,00 ",0.499835," 0,00 "," 5.019,09 "," 4.509,09 ",2839462775,CFD," 0,00 "
25/10/2024 18:02:25,Position closed,NSDQ100/USD," 523,62 ",0.499835," 13,62 "," 5.032,71 "," 5.032,71 ",2839462775,CFD," 0,00 "
25/10/2024 18:25:50,Open Position,NSDQ100/USD," 510,00 ",0.500799," 0,00 "," 5.032,71 "," 4.522,71 ",2839491346,CFD," 0,00 "
25/10/2024 18:26:04,Open Position,NSDQ100/USD," 699,99 ",0.687281," 0,00 "," 5.032,71 "," 3.822,72 ",2839491443,CFD," 0,00 "
25/10/2024 20:01:42,Position closed,NSDQ100/USD," 709,68 ",0.687281," 9,69 "," 5.042,40 "," 4.532,40 ",2839491443,CFD," 0,00 "
25/10/2024 20:01:50,Position closed,NSDQ100/USD," 514,76 ",0.500799," 4,76 "," 5.047,16 "," 5.047,16 ",2839491346,CFD," 0,00 "
28/10/2024 05:36:04,Open Position,NSDQ100/USD," 509,98 ",0.497911," 0,00 "," 5.047,16 "," 4.537,18 ",2839637163,CFD," 0,00 "
28/10/2024 05:59:28,Open Position,NSDQ100/USD," 499,99 ",0.488606," 0,00 "," 5.047,16 "," 4.037,19 ",2839638774,CFD," 0,00 "
28/10/2024 07:26:30,Open Position,NSDQ100/USD," 599,99 ",0.585386," 0,00 "," 5.047,16 "," 3.437,20 ",2839648097,CFD," 0,00 "
28/10/2024 08:04:15,Position closed,NSDQ100/USD," 608,79 ",0.585386," 8,80 "," 5.055,96 "," 4.045,99 ",2839648097,CFD," 0,00 "
28/10/2024 08:04:23,Position closed,NSDQ100/USD," 511,74 ",0.497911," 1,76 "," 5.057,72 "," 4.557,73 ",2839637163,CFD," 0,00 "
28/10/2024 08:20:08,Open Position,NSDQ100/USD," 499,99 ",0.487765," 0,00 "," 5.057,72 "," 4.057,74 ",2839687998,CFD," 0,00 "
28/10/2024 08:25:50,Position closed,NSDQ100/USD," 505,66 ",0.487765," 5,67 "," 5.063,39 "," 4.563,40 ",2839687998,CFD," 0,00 "
28/10/2024 08:26:20,Open Position,NSDQ100/USD," 300,00 ",0.292743," 0,00 "," 5.063,39 "," 4.263,40 ",2839706914,CFD," 0,00 "
28/10/2024 08:33:05,Position closed,NSDQ100/USD," 302,82 ",0.292743," 2,82 "," 5.066,21 "," 4.566,22 ",2839706914,CFD," 0,00 "
28/10/2024 08:33:34,Open Position,NSDQ100/USD," 299,99 ",0.292587," 0,00 "," 5.066,21 "," 4.266,23 ",2839709408,CFD," 0,00 "
28/10/2024 08:33:51,Open Position,NSDQ100/USD," 250,00 ",0.243819," 0,00 "," 5.066,21 "," 4.016,23 ",2839709448,CFD," 0,00 "
28/10/2024 08:40:15,Position closed,NSDQ100/USD," 253,10 ",0.243819," 3,10 "," 5.069,31 "," 4.269,33 ",2839709448,CFD," 0,00 "
28/10/2024 08:40:42,Open Position,NSDQ100/USD," 349,99 ",0.341154," 0,00 "," 5.069,31 "," 3.919,34 ",2839711142,CFD," 0,00 "
28/10/2024 08:41:07,Open Position,NSDQ100/USD," 199,99 ",0.194957," 0,00 "," 5.069,31 "," 3.719,35 ",2839711260,CFD," 0,00 "
28/10/2024 08:41:52,Open Position,NSDQ100/USD," 199,99 ",0.194923," 0,00 "," 5.069,31 "," 3.519,36 ",2839711391,CFD," 0,00 "
28/10/2024 08:51:09,Position closed,NSDQ100/USD," 348,43 ",0.341154,"(1,56)"," 5.067,75 "," 3.867,79 ",2839711142,CFD," 0,00 "
28/10/2024 08:56:31,Position closed,NSDQ100/USD," 294,64 ",0.292587,"(5,35)"," 5.062,40 "," 4.162,43 ",2839709408,CFD," 0,00 "
28/10/2024 08:56:49,Open Position,NSDQ100/USD," 199,99 ",0.194929," 0,00 "," 5.062,40 "," 3.962,44 ",2839716569,CFD," 0,00 "
28/10/2024 08:57:50,Open Position,NSDQ100/USD," 200,00 ",0.194933," 0,00 "," 5.062,40 "," 3.762,44 ",2839716876,CFD," 0,00 "
28/10/2024 09:07:36,Position closed,NSDQ100/USD," 200,98 ",0.194933," 0,98 "," 5.063,38 "," 3.963,42 ",2839716876,CFD," 0,00 "
28/10/2024 09:08:30,Open Position,NSDQ100/USD," 299,99 ",0.292560," 0,00 "," 5.063,38 "," 3.663,43 ",2839727178,CFD," 0,00 "
28/10/2024 09:59:36,Position closed,NSDQ100/USD," 201,92 ",0.194957," 1,93 "," 5.065,31 "," 3.865,35 ",2839711260,CFD," 0,00 "
28/10/2024 09:59:56,Position closed,NSDQ100/USD," 201,42 ",0.194929," 1,43 "," 5.066,74 "," 4.066,77 ",2839716569,CFD," 0,00 "
28/10/2024 10:00:03,Position closed,NSDQ100/USD," 201,26 ",0.194923," 1,27 "," 5.068,01 "," 4.268,03 ",2839711391,CFD," 0,00 "
28/10/2024 10:00:43,Open Position,NSDQ100/USD," 350,00 ",0.340869," 0,00 "," 5.068,01 "," 3.918,03 ",2839745382,CFD," 0,00 "
28/10/2024 10:01:45,Open Position,NSDQ100/USD," 299,99 ",0.292215," 0,00 "," 5.068,01 "," 3.618,04 ",2839745610,CFD," 0,00 "
28/10/2024 10:13:59,Position closed,NSDQ100/USD," 304,85 ",0.292215," 4,86 "," 5.072,87 "," 3.922,89 ",2839745610,CFD," 0,00 "
28/10/2024 10:15:47,Open Position,NSDQ100/USD," 299,99 ",0.292470," 0,00 "," 5.072,87 "," 3.622,90 ",2839748732,CFD," 0,00 "
28/10/2024 11:40:27,Position closed,NSDQ100/USD," 308,22 ",0.292470," 8,23 "," 5.081,10 "," 3.931,12 ",2839748732,CFD," 0,00 "
28/10/2024 11:40:34,Position closed,NSDQ100/USD," 305,65 ",0.292560," 5,66 "," 5.086,76 "," 4.236,77 ",2839727178,CFD," 0,00 "
28/10/2024 11:59:51,Open Position,NSDQ100/USD," 509,99 ",0.498055," 0,00 "," 5.086,76 "," 3.726,78 ",2839771675,CFD," 0,00 "
28/10/2024 12:16:35,Position closed,NSDQ100/USD," 512,00 ",0.498055," 2,01 "," 5.088,77 "," 4.238,78 ",2839771675,CFD," 0,00 "
28/10/2024 12:17:09,Open Position,NSDQ100/USD," 509,99 ",0.498191," 0,00 "," 5.088,77 "," 3.728,79 ",2839785067,CFD," 0,00 "
28/10/2024 12:20:58,Open Position,NSDQ100/USD," 400,00 ",0.390724," 0,00 "," 5.088,77 "," 3.328,79 ",2839786866,CFD," 0,00 "
28/10/2024 12:22:37,Open Position,NSDQ100/USD," 400,00 ",0.390696," 0,00 "," 5.088,77 "," 2.928,79 ",2839787202,CFD," 0,00 "
28/10/2024 12:24:38,Open Position,NSDQ100/USD," 349,99 ",0.341911," 0,00 "," 5.088,77 "," 2.578,80 ",2839787666,CFD," 0,00 "
28/10/2024 12:25:41,Open Position,NSDQ100/USD," 509,99 ",0.498310," 0,00 "," 5.088,77 "," 2.068,81 ",2839787842,CFD," 0,00 "
28/10/2024 13:11:18,Open Position,NSDQ100/USD," 300,00 ",0.292612," 0,00 "," 5.088,77 "," 1.768,81 ",2839799485,CFD," 0,00 "
28/10/2024 13:20:48,Position closed,NSDQ100/USD," 300,24 ",0.292612," 0,24 "," 5.089,01 "," 2.069,05 ",2839799485,CFD," 0,00 "
28/10/2024 13:31:34,Position closed,NSDQ100/USD," 318,26 ",0.340869,"(31,74)"," 5.057,27 "," 2.387,31 ",2839745382,CFD," 0,00 "
28/10/2024 13:33:06,Position closed,NSDQ100/USD," 405,54 ",0.390724," 5,54 "," 5.062,81 "," 2.792,85 ",2839786866,CFD," 0,00 "
28/10/2024 13:33:06,Position closed,NSDQ100/USD," 516,70 ",0.498191," 6,71 "," 5.069,52 "," 3.309,55 ",2839785067,CFD," 0,00 "
28/10/2024 13:33:06,Position closed,NSDQ100/USD," 354,29 ",0.341911," 4,30 "," 5.073,82 "," 3.663,84 ",2839787666,CFD," 0,00 "
28/10/2024 13:33:06,Position closed,NSDQ100/USD," 406,12 ",0.390696," 6,12 "," 5.079,94 "," 4.069,96 ",2839787202,CFD," 0,00 "
28/10/2024 13:33:06,Position closed,NSDQ100/USD," 502,81 ",0.488606," 2,82 "," 5.082,76 "," 4.572,77 ",2839638774,CFD," 0,00 "
28/10/2024 13:33:06,Position closed,NSDQ100/USD," 514,26 ",0.498310," 4,27 "," 5.087,03 "," 5.087,03 ",2839787842,CFD," 0,00 "
28/10/2024 13:34:21,Open Position,NSDQ100/USD," 199,99 ",0.195674," 0,00 "," 5.087,03 "," 4.887,04 ",2839931515,CFD," 0,00 "
28/10/2024 13:35:19,Open Position,NSDQ100/USD," 510,00 ",0.498755," 0,00 "," 5.087,03 "," 4.377,04 ",2839933474,CFD," 0,00 "
28/10/2024 13:38:41,Position closed,NSDQ100/USD," 514,90 ",0.498755," 4,90 "," 5.091,93 "," 4.891,94 ",2839933474,CFD," 0,00 "
28/10/2024 13:38:41,Position closed,NSDQ100/USD," 200,19 ",0.195674," 0,20 "," 5.092,13 "," 5.092,13 ",2839931515,CFD," 0,00 "
28/10/2024 13:39:29,Open Position,NSDQ100/USD," 300,00 ",0.293507," 0,00 "," 5.092,13 "," 4.792,13 ",2839941447,CFD," 0,00 "
28/10/2024 13:41:28,Position closed,NSDQ100/USD," 301,04 ",0.293507," 1,04 "," 5.093,17 "," 5.093,17 ",2839941447,CFD," 0,00 "
28/10/2024 13:42:07,Open Position,NSDQ100/USD," 300,00 ",0.293724," 0,00 "," 5.093,17 "," 4.793,17 ",2839947453,CFD," 0,00 "
28/10/2024 13:42:31,Position closed,NSDQ100/USD," 300,39 ",0.293724," 0,39 "," 5.093,56 "," 5.093,56 ",2839947453,CFD," 0,00 "
28/10/2024 13:43:18,Open Position,NSDQ100/USD," 300,00 ",0.293569," 0,00 "," 5.093,56 "," 4.793,56 ",2839949858,CFD," 0,00 "
28/10/2024 13:47:06,Open Position,NSDQ100/USD," 509,99 ",0.499079," 0,00 "," 5.093,56 "," 4.283,57 ",2839956844,CFD," 0,00 "
28/10/2024 13:47:27,Open Position,NSDQ100/USD," 400,00 ",0.391506," 0,00 "," 5.093,56 "," 3.883,57 ",2839957157,CFD," 0,00 "
28/10/2024 13:47:45,Open Position,NSDQ100/USD," 599,99 ",0.587255," 0,00 "," 5.093,56 "," 3.283,58 ",2839957391,CFD," 0,00 "
28/10/2024 13:48:05,Position closed,NSDQ100/USD," 401,27 ",0.391506," 1,27 "," 5.094,83 "," 3.684,85 ",2839957157,CFD," 0,00 "
28/10/2024 13:48:36,Position closed,NSDQ100/USD," 514,75 ",0.499079," 4,76 "," 5.099,59 "," 4.199,60 ",2839956844,CFD," 0,00 "
28/10/2024 13:48:36,Position closed,NSDQ100/USD," 603,60 ",0.587255," 3,61 "," 5.103,20 "," 4.803,20 ",2839957391,CFD," 0,00 "
28/10/2024 13:48:36,Position closed,NSDQ100/USD," 303,01 ",0.293569," 3,01 "," 5.106,21 "," 5.106,21 ",2839949858,CFD," 0,00 "
28/10/2024 13:49:07,Open Position,NSDQ100/USD," 519,98 ",0.509259," 0,00 "," 5.106,21 "," 4.586,23 ",2839958896,CFD," 0,00 "
28/10/2024 13:49:13,Open Position,NSDQ100/USD," 519,99 ",0.509528," 0,00 "," 5.106,21 "," 4.066,24 ",2839958969,CFD," 0,00 "
28/10/2024 13:49:55,Open Position,NSDQ100/USD," 249,99 ",0.244765," 0,00 "," 5.106,21 "," 3.816,25 ",2839960892,CFD," 0,00 "
28/10/2024 14:10:08,Position closed,NSDQ100/USD," 253,82 ",0.244765," 3,83 "," 5.110,04 "," 4.070,07 ",2839960892,CFD," 0,00 "
28/10/2024 14:10:54,Open Position,NSDQ100/USD," 299,99 ",0.293493," 0,00 "," 5.110,04 "," 3.770,08 ",2840094545,CFD," 0,00 "
28/10/2024 14:15:22,Position closed,NSDQ100/USD," 299,59 ",0.293493,"(0,40)"," 5.109,64 "," 4.069,67 ",2840094545,CFD," 0,00 "
28/10/2024 14:15:42,Open Position,NSDQ100/USD," 299,99 ",0.293517," 0,00 "," 5.109,64 "," 3.769,68 ",2840099814,CFD," 0,00 "
28/10/2024 14:30:35,Position closed,NSDQ100/USD," 306,78 ",0.293517," 6,79 "," 5.116,43 "," 4.076,46 ",2840099814,CFD," 0,00 "
28/10/2024 14:31:23,Open Position,NSDQ100/USD," 510,00 ",0.498411," 0,00 "," 5.116,43 "," 3.566,46 ",2840122498,CFD," 0,00 "
28/10/2024 14:32:02,Position closed,NSDQ100/USD," 514,20 ",0.498411," 4,20 "," 5.120,63 "," 4.080,66 ",2840122498,CFD," 0,00 "
28/10/2024 14:32:31,Open Position,NSDQ100/USD," 300,00 ",0.293469," 0,00 "," 5.120,63 "," 3.780,66 ",2840125250,CFD," 0,00 "
28/10/2024 14:34:21,Position closed,NSDQ100/USD," 302,77 ",0.293469," 2,77 "," 5.123,40 "," 4.083,43 ",2840125250,CFD," 0,00 "
28/10/2024 14:35:17,Position closed,NSDQ100/USD," 515,72 ",0.509259,"(4,26)"," 5.119,14 "," 4.599,15 ",2839958896,CFD," 0,00 "
28/10/2024 14:36:19,Open Position,NSDQ100/USD," 399,99 ",0.391348," 0,00 "," 5.119,14 "," 4.199,16 ",2840131254,CFD," 0,00 "
28/10/2024 14:37:02,Open Position,NSDQ100/USD," 299,99 ",0.293484," 0,00 "," 5.119,14 "," 3.899,17 ",2840132061,CFD," 0,00 "
28/10/2024 14:39:29,Position closed,NSDQ100/USD," 302,20 ",0.293484," 2,21 "," 5.121,35 "," 4.201,37 ",2840132061,CFD," 0,00 "
28/10/2024 14:39:53,Open Position,NSDQ100/USD," 250,00 ",0.244434," 0,00 "," 5.121,35 "," 3.951,37 ",2840136784,CFD," 0,00 "
28/10/2024 14:42:47,Position closed,NSDQ100/USD," 254,50 ",0.244434," 4,50 "," 5.125,85 "," 4.205,87 ",2840136784,CFD," 0,00 "
28/10/2024 14:43:09,Open Position,NSDQ100/USD," 300,00 ",0.293204," 0,00 "," 5.125,85 "," 3.905,87 ",2840143967,CFD," 0,00 "
28/10/2024 14:43:25,Open Position,NSDQ100/USD," 249,99 ",0.244324," 0,00 "," 5.125,85 "," 3.655,88 ",2840145902,CFD," 0,00 "
28/10/2024 14:47:44,Open Position,NSDQ100/USD," 599,99 ",0.586581," 0,00 "," 5.125,85 "," 3.055,89 ",2840153152,CFD," 0,00 "
28/10/2024 14:59:26,Position closed,NSDQ100/USD," 607,52 ",0.586581," 7,53 "," 5.133,38 "," 3.663,41 ",2840153152,CFD," 0,00 "
28/10/2024 14:59:34,Position closed,NSDQ100/USD," 306,93 ",0.293204," 6,93 "," 5.140,31 "," 3.970,34 ",2840143967,CFD," 0,00 "
28/10/2024 14:59:42,Position closed,NSDQ100/USD," 402,55 ",0.391348," 2,56 "," 5.142,87 "," 4.372,89 ",2840131254,CFD," 0,00 "
28/10/2024 14:59:48,Open Position,NSDQ100/USD," 519,99 ",0.509039," 0,00 "," 5.142,87 "," 3.852,90 ",2840171062,CFD," 0,00 "
28/10/2024 15:03:38,Position closed,NSDQ100/USD," 524,14 ",0.509528," 4,15 "," 5.147,02 "," 4.377,04 ",2839958969,CFD," 0,00 "
28/10/2024 15:04:07,Position closed,NSDQ100/USD," 528,05 ",0.509039," 8,06 "," 5.155,08 "," 4.905,09 ",2840171062,CFD," 0,00 "
28/10/2024 15:04:23,Position closed,NSDQ100/USD," 237,83 ",0.244324,"(12,16)"," 5.142,92 "," 5.142,92 ",2840145902,CFD," 0,00 "
28/10/2024 15:05:11,Open Position,NSDQ100/USD," 250,00 ",0.244877," 0,00 "," 5.142,92 "," 4.892,92 ",2840178142,CFD," 0,00 "
28/10/2024 15:05:17,Open Position,NSDQ100/USD," 519,99 ",0.509426," 0,00 "," 5.142,92 "," 4.372,93 ",2840178208,CFD," 0,00 "
28/10/2024 15:05:43,Open Position,NSDQ100/USD," 300,00 ",0.293899," 0,00 "," 5.142,92 "," 4.072,93 ",2840179063,CFD," 0,00 "
28/10/2024 15:45:09,Position closed,NSDQ100/USD," 530,96 ",0.509426," 10,97 "," 5.153,89 "," 4.603,89 ",2840178208,CFD," 0,00 "
28/10/2024 15:45:16,Position closed,NSDQ100/USD," 306,86 ",0.293899," 6,86 "," 5.160,75 "," 4.910,75 ",2840179063,CFD," 0,00 "
28/10/2024 15:48:07,Open Position,NSDQ100/USD," 519,99 ",0.509945," 0,00 "," 5.160,75 "," 4.390,76 ",2840279079,CFD," 0,00 "
28/10/2024 15:51:02,Open Position,NSDQ100/USD," 350,00 ",0.342814," 0,00 "," 5.160,75 "," 4.040,76 ",2840282260,CFD," 0,00 "
28/10/2024 15:53:30,Open Position,NSDQ100/USD," 300,00 ",0.294160," 0,00 "," 5.160,75 "," 3.740,76 ",2840283832,CFD," 0,00 "
28/10/2024 15:57:55,Open Position,NSDQ100/USD," 249,99 ",0.245175," 0,00 "," 5.160,75 "," 3.490,77 ",2840286762,CFD," 0,00 "
28/10/2024 16:02:05,Position closed,NSDQ100/USD," 525,47 ",0.509945," 5,48 "," 5.166,23 "," 4.016,24 ",2840279079,CFD," 0,00 "
28/10/2024 16:02:38,Position closed,NSDQ100/USD," 303,60 ",0.294160," 3,60 "," 5.169,83 "," 4.319,84 ",2840283832,CFD," 0,00 "
28/10/2024 16:02:46,Position closed,NSDQ100/USD," 250,59 ",0.245175," 0,60 "," 5.170,43 "," 4.570,43 ",2840286762,CFD," 0,00 "
28/10/2024 16:03:25,Position closed,NSDQ100/USD," 340,96 ",0.342814,"(9,04)"," 5.161,39 "," 4.911,39 ",2840282260,CFD," 0,00 "
28/10/2024 16:03:25,Position closed,NSDQ100/USD," 243,74 ",0.244877,"(6,26)"," 5.155,13 "," 5.155,13 ",2840178142,CFD," 0,00 "
28/10/2024 16:04:11,Open Position,NSDQ100/USD," 300,00 ",0.294150," 0,00 "," 5.155,13 "," 4.855,13 ",2840295089,CFD," 0,00 "
28/10/2024 16:04:21,Open Position,NSDQ100/USD," 300,00 ",0.294114," 0,00 "," 5.155,13 "," 4.555,13 ",2840295232,CFD," 0,00 "
28/10/2024 16:04:34,Open Position,NSDQ100/USD," 299,99 ",0.294070," 0,00 "," 5.155,13 "," 4.255,14 ",2840295468,CFD," 0,00 "
28/10/2024 16:08:06,Position closed,NSDQ100/USD," 302,34 ",0.294114," 2,34 "," 5.157,47 "," 4.557,48 ",2840295232,CFD," 0,00 "
28/10/2024 16:08:12,Position closed,NSDQ100/USD," 300,89 ",0.294150," 0,89 "," 5.158,36 "," 4.858,37 ",2840295089,CFD," 0,00 "
28/10/2024 16:09:32,Position closed,NSDQ100/USD," 298,06 ",0.294070,"(1,93)"," 5.156,43 "," 5.156,43 ",2840295468,CFD," 0,00 "
28/10/2024 16:09:56,Open Position,NSDQ100/USD," 519,99 ",0.509885," 0,00 "," 5.156,43 "," 4.636,44 ",2840300392,CFD," 0,00 "
28/10/2024 16:10:19,Open Position,NSDQ100/USD," 299,99 ",0.294094," 0,00 "," 5.156,43 "," 4.336,45 ",2840300579,CFD," 0,00 "
28/10/2024 16:19:07,Position closed,NSDQ100/USD," 302,18 ",0.294094," 2,19 "," 5.158,62 "," 4.638,63 ",2840300579,CFD," 0,00 "
28/10/2024 16:19:17,Open Position,NSDQ100/USD," 249,99 ",0.244944," 0,00 "," 5.158,62 "," 4.388,64 ",2840307992,CFD," 0,00 "
28/10/2024 16:23:21,Position closed,NSDQ100/USD," 252,40 ",0.244944," 2,41 "," 5.161,03 "," 4.641,04 ",2840307992,CFD," 0,00 "
28/10/2024 16:23:59,Open Position,NSDQ100/USD," 399,99 ",0.391739," 0,00 "," 5.161,03 "," 4.241,05 ",2840312016,CFD," 0,00 "
28/10/2024 16:24:08,Open Position,NSDQ100/USD," 200,00 ",0.195871," 0,00 "," 5.161,03 "," 4.041,05 ",2840312214,CFD," 0,00 "
28/10/2024 16:27:05,Position closed,NSDQ100/USD," 198,87 ",0.195871,"(1,13)"," 5.159,90 "," 4.239,92 ",2840312214,CFD," 0,00 "
28/10/2024 16:27:10,Position closed,NSDQ100/USD," 400,91 ",0.391739," 0,92 "," 5.160,82 "," 4.640,83 ",2840312016,CFD," 0,00 "
28/10/2024 16:27:28,Open Position,NSDQ100/USD," 300,00 ",0.293865," 0,00 "," 5.160,82 "," 4.340,83 ",2840314403,CFD," 0,00 "
28/10/2024 16:27:39,Open Position,NSDQ100/USD," 200,00 ",0.195880," 0,00 "," 5.160,82 "," 4.140,83 ",2840314497,CFD," 0,00 "
28/10/2024 16:31:33,Position closed,NSDQ100/USD," 302,19 ",0.293865," 2,19 "," 5.163,01 "," 4.443,02 ",2840314403,CFD," 0,00 "
28/10/2024 16:31:43,Open Position,NSDQ100/USD," 399,99 ",0.392027," 0,00 "," 5.163,01 "," 4.043,03 ",2840317523,CFD," 0,00 "
28/10/2024 16:59:43,Position closed,NSDQ100/USD," 404,63 ",0.392027," 4,64 "," 5.167,65 "," 4.447,66 ",2840317523,CFD," 0,00 "
28/10/2024 16:59:43,Position closed,NSDQ100/USD," 194,37 ",0.195880,"(5,63)"," 5.162,02 "," 4.642,03 ",2840314497,CFD," 0,00 "
28/10/2024 16:59:43,Position closed,NSDQ100/USD," 520,93 ",0.509885," 0,94 "," 5.162,96 "," 5.162,96 ",2840300392,CFD," 0,00 "
28/10/2024 17:04:19,Open Position,NSDQ100/USD," 299,99 ",0.294112," 0,00 "," 5.162,96 "," 4.862,97 ",2840337143,CFD," 0,00 "
28/10/2024 17:12:12,Open Position,NSDQ100/USD," 249,99 ",0.245260," 0,00 "," 5.162,96 "," 4.612,98 ",2840341853,CFD," 0,00 "
28/10/2024 17:14:11,Position closed,NSDQ100/USD," 251,79 ",0.245260," 1,80 "," 5.164,76 "," 4.864,77 ",2840341853,CFD," 0,00 "
28/10/2024 17:16:23,Open Position,NSDQ100/USD," 300,00 ",0.294440," 0,00 "," 5.164,76 "," 4.564,77 ",2840344915,CFD," 0,00 "
28/10/2024 17:44:05,Position closed,NSDQ100/USD," 300,47 ",0.294112," 0,48 "," 5.165,24 "," 4.865,24 ",2840337143,CFD," 0,00 "
28/10/2024 17:45:13,Open Position,NSDQ100/USD," 250,00 ",0.244985," 0,00 "," 5.165,24 "," 4.615,24 ",2840368306,CFD," 0,00 "
28/10/2024 18:00:11,Open Position,NSDQ100/USD," 399,98 ",0.392006," 0,00 "," 5.165,24 "," 4.215,26 ",2840377509,CFD," 0,00 "
28/10/2024 19:15:07,Position closed,NSDQ100/USD," 409,76 ",0.392006," 9,78 "," 5.175,02 "," 4.625,02 ",2840377509,CFD," 0,00 "
28/10/2024 19:15:38,Position closed,NSDQ100/USD," 298,51 ",0.294440,"(1,49)"," 5.173,53 "," 4.923,53 ",2840344915,CFD," 0,00 "
28/10/2024 19:16:54,Open Position,NSDQ100/USD," 350,00 ",0.343420," 0,00 "," 5.173,53 "," 4.573,53 ",2840425385,CFD," 0,00 "
28/10/2024 19:17:44,Open Position,NSDQ100/USD," 349,99 ",0.343569," 0,00 "," 5.173,53 "," 4.223,54 ",2840425762,CFD," 0,00 "
28/10/2024 19:17:54,Open Position,NSDQ100/USD," 249,99 ",0.245433," 0,00 "," 5.173,53 "," 3.973,55 ",2840425804,CFD," 0,00 "
28/10/2024 19:59:52,Position closed,NSDQ100/USD," 253,51 ",0.245433," 3,52 "," 5.177,05 "," 4.227,06 ",2840425804,CFD," 0,00 "
28/10/2024 19:59:58,Position closed,NSDQ100/USD," 355,37 ",0.343569," 5,38 "," 5.182,43 "," 4.582,43 ",2840425762,CFD," 0,00 "
28/10/2024 20:04:53,Position closed,NSDQ100/USD," 239,93 ",0.244985,"(10,07)"," 5.172,36 "," 4.822,36 ",2840368306,CFD," 0,00 "
28/10/2024 20:04:53,Position closed,NSDQ100/USD," 344,88 ",0.343420,"(5,12)"," 5.167,24 "," 5.167,24 ",2840425385,CFD," 0,00 "
28/10/2024 20:18:54,Open Position,NSDQ100/USD," 350,00 ",0.343721," 0,00 "," 5.167,24 "," 4.817,24 ",2840455656,CFD," 0,00 "
28/10/2024 20:26:40,Position closed,NSDQ100/USD," 351,80 ",0.343721," 1,80 "," 5.169,04 "," 5.169,04 ",2840455656,CFD," 0,00 "
28/10/2024 23:21:41,Open Position,NSDQ100/USD," 399,99 ",0.392720," 0,00 "," 5.169,04 "," 4.769,05 ",2840465536,CFD," 0,00 "
28/10/2024 23:38:23,Open Position,NSDQ100/USD," 349,99 ",0.343740," 0,00 "," 5.169,04 "," 4.419,06 ",2840466467,CFD," 0,00 "
29/10/2024 00:08:18,Index price adjustment,NSDQ100/USD," 0,05 ",-," 0,05 "," 5.169,09 "," 4.419,11 ",2840368306,CFD," 0,00 "
29/10/2024 00:08:18,Index price adjustment,NSDQ100/USD," 0,07 ",-," 0,07 "," 5.169,16 "," 4.419,18 ",2840425385,CFD," 0,00 "
29/10/2024 00:08:24,Position closed,NSDQ100/USD," 356,71 ",0.343740," 6,72 "," 5.175,88 "," 4.775,89 ",2840466467,CFD," 0,00 "
29/10/2024 00:29:33,Position closed,NSDQ100/USD," 402,64 ",0.392720," 2,65 "," 5.178,53 "," 5.178,53 ",2840465536,CFD," 0,00 "
29/10/2024 06:18:02,Open Position,NSDQ100/USD," 349,99 ",0.343447," 0,00 "," 5.178,53 "," 4.828,54 ",2840492695,CFD," 0,00 "
29/10/2024 06:49:46,Open Position,NSDQ100/USD," 500,00 ",0.489998," 0,00 "," 5.178,53 "," 4.328,54 ",2840495810,CFD," 0,00 "
29/10/2024 06:56:36,Open Position,NSDQ100/USD," 400,00 ",0.392109," 0,00 "," 5.178,53 "," 3.928,54 ",2840496912,CFD," 0,00 "
29/10/2024 07:30:27,Open Position,NSDQ100/USD," 350,00 ",0.342903," 0,00 "," 5.178,53 "," 3.578,54 ",2840504580,CFD," 0,00 "
29/10/2024 07:36:27,Open Position,NSDQ100/USD," 349,99 ",0.343016," 0,00 "," 5.178,53 "," 3.228,55 ",2840505409,CFD," 0,00 "
29/10/2024 07:41:21,Position closed,NSDQ100/USD," 348,99 ",0.342903,"(1,01)"," 5.177,52 "," 3.577,54 ",2840504580,CFD," 0,00 "
29/10/2024 07:41:33,Position closed,NSDQ100/USD," 500,22 ",0.489998," 0,22 "," 5.177,74 "," 4.077,76 ",2840495810,CFD," 0,00 "
29/10/2024 07:44:31,Open Position,NSDQ100/USD," 300,00 ",0.293921," 0,00 "," 5.177,74 "," 3.777,76 ",2840506237,CFD," 0,00 "
29/10/2024 07:44:46,Position closed,NSDQ100/USD," 395,58 ",0.392109,"(4,42)"," 5.173,32 "," 4.173,34 ",2840496912,CFD," 0,00 "
29/10/2024 08:07:47,Position closed,NSDQ100/USD," 362,49 ",0.343016," 12,50 "," 5.185,82 "," 4.535,83 ",2840505409,CFD," 0,00 "
29/10/2024 08:08:01,Position closed,NSDQ100/USD," 353,71 ",0.343447," 3,72 "," 5.189,54 "," 4.889,54 ",2840492695,CFD," 0,00 "
29/10/2024 08:11:45,Open Position,NSDQ100/USD," 300,00 ",0.294446," 0,00 "," 5.189,54 "," 4.589,54 ",2840525532,CFD," 0,00 "
29/10/2024 08:12:00,Open Position,NSDQ100/USD," 400,00 ",0.392742," 0,00 "," 5.189,54 "," 4.189,54 ",2840525577,CFD," 0,00 "
29/10/2024 08:21:10,Position closed,NSDQ100/USD," 407,60 ",0.392742," 7,60 "," 5.197,14 "," 4.597,14 ",2840525577,CFD," 0,00 "
29/10/2024 08:21:44,Open Position,NSDQ100/USD," 249,99 ",0.245728," 0,00 "," 5.197,14 "," 4.347,15 ",2840539929,CFD," 0,00 "
29/10/2024 08:21:52,Open Position,NSDQ100/USD," 350,00 ",0.344029," 0,00 "," 5.197,14 "," 3.997,15 ",2840539993,CFD," 0,00 "
29/10/2024 08:23:48,Position closed,NSDQ100/USD," 247,94 ",0.245728,"(2,05)"," 5.195,09 "," 4.245,09 ",2840539929,CFD," 0,00 "
29/10/2024 08:24:01,Position closed,NSDQ100/USD," 353,39 ",0.344029," 3,39 "," 5.198,48 "," 4.598,48 ",2840539993,CFD," 0,00 "
29/10/2024 08:24:21,Open Position,NSDQ100/USD," 299,99 ",0.294624," 0,00 "," 5.198,48 "," 4.298,49 ",2840541018,CFD," 0,00 "
29/10/2024 08:25:31,Open Position,NSDQ100/USD," 249,99 ",0.245585," 0,00 "," 5.198,48 "," 4.048,50 ",2840541852,CFD," 0,00 "
29/10/2024 08:30:21,Position closed,NSDQ100/USD," 305,78 ",0.294624," 5,79 "," 5.204,27 "," 4.354,28 ",2840541018,CFD," 0,00 "
29/10/2024 08:30:28,Position closed,NSDQ100/USD," 301,72 ",0.294446," 1,72 "," 5.205,99 "," 4.656,00 ",2840525532,CFD," 0,00 "
29/10/2024 08:31:14,Open Position,NSDQ100/USD," 300,00 ",0.294366," 0,00 "," 5.205,99 "," 4.356,00 ",2840544436,CFD," 0,00 "
29/10/2024 08:31:59,Open Position,NSDQ100/USD," 349,99 ",0.343422," 0,00 "," 5.205,99 "," 4.006,01 ",2840544611,CFD," 0,00 "
29/10/2024 08:47:10,Position closed,NSDQ100/USD," 355,19 ",0.343422," 5,20 "," 5.211,19 "," 4.361,20 ",2840544611,CFD," 0,00 "
29/10/2024 08:47:16,Position closed,NSDQ100/USD," 304,37 ",0.294366," 4,37 "," 5.215,56 "," 4.665,57 ",2840544436,CFD," 0,00 "
29/10/2024 08:48:44,Open Position,NSDQ100/USD," 300,00 ",0.294066," 0,00 "," 5.215,56 "," 4.365,57 ",2840550029,CFD," 0,00 "
29/10/2024 08:50:20,Open Position,NSDQ100/USD," 400,00 ",0.392174," 0,00 "," 5.215,56 "," 3.965,57 ",2840550310,CFD," 0,00 "
29/10/2024 08:56:15,Open Position,NSDQ100/USD," 300,00 ",0.294262," 0,00 "," 5.215,56 "," 3.665,57 ",2840551846,CFD," 0,00 "
29/10/2024 09:34:00,Position closed,NSDQ100/USD," 409,58 ",0.392174," 9,58 "," 5.225,14 "," 4.075,15 ",2840550310,CFD," 0,00 "
29/10/2024 09:37:14,Open Position,NSDQ100/USD," 450,00 ",0.441926," 0,00 "," 5.225,14 "," 3.625,15 ",2840562392,CFD," 0,00 "
29/10/2024 09:40:22,Open Position,NSDQ100/USD," 350,00 ",0.343576," 0,00 "," 5.225,14 "," 3.275,15 ",2840563188,CFD," 0,00 "
29/10/2024 10:28:54,Open Position,NSDQ100/USD," 299,99 ",0.294649," 0,00 "," 5.225,14 "," 2.975,16 ",2840574737,CFD," 0,00 "
29/10/2024 11:12:33,Position closed,NSDQ100/USD," 454,40 ",0.441926," 4,40 "," 5.229,54 "," 3.429,56 ",2840562392,CFD," 0,00 "
29/10/2024 11:12:42,Position closed,NSDQ100/USD," 251,40 ",0.245585," 1,41 "," 5.230,95 "," 3.680,96 ",2840541852,CFD," 0,00 "
29/10/2024 11:12:56,Position closed,NSDQ100/USD," 302,51 ",0.294649," 2,52 "," 5.233,47 "," 3.983,47 ",2840574737,CFD," 0,00 "
29/10/2024 11:13:38,Open Position,NSDQ100/USD," 300,00 ",0.294774," 0,00 "," 5.233,47 "," 3.683,47 ",2840600852,CFD," 0,00 "
29/10/2024 11:53:42,Position closed,NSDQ100/USD," 301,67 ",0.294774," 1,67 "," 5.235,14 "," 3.985,14 ",2840600852,CFD," 0,00 "
29/10/2024 12:06:53,Open Position,NSDQ100/USD," 349,99 ",0.343936," 0,00 "," 5.235,14 "," 3.635,15 ",2840625452,CFD," 0,00 "
29/10/2024 12:07:13,Open Position,NSDQ100/USD," 499,99 ",0.491360," 0,00 "," 5.235,14 "," 3.135,16 ",2840625496,CFD," 0,00 "
29/10/2024 12:07:37,Position closed,NSDQ100/USD," 342,35 ",0.343576,"(7,65)"," 5.227,49 "," 3.477,51 ",2840563188,CFD," 0,00 "
29/10/2024 12:07:49,Position closed,NSDQ100/USD," 287,98 ",0.294262,"(12,02)"," 5.215,47 "," 3.765,49 ",2840551846,CFD," 0,00 "
29/10/2024 12:09:55,Position closed,NSDQ100/USD," 282,93 ",0.294066,"(17,07)"," 5.198,40 "," 4.048,42 ",2840550029,CFD," 0,00 "
29/10/2024 12:10:13,Open Position,NSDQ100/USD," 400,00 ",0.393436," 0,00 "," 5.198,40 "," 3.648,42 ",2840626104,CFD," 0,00 "
29/10/2024 12:11:44,Position closed,NSDQ100/USD," 507,97 ",0.491360," 7,98 "," 5.206,38 "," 4.156,39 ",2840625496,CFD," 0,00 "
29/10/2024 12:12:29,Position closed,NSDQ100/USD," 353,96 ",0.343936," 3,97 "," 5.210,35 "," 4.510,35 ",2840625452,CFD," 0,00 "
29/10/2024 12:12:54,Open Position,NSDQ100/USD," 300,00 ",0.294986," 0,00 "," 5.210,35 "," 4.210,35 ",2840626678,CFD," 0,00 "
29/10/2024 12:13:40,Open Position,NSDQ100/USD," 299,99 ",0.295021," 0,00 "," 5.210,35 "," 3.910,36 ",2840626836,CFD," 0,00 "
29/10/2024 12:18:21,Position closed,NSDQ100/USD," 305,03 ",0.294986," 5,03 "," 5.215,38 "," 4.215,39 ",2840626678,CFD," 0,00 "
29/10/2024 12:18:41,Open Position,NSDQ100/USD," 399,99 ",0.392926," 0,00 "," 5.215,38 "," 3.815,40 ",2840627692,CFD," 0,00 "
29/10/2024 12:26:58,Open Position,NSDQ100/USD," 299,99 ",0.294949," 0,00 "," 5.215,38 "," 3.515,41 ",2840641373,CFD," 0,00 "
29/10/2024 12:30:26,Open Position,NSDQ100/USD," 250,00 ",0.245621," 0,00 "," 5.215,38 "," 3.265,41 ",2840642203,CFD," 0,00 "
29/10/2024 12:42:41,Position closed,NSDQ100/USD," 248,12 ",0.245621,"(1,88)"," 5.213,50 "," 3.513,53 ",2840642203,CFD," 0,00 "
29/10/2024 12:43:02,Position closed,NSDQ100/USD," 281,47 ",0.293921,"(18,53)"," 5.194,97 "," 3.795,00 ",2840506237,CFD," 0,00 "
29/10/2024 12:44:55,Position closed,NSDQ100/USD," 397,57 ",0.392926,"(2,42)"," 5.192,55 "," 4.192,57 ",2840627692,CFD," 0,00 "
29/10/2024 12:44:55,Position closed,NSDQ100/USD," 295,73 ",0.294949,"(4,26)"," 5.188,29 "," 4.488,30 ",2840641373,CFD," 0,00 "
29/10/2024 12:44:55,Position closed,NSDQ100/USD," 294,25 ",0.295021,"(5,74)"," 5.182,55 "," 4.782,55 ",2840626836,CFD," 0,00 "
29/10/2024 12:44:55,Position closed,NSDQ100/USD," 390,85 ",0.393436,"(9,15)"," 5.173,40 "," 5.173,40 ",2840626104,CFD," 0,00 "
29/10/2024 12:46:01,Open Position,NSDQ100/USD," 300,00 ",0.294760," 0,00 "," 5.173,40 "," 4.873,40 ",2840645755,CFD," 0,00 "
29/10/2024 12:46:12,Open Position,NSDQ100/USD," 400,00 ",0.393107," 0,00 "," 5.173,40 "," 4.473,40 ",2840645787,CFD," 0,00 "
29/10/2024 12:58:14,Open Position,NSDQ100/USD," 200,00 ",0.196558," 0,00 "," 5.173,40 "," 4.273,40 ",2840651903,CFD," 0,00 "
29/10/2024 13:09:29,Position closed,NSDQ100/USD," 303,85 ",0.294760," 3,85 "," 5.177,25 "," 4.577,25 ",2840645755,CFD," 0,00 "
29/10/2024 13:10:33,Open Position,NSDQ100/USD," 200,00 ",0.196424," 0,00 "," 5.177,25 "," 4.377,25 ",2840655278,CFD," 0,00 "
29/10/2024 13:19:04,Position closed,NSDQ100/USD," 398,33 ",0.393107,"(1,67)"," 5.175,58 "," 4.775,58 ",2840645787,CFD," 0,00 "
29/10/2024 13:19:04,Position closed,NSDQ100/USD," 201,80 ",0.196424," 1,80 "," 5.177,38 "," 4.977,38 ",2840655278,CFD," 0,00 "
29/10/2024 13:19:04,Position closed,NSDQ100/USD," 199,07 ",0.196558,"(0,93)"," 5.176,45 "," 5.176,45 ",2840651903,CFD," 0,00 "
29/10/2024 13:30:09,Open Position,NSDQ100/USD," 300,00 ",0.294582," 0,00 "," 5.176,45 "," 4.876,45 ",2840668306,CFD," 0,00 "
29/10/2024 13:35:15,Position closed,NSDQ100/USD," 318,07 ",0.294582," 18,07 "," 5.194,52 "," 5.194,52 ",2840668306,CFD," 0,00 "
29/10/2024 13:38:09,Open Position,NSDQ100/USD," 199,98 ",0.196843," 0,00 "," 5.194,52 "," 4.994,54 ",2840772988,CFD," 0,00 "
29/10/2024 13:44:46,Open Position,NSDQ100/USD," 300,00 ",0.294813," 0,00 "," 5.194,52 "," 4.694,54 ",2840791540,CFD," 0,00 "
29/10/2024 13:52:34,Position closed,NSDQ100/USD," 304,97 ",0.294813," 4,97 "," 5.199,49 "," 4.999,51 ",2840791540,CFD," 0,00 "
29/10/2024 13:52:34,Position closed,NSDQ100/USD," 197,02 ",0.196843,"(2,96)"," 5.196,53 "," 5.196,53 ",2840772988,CFD," 0,00 "
29/10/2024 13:53:23,Open Position,NSDQ100/USD," 349,99 ",0.343969," 0,00 "," 5.196,53 "," 4.846,54 ",2840923430,CFD," 0,00 "
29/10/2024 13:53:38,Open Position,NSDQ100/USD," 199,99 ",0.196561," 0,00 "," 5.196,53 "," 4.646,55 ",2840935644,CFD," 0,00 "
29/10/2024 14:00:25,Open Position,NSDQ100/USD," 300,00 ",0.294476," 0,00 "," 5.196,53 "," 4.346,55 ",2840961355,CFD," 0,00 "
29/10/2024 14:04:29,Open Position,NSDQ100/USD," 299,99 ",0.294146," 0,00 "," 5.196,53 "," 4.046,56 ",2840978535,CFD," 0,00 "
29/10/2024 14:08:30,Open Position,NSDQ100/USD," 349,99 ",0.343441," 0,00 "," 5.196,53 "," 3.696,57 ",2840992146,CFD," 0,00 "
29/10/2024 14:18:18,Open Position,NSDQ100/USD," 199,99 ",0.196218," 0,00 "," 5.196,53 "," 3.496,58 ",2841007394,CFD," 0,00 "
29/10/2024 14:21:05,Position closed,NSDQ100/USD," 300,47 ",0.294146," 0,48 "," 5.197,01 "," 3.797,05 ",2840978535,CFD," 0,00 "
29/10/2024 14:21:37,Open Position,NSDQ100/USD," 300,00 ",0.294100," 0,00 "," 5.197,01 "," 3.497,05 ",2841012279,CFD," 0,00 "
29/10/2024 14:29:20,Open Position,NSDQ100/USD," 350,00 ",0.342964," 0,00 "," 5.197,01 "," 3.147,05 ",2841023247,CFD," 0,00 "
29/10/2024 14:36:46,Position closed,NSDQ100/USD," 362,98 ",0.342964," 12,98 "," 5.209,99 "," 3.510,03 ",2841023247,CFD," 0,00 "
29/10/2024 14:37:55,Open Position,NSDQ100/USD," 249,99 ",0.244577," 0,00 "," 5.209,99 "," 3.260,04 ",2841040842,CFD," 0,00 "
29/10/2024 14:38:13,Open Position,NSDQ100/USD," 300,00 ",0.293523," 0,00 "," 5.209,99 "," 2.960,04 ",2841041116,CFD," 0,00 "
29/10/2024 14:43:18,Position closed,NSDQ100/USD," 251,39 ",0.244577," 1,40 "," 5.211,39 "," 3.211,43 ",2841040842,CFD," 0,00 "
29/10/2024 14:43:49,Open Position,NSDQ100/USD," 399,99 ",0.391272," 0,00 "," 5.211,39 "," 2.811,44 ",2841050350,CFD," 0,00 "
29/10/2024 14:44:15,Open Position,NSDQ100/USD," 200,00 ",0.195686," 0,00 "," 5.211,39 "," 2.611,44 ",2841050812,CFD," 0,00 "
29/10/2024 14:59:20,Position closed,NSDQ100/USD," 202,30 ",0.195686," 2,30 "," 5.213,69 "," 2.813,74 ",2841050812,CFD," 0,00 "
29/10/2024 14:59:54,Open Position,NSDQ100/USD," 200,00 ",0.195518," 0,00 "," 5.213,69 "," 2.613,74 ",2841081570,CFD," 0,00 "
29/10/2024 15:00:07,Open Position,NSDQ100/USD," 349,99 ",0.342152," 0,00 "," 5.213,69 "," 2.263,75 ",2841081841,CFD," 0,00 "
29/10/2024 15:00:22,Open Position,NSDQ100/USD," 300,00 ",0.293444," 0,00 "," 5.213,69 "," 1.963,75 ",2841082283,CFD," 0,00 "
29/10/2024 15:39:10,Position closed,NSDQ100/USD," 350,41 ",0.342152," 0,42 "," 5.214,11 "," 2.314,16 ",2841081841,CFD," 0,00 "
29/10/2024 15:39:47,Open Position,NSDQ100/USD," 249,99 ",0.244302," 0,00 "," 5.214,11 "," 2.064,17 ",2841136863,CFD," 0,00 "
29/10/2024 15:40:03,Open Position,NSDQ100/USD," 250,00 ",0.244297," 0,00 "," 5.214,11 "," 1.814,17 ",2841136983,CFD," 0,00 "
29/10/2024 16:07:54,Position closed,NSDQ100/USD," 253,16 ",0.244297," 3,16 "," 5.217,27 "," 2.067,33 ",2841136983,CFD," 0,00 "
29/10/2024 16:08:00,Position closed,NSDQ100/USD," 253,34 ",0.244302," 3,35 "," 5.220,62 "," 2.320,67 ",2841136863,CFD," 0,00 "
29/10/2024 16:08:09,Position closed,NSDQ100/USD," 204,58 ",0.195518," 4,58 "," 5.225,20 "," 2.525,25 ",2841081570,CFD," 0,00 "
29/10/2024 16:08:35,Open Position,NSDQ100/USD," 300,00 ",0.292935," 0,00 "," 5.225,20 "," 2.225,25 ",2841185973,CFD," 0,00 "
29/10/2024 16:23:59,Open Position,NSDQ100/USD," 299,99 ",0.292655," 0,00 "," 5.225,20 "," 1.925,26 ",2841202090,CFD," 0,00 "
29/10/2024 16:24:17,Open Position,NSDQ100/USD," 199,99 ",0.195142," 0,00 "," 5.225,20 "," 1.725,27 ",2841202318,CFD," 0,00 "
29/10/2024 17:10:17,Position closed,NSDQ100/USD," 308,60 ",0.292655," 8,61 "," 5.233,81 "," 2.033,87 ",2841202090,CFD," 0,00 "
29/10/2024 17:10:54,Open Position,NSDQ100/USD," 249,99 ",0.243465," 0,00 "," 5.233,81 "," 1.783,88 ",2841247116,CFD," 0,00 "
29/10/2024 17:11:02,Open Position,NSDQ100/USD," 249,98 ",0.243409," 0,00 "," 5.233,81 "," 1.533,90 ",2841247165,CFD," 0,00 "
29/10/2024 17:11:16,Open Position,NSDQ100/USD," 249,99 ",0.243461," 0,00 "," 5.233,81 "," 1.283,91 ",2841247273,CFD," 0,00 "
29/10/2024 19:07:40,Position closed,NSDQ100/USD," 255,80 ",0.243409," 5,82 "," 5.239,63 "," 1.539,71 ",2841247165,CFD," 0,00 "
29/10/2024 19:18:13,Open Position,NSDQ100/USD," 499,99 ",0.485842," 0,00 "," 5.239,63 "," 1.039,72 ",2841445888,CFD," 0,00 "
29/10/2024 19:19:32,Open Position,NSDQ100/USD," 469,99 ",0.456587," 0,00 "," 5.239,63 "," 569,73 ",2841446568,CFD," 0,00 "
29/10/2024 19:25:01,Position closed,NSDQ100/USD," 506,55 ",0.485842," 6,56 "," 5.246,19 "," 1.076,28 ",2841445888,CFD," 0,00 "
29/10/2024 19:25:06,Position closed,NSDQ100/USD," 472,78 ",0.456587," 2,79 "," 5.248,98 "," 1.549,06 ",2841446568,CFD," 0,00 "
29/10/2024 19:25:55,Open Position,NSDQ100/USD," 499,99 ",0.485443," 0,00 "," 5.248,98 "," 1.049,07 ",2841451049,CFD," 0,00 "
29/10/2024 19:26:37,Open Position,NSDQ100/USD," 349,99 ",0.339795," 0,00 "," 5.248,98 "," 699,08 ",2841451423,CFD," 0,00 "
29/10/2024 19:28:47,Open Position,GOOG/USD," 149,99 ",4.363572," 0,00 "," 5.248,98 "," 549,09 ",2841452726,CFD," 0,00 "
29/10/2024 19:29:32,Position closed,NSDQ100/USD," 501,88 ",0.485443," 1,89 "," 5.250,87 "," 1.050,97 ",2841451049,CFD," 0,00 "
29/10/2024 19:29:53,Position closed,NSDQ100/USD," 348,70 ",0.339795,"(1,29)"," 5.249,58 "," 1.399,67 ",2841451423,CFD," 0,00 "
29/10/2024 19:32:12,Open Position,NSDQ100/USD," 400,00 ",0.388368," 0,00 "," 5.249,58 "," 999,67 ",2841455654,CFD," 0,00 "
29/10/2024 19:33:20,Position closed,NSDQ100/USD," 401,59 ",0.388368," 1,59 "," 5.251,17 "," 1.401,26 ",2841455654,CFD," 0,00 "
29/10/2024 19:36:52,Open Position,NSDQ100/USD," 349,99 ",0.339927," 0,00 "," 5.251,17 "," 1.051,27 ",2841459019,CFD," 0,00 "
29/10/2024 19:37:03,Open Position,NSDQ100/USD," 250,00 ",0.242808," 0,00 "," 5.251,17 "," 801,27 ",2841459069,CFD," 0,00 "
29/10/2024 19:42:32,Position closed,NSDQ100/USD," 248,96 ",0.242808,"(1,04)"," 5.250,13 "," 1.050,23 ",2841459069,CFD," 0,00 "
29/10/2024 19:59:17,Position closed,NSDQ100/USD," 360,47 ",0.339927," 10,48 "," 5.260,61 "," 1.410,70 ",2841459019,CFD," 0,00 "
29/10/2024 20:00:10,Open Position,NSDQ100/USD," 299,99 ",0.291918," 0,00 "," 5.260,61 "," 1.110,71 ",2841476260,CFD," 0,00 "
29/10/2024 20:00:20,Open Position,NSDQ100/USD," 250,00 ",0.243229," 0,00 "," 5.260,61 "," 860,71 ",2841476294,CFD," 0,00 "
29/10/2024 20:03:23,Position closed,NSDQ100/USD," 262,43 ",0.243229," 12,43 "," 5.273,04 "," 1.123,14 ",2841476294,CFD," 0,00 "
29/10/2024 20:03:44,Open Position,NSDQ100/USD," 249,99 ",0.242737," 0,00 "," 5.273,04 "," 873,15 ",2841477166,CFD," 0,00 "
29/10/2024 20:03:57,Position closed,NSDQ100/USD," 251,52 ",0.242737," 1,53 "," 5.274,57 "," 1.124,67 ",2841477166,CFD," 0,00 "
29/10/2024 20:05:27,Open Position,NSDQ100/USD," 250,00 ",0.242860," 0,00 "," 5.274,57 "," 874,67 ",2841477524,CFD," 0,00 "
29/10/2024 20:05:42,Open Position,NSDQ100/USD," 249,99 ",0.243000," 0,00 "," 5.274,57 "," 624,68 ",2841477630,CFD," 0,00 "
29/10/2024 20:11:48,Position closed,NSDQ100/USD," 254,30 ",0.242860," 4,30 "," 5.278,87 "," 878,98 ",2841477524,CFD," 0,00 "
29/10/2024 20:19:16,Position closed,NSDQ100/USD," 251,16 ",0.243000," 1,17 "," 5.280,04 "," 1.130,14 ",2841477630,CFD," 0,00 "
29/10/2024 20:20:33,Open Position,NSDQ100/USD," 300,00 ",0.291594," 0,00 "," 5.280,04 "," 830,14 ",2841480223,CFD," 0,00 "
29/10/2024 20:21:27,Open Position,NSDQ100/USD," 500,00 ",0.485942," 0,00 "," 5.280,04 "," 330,14 ",2841480345,CFD," 0,00 "
29/10/2024 20:22:47,Position closed,NSDQ100/USD," 299,13 ",0.291594,"(0,87)"," 5.279,17 "," 629,27 ",2841480223,CFD," 0,00 "
29/10/2024 20:29:43,Open Position,NSDQ100/USD," 199,99 ",0.194375," 0,00 "," 5.279,17 "," 429,28 ",2841481395,CFD," 0,00 "
29/10/2024 20:31:17,Position closed,NSDQ100/USD," 293,72 ",0.291918,"(6,27)"," 5.272,90 "," 723,00 ",2841476260,CFD," 0,00 "
29/10/2024 20:36:16,Position closed,NSDQ100/USD," 198,22 ",0.194375,"(1,77)"," 5.271,13 "," 921,22 ",2841481395,CFD," 0,00 "
29/10/2024 22:13:41,Position closed,NSDQ100/USD," 507,44 ",0.485942," 7,44 "," 5.278,57 "," 1.428,66 ",2841480345,CFD," 0,00 "
29/10/2024 22:13:55,Open Position,NSDQ100/USD," 299,99 ",0.291367," 0,00 "," 5.278,57 "," 1.128,67 ",2841489537,CFD," 0,00 "
29/10/2024 22:48:54,Open Position,NSDQ100/USD," 150,00 ",0.145531," 0,00 "," 5.278,57 "," 978,67 ",2841492976,CFD," 0,00 "
29/10/2024 22:54:03,Open Position,NSDQ100/USD," 299,99 ",0.291036," 0,00 "," 5.278,57 "," 678,68 ",2841493329,CFD," 0,00 "
29/10/2024 23:03:27,Open Position,NSDQ100/USD," 349,99 ",0.339668," 0,00 "," 5.278,57 "," 328,69 ",2841494209,CFD," 0,00 "
29/10/2024 23:18:41,Open Position,NSDQ100/USD," 99,99 ",0.097051," 0,00 "," 5.278,57 "," 228,70 ",2841495510,CFD," 0,00 "
30/10/2024 00:49:41,Overnight fee,Daily,"(0,02)",-,"(0,02)"," 5.278,55 "," 228,68 ",2841202318,CFD," 0,00 "
30/10/2024 00:49:41,Overnight fee,Daily,"(0,02)",-,"(0,02)"," 5.278,53 "," 228,66 ",2841007394,CFD," 0,00 "
30/10/2024 00:49:41,Overnight fee,Daily,"(0,02)",-,"(0,02)"," 5.278,51 "," 228,64 ",2840935644,CFD," 0,00 "
30/10/2024 00:49:41,Overnight fee,Daily,"(0,03)",-,"(0,03)"," 5.278,48 "," 228,61 ",2841247273,CFD," 0,00 "
30/10/2024 00:49:41,Overnight fee,Daily,"(0,03)",-,"(0,03)"," 5.278,45 "," 228,58 ",2841185973,CFD," 0,00 "
30/10/2024 00:49:41,Overnight fee,Daily,"(0,03)",-,"(0,03)"," 5.278,42 "," 228,55 ",2841041116,CFD," 0,00 "
30/10/2024 00:49:41,Overnight fee,Daily,"(0,03)",-,"(0,03)"," 5.278,39 "," 228,52 ",2841247116,CFD," 0,00 "
30/10/2024 00:49:41,Overnight fee,Daily,"(0,03)",-,"(0,03)"," 5.278,36 "," 228,49 ",2840961355,CFD," 0,00 "
30/10/2024 00:49:41,Overnight fee,Daily,"(0,03)",-,"(0,03)"," 5.278,33 "," 228,46 ",2841082283,CFD," 0,00 "
30/10/2024 00:49:41,Overnight fee,Daily,"(0,03)",-,"(0,03)"," 5.278,30 "," 228,43 ",2841012279,CFD," 0,00 "
30/10/2024 00:49:41,Overnight fee,Daily,"(0,04)",-,"(0,04)"," 5.278,26 "," 228,39 ",2840992146,CFD," 0,00 "
30/10/2024 00:49:41,Overnight fee,Daily,"(0,04)",-,"(0,04)"," 5.278,22 "," 228,35 ",2840923430,CFD," 0,00 "
30/10/2024 00:49:41,Overnight fee,Daily,"(0,04)",-,"(0,04)"," 5.278,18 "," 228,31 ",2841050350,CFD," 0,00 "
30/10/2024 00:49:41,Overnight fee,Daily,"(0,23)",-,"(0,23)"," 5.277,95 "," 228,08 ",2841452726,CFD," 0,00 "
30/10/2024 00:49:41,Overnight fee,Daily,"(2,51)",-,"(2,51)"," 5.275,44 "," 225,57 ",2841480345,CFD," 0,00 "
30/10/2024 05:58:24,Position closed,NSDQ100/USD," 360,86 ",0.339668," 10,87 "," 5.286,31 "," 586,43 ",2841494209,CFD," 0,00 "
30/10/2024 06:00:25,Position closed,NSDQ100/USD," 311,46 ",0.291036," 11,47 "," 5.297,78 "," 897,89 ",2841493329,CFD," 0,00 "
30/10/2024 06:00:39,Position closed,NSDQ100/USD," 103,03 ",0.097051," 3,04 "," 5.300,82 "," 1.000,92 ",2841495510,CFD," 0,00 "
30/10/2024 06:01:32,Position closed,NSDQ100/USD," 184,66 ",0.195142,"(15,33)"," 5.285,49 "," 1.185,58 ",2841202318,CFD," 0,00 "
30/10/2024 06:02:14,Open Position,NSDQ100/USD," 300,00 ",0.291561," 0,00 "," 5.285,49 "," 885,58 ",2841520769,CFD," 0,00 "
30/10/2024 06:03:13,Open Position,NSDQ100/USD," 230,00 ",0.223583," 0,00 "," 5.285,49 "," 655,58 ",2841520864,CFD," 0,00 "
30/10/2024 06:46:43,Position closed,NSDQ100/USD," 308,19 ",0.291561," 8,19 "," 5.293,68 "," 963,77 ",2841520769,CFD," 0,00 "
30/10/2024 06:47:44,Open Position,NSDQ100/USD," 250,00 ",0.242615," 0,00 "," 5.293,68 "," 713,77 ",2841527137,CFD," 0,00 "
30/10/2024 07:37:54,Position closed,NSDQ100/USD," 253,04 ",0.242615," 3,04 "," 5.296,72 "," 966,81 ",2841527137,CFD," 0,00 "
30/10/2024 07:38:03,Position closed,NSDQ100/USD," 148,65 ",0.145531,"(1,35)"," 5.295,37 "," 1.115,46 ",2841492976,CFD," 0,00 "
30/10/2024 07:39:59,Open Position,NSDQ100/USD," 250,00 ",0.242529," 0,00 "," 5.295,37 "," 865,46 ",2841534035,CFD," 0,00 "
30/10/2024 08:00:37,Open Position,NSDQ100/USD," 100,00 ",0.097028," 0,00 "," 5.295,37 "," 765,46 ",2841551573,CFD," 0,00 "
30/10/2024 09:00:50,Position closed,NSDQ100/USD," 302,21 ",0.291367," 2,22 "," 5.297,59 "," 1.067,67 ",2841489537,CFD," 0,00 "
30/10/2024 09:03:52,Position closed,NSDQ100/USD," 96,41 ",0.097028,"(3,59)"," 5.294,00 "," 1.164,08 ",2841551573,CFD," 0,00 "
30/10/2024 09:16:37,Open Position,NSDQ100/USD," 249,99 ",0.242756," 0,00 "," 5.294,00 "," 914,09 ",2841608880,CFD," 0,00 "
30/10/2024 10:06:54,Position closed,NSDQ100/USD," 250,55 ",0.242756," 0,56 "," 5.294,56 "," 1.164,64 ",2841608880,CFD," 0,00 "
30/10/2024 12:13:12,Open Position,NSDQ100/USD," 300,00 ",0.291565," 0,00 "," 5.294,56 "," 864,64 ",2841661566,CFD," 0,00 "
30/10/2024 12:13:29,Position closed,NSDQ100/USD," 228,71 ",0.223583,"(1,29)"," 5.293,27 "," 1.093,35 ",2841520864,CFD," 0,00 "
30/10/2024 13:07:57,Position closed,NSDQ100/USD," 255,97 ",0.243461," 5,98 "," 5.299,25 "," 1.349,32 ",2841247273,CFD," 0,00 "
30/10/2024 13:08:48,Position closed,NSDQ100/USD," 253,98 ",0.243465," 3,99 "," 5.303,24 "," 1.603,30 ",2841247116,CFD," 0,00 "
30/10/2024 13:12:37,Open Position,NSDQ100/USD," 249,99 ",0.243532," 0,00 "," 5.303,24 "," 1.353,31 ",2841682342,CFD," 0,00 "
30/10/2024 13:13:34,Position closed,NSDQ100/USD," 285,40 ",0.291565,"(14,60)"," 5.288,64 "," 1.638,71 ",2841661566,CFD," 0,00 "
30/10/2024 13:21:21,Position closed,NSDQ100/USD," 250,99 ",0.243532," 1,00 "," 5.289,64 "," 1.889,70 ",2841682342,CFD," 0,00 "
30/10/2024 13:21:43,Open Position,NSDQ100/USD," 299,98 ",0.292355," 0,00 "," 5.289,64 "," 1.589,72 ",2841685025,CFD," 0,00 "
30/10/2024 13:23:30,Open Position,NSDQ100/USD," 299,99 ",0.292486," 0,00 "," 5.289,64 "," 1.289,73 ",2841685399,CFD," 0,00 "
30/10/2024 13:31:22,Position closed,GOOG/USD," 196,37 ",4.363572," 46,38 "," 5.336,02 "," 1.486,10 ",2841452726,CFD," 0,00 "
30/10/2024 13:32:08,Open Position,NSDQ100/USD," 200,00 ",0.194895," 0,00 "," 5.336,02 "," 1.286,10 ",2841768782,CFD," 0,00 "
30/10/2024 13:32:25,Position closed,NSDQ100/USD," 199,17 ",0.194895,"(0,83)"," 5.335,19 "," 1.485,27 ",2841768782,CFD," 0,00 "
30/10/2024 13:34:49,Position closed,NSDQ100/USD," 220,55 ",0.242529,"(29,45)"," 5.305,74 "," 1.705,82 ",2841534035,CFD," 0,00 "
30/10/2024 13:35:11,Position closed,NSDQ100/USD," 310,38 ",0.292355," 10,40 "," 5.316,14 "," 2.016,20 ",2841685025,CFD," 0,00 "
30/10/2024 13:35:48,Position closed,NSDQ100/USD," 302,56 ",0.292486," 2,57 "," 5.318,71 "," 2.318,76 ",2841685399,CFD," 0,00 "
30/10/2024 13:36:23,Open Position,NSDQ100/USD," 300,00 ",0.292712," 0,00 "," 5.318,71 "," 2.018,76 ",2841783831,CFD," 0,00 "
30/10/2024 13:36:36,Open Position,NSDQ100/USD," 510,00 ",0.497891," 0,00 "," 5.318,71 "," 1.508,76 ",2841784389,CFD," 0,00 "
30/10/2024 13:37:08,Position closed,NSDQ100/USD," 301,38 ",0.292712," 1,38 "," 5.320,09 "," 1.810,14 ",2841783831,CFD," 0,00 "
30/10/2024 13:38:22,Open Position,NSDQ100/USD," 249,99 ",0.243965," 0,00 "," 5.320,09 "," 1.560,15 ",2841790944,CFD," 0,00 "
30/10/2024 13:39:57,Position closed,NSDQ100/USD," 302,15 ",0.292935," 2,15 "," 5.322,24 "," 1.862,30 ",2841185973,CFD," 0,00 "
30/10/2024 13:40:29,Position closed,NSDQ100/USD," 520,12 ",0.497891," 10,12 "," 5.332,36 "," 2.382,42 ",2841784389,CFD," 0,00 "
30/10/2024 13:40:45,Open Position,NSDQ100/USD," 300,00 ",0.293287," 0,00 "," 5.332,36 "," 2.082,42 ",2841796718,CFD," 0,00 "
30/10/2024 13:41:58,Position closed,NSDQ100/USD," 300,89 ",0.293523," 0,89 "," 5.333,25 "," 2.383,31 ",2841041116,CFD," 0,00 "
30/10/2024 13:42:41,Position closed,NSDQ100/USD," 266,34 ",0.243965," 16,35 "," 5.349,60 "," 2.649,65 ",2841790944,CFD," 0,00 "
30/10/2024 13:43:50,Position closed,NSDQ100/USD," 412,17 ",0.391272," 12,18 "," 5.361,78 "," 3.061,82 ",2841050350,CFD," 0,00 "
30/10/2024 13:44:16,Position closed,NSDQ100/USD," 326,03 ",0.343969,"(23,96)"," 5.337,82 "," 3.387,85 ",2840923430,CFD," 0,00 "
30/10/2024 13:44:16,Position closed,NSDQ100/USD," 186,22 ",0.196561,"(13,77)"," 5.324,05 "," 3.574,07 ",2840935644,CFD," 0,00 "
30/10/2024 13:44:16,Position closed,NSDQ100/USD," 286,70 ",0.294476,"(13,30)"," 5.310,75 "," 3.860,77 ",2840961355,CFD," 0,00 "
30/10/2024 13:44:16,Position closed,NSDQ100/USD," 336,82 ",0.343441,"(13,17)"," 5.297,58 "," 4.197,59 ",2840992146,CFD," 0,00 "
30/10/2024 13:44:16,Position closed,NSDQ100/USD," 193,15 ",0.196218,"(6,84)"," 5.290,74 "," 4.390,74 ",2841007394,CFD," 0,00 "
30/10/2024 13:44:16,Position closed,NSDQ100/USD," 307,79 ",0.293444," 7,79 "," 5.298,53 "," 4.698,53 ",2841082283,CFD," 0,00 "
30/10/2024 13:44:16,Position closed,NSDQ100/USD," 294,39 ",0.294100,"(5,61)"," 5.292,92 "," 4.992,92 ",2841012279,CFD," 0,00 "
30/10/2024 13:44:16,Position closed,NSDQ100/USD," 310,98 ",0.293287," 10,98 "," 5.303,90 "," 5.303,90 ",2841796718,CFD," 0,00 "
30/10/2024 13:44:56,Open Position,NSDQ100/USD," 349,99 ",0.342797," 0,00 "," 5.303,90 "," 4.953,91 ",2841807133,CFD," 0,00 "
30/10/2024 13:46:23,Position closed,NSDQ100/USD," 345,68 ",0.342797,"(4,31)"," 5.299,59 "," 5.299,59 ",2841807133,CFD," 0,00 "
30/10/2024 13:47:24,Open Position,NSDQ100/USD," 250,00 ",0.244629," 0,00 "," 5.299,59 "," 5.049,59 ",2841814028,CFD," 0,00 "
30/10/2024 13:48:25,Position closed,NSDQ100/USD," 251,28 ",0.244629," 1,28 "," 5.300,87 "," 5.300,87 ",2841814028,CFD," 0,00 "
30/10/2024 13:49:47,Open Position,NSDQ100/USD," 300,00 ",0.293531," 0,00 "," 5.300,87 "," 5.000,87 ",2841822243,CFD," 0,00 "
30/10/2024 13:51:16,Open Position,NSDQ100/USD," 299,99 ",0.293261," 0,00 "," 5.300,87 "," 4.700,88 ",2841870044,CFD," 0,00 "
30/10/2024 13:53:07,Open Position,MSFT/USD," 199,99 ",2.299212," 0,00 "," 5.300,87 "," 4.500,89 ",2841887128,CFD," 0,00 "
30/10/2024 13:55:59,Open Position,NSDQ100/USD," 250,00 ",0.244032," 0,00 "," 5.300,87 "," 4.250,89 ",2841894783,CFD," 0,00 "
30/10/2024 13:56:09,Position closed,NSDQ100/USD," 307,86 ",0.293261," 7,87 "," 5.308,74 "," 4.558,75 ",2841870044,CFD," 0,00 "
30/10/2024 13:59:54,Open Position,NSDQ100/USD," 399,99 ",0.390274," 0,00 "," 5.308,74 "," 4.158,76 ",2841904356,CFD," 0,00 "
30/10/2024 14:00:08,Open Position,NSDQ100/USD," 249,99 ",0.243902," 0,00 "," 5.308,74 "," 3.908,77 ",2841905819,CFD," 0,00 "
30/10/2024 14:05:02,Open Position,NSDQ100/USD," 299,99 ",0.292248," 0,00 "," 5.308,74 "," 3.608,78 ",2841916801,CFD," 0,00 "
30/10/2024 14:05:14,Position closed,NSDQ100/USD," 257,28 ",0.244032," 7,28 "," 5.316,02 "," 3.866,06 ",2841894783,CFD," 0,00 "
30/10/2024 14:07:54,Position closed,NSDQ100/USD," 255,29 ",0.243902," 5,30 "," 5.321,32 "," 4.121,35 ",2841905819,CFD," 0,00 "
30/10/2024 14:09:10,Open Position,NSDQ100/USD," 199,99 ",0.194892," 0,00 "," 5.321,32 "," 3.921,36 ",2841922762,CFD," 0,00 "
30/10/2024 14:09:21,Open Position,NSDQ100/USD," 249,99 ",0.243525," 0,00 "," 5.321,32 "," 3.671,37 ",2841923130,CFD," 0,00 "
30/10/2024 14:32:09,Position closed,NSDQ100/USD," 305,37 ",0.292248," 5,38 "," 5.326,70 "," 3.976,74 ",2841916801,CFD," 0,00 "
30/10/2024 14:32:31,Position closed,NSDQ100/USD," 194,01 ",0.194892,"(5,98)"," 5.320,72 "," 4.170,75 ",2841922762,CFD," 0,00 "
30/10/2024 14:32:36,Position closed,NSDQ100/USD," 255,08 ",0.243525," 5,09 "," 5.325,81 "," 4.425,83 ",2841923130,CFD," 0,00 "
30/10/2024 14:32:45,Open Position,NSDQ100/USD," 299,99 ",0.291897," 0,00 "," 5.325,81 "," 4.125,84 ",2841999722,CFD," 0,00 "
30/10/2024 15:55:51,Open Position,NSDQ100/USD," 429,99 ",0.389470," 0,00 "," 5.325,81 "," 3.725,84 ",2842133872,CFD," 0,00 "
30/10/2024 18:10:26,Position closed,NSDQ100/USD," 405,78 ",0.390274," 5,79 "," 5.331,60 "," 4.131,62 ",2841904356,CFD," 0,00 "
30/10/2024 18:10:45,Open Position,MSFT/USD," 150,00 ",1.722109," 0,00 "," 5.331,60 "," 3.981,62 ",2842271686,CFD," 0,00 "
30/10/2024 18:11:23,Open Position,META/USD," 99,98 ",0.840010," 0,00 "," 5.331,60 "," 3.881,64 ",2842271878,CFD," 0,00 "
30/10/2024 18:11:36,Open Position,NSDQ100/USD," 300,00 ",0.293057," 0,00 "," 5.331,60 "," 3.581,64 ",2842272007,CFD," 0,00 "
30/10/2024 18:28:08,Open Position,NSDQ100/USD," 500,00 ",0.488679," 0,00 "," 5.331,60 "," 3.081,64 ",2842281096,CFD," 0,00 "
30/10/2024 19:04:52,Position closed,NSDQ100/USD," 308,24 ",0.293057," 8,24 "," 5.339,84 "," 3.389,88 ",2842272007,CFD," 0,00 "
30/10/2024 19:04:59,Position closed,NSDQ100/USD," 509,20 ",0.488679," 9,20 "," 5.349,04 "," 3.899,08 ",2842281096,CFD," 0,00 "
30/10/2024 19:05:34,Open Position,NSDQ100/USD," 299,99 ",0.293550," 0,00 "," 5.349,04 "," 3.599,09 ",2842298201,CFD," 0,00 "
30/10/2024 19:05:49,Open Position,NSDQ100/USD," 349,99 ",0.342577," 0,00 "," 5.349,04 "," 3.249,10 ",2842298375,CFD," 0,00 "
30/10/2024 19:51:55,Position closed,NSDQ100/USD," 302,74 ",0.293531," 2,74 "," 5.351,78 "," 3.551,84 ",2841822243,CFD," 0,00 "
30/10/2024 19:58:52,Position closed,NSDQ100/USD," 364,05 ",0.342577," 14,06 "," 5.365,84 "," 3.915,89 ",2842298375,CFD," 0,00 "
30/10/2024 19:59:59,Open Position,NSDQ100/USD," 299,99 ",0.294006," 0,00 "," 5.365,84 "," 3.615,90 ",2842349827,CFD," 0,00 "
30/10/2024 20:00:11,Open Position,NSDQ100/USD," 200,00 ",0.196064," 0,00 "," 5.365,84 "," 3.415,90 ",2842349882,CFD," 0,00 "
30/10/2024 20:08:19,Position closed,NSDQ100/USD," 201,69 ",0.196064," 1,69 "," 5.367,53 "," 3.617,59 ",2842349882,CFD," 0,00 "
30/10/2024 20:21:04,Open Position,NSDQ100/USD," 500,00 ",0.491293," 0,00 "," 5.367,53 "," 3.117,59 ",2842355905,CFD," 0,00 "
30/10/2024 20:27:40,Position closed,NSDQ100/USD," 516,83 ",0.491293," 16,83 "," 5.384,36 "," 3.634,42 ",2842355905,CFD," 0,00 "
30/10/2024 22:06:49,Open Position,NSDQ100/USD," 349,99 ",0.344663," 0,00 "," 5.384,36 "," 3.284,43 ",2842364906,CFD," 0,00 "
30/10/2024 22:18:24,Position closed,NSDQ100/USD," 351,04 ",0.344663," 1,05 "," 5.385,41 "," 3.635,47 ",2842364906,CFD," 0,00 "
30/10/2024 22:19:26,Open Position,NSDQ100/USD," 909,99 ",0.896135," 0,00 "," 5.385,41 "," 2.725,48 ",2842367034,CFD," 0,00 "
30/10/2024 22:21:09,Open Position,NSDQ100/USD," 299,99 ",0.295549," 0,00 "," 5.385,41 "," 2.425,49 ",2842370443,CFD," 0,00 "
30/10/2024 22:22:27,Open Position,NSDQ100/USD," 300,00 ",0.295544," 0,00 "," 5.385,41 "," 2.125,49 ",2842370522,CFD," 0,00 "
30/10/2024 22:35:51,Position closed,NSDQ100/USD," 295,84 ",0.295549,"(4,15)"," 5.381,26 "," 2.421,33 ",2842370443,CFD," 0,00 "
30/10/2024 22:37:21,Open Position,NSDQ100/USD," 250,00 ",0.246082," 0,00 "," 5.381,26 "," 2.171,33 ",2842371548,CFD," 0,00 "
30/10/2024 22:40:32,Open Position,NSDQ100/USD," 249,99 ",0.246226," 0,00 "," 5.381,26 "," 1.921,34 ",2842371721,CFD," 0,00 "
31/10/2024 00:05:15,Position closed,NSDQ100/USD," 256,21 ",0.246226," 6,22 "," 5.387,48 "," 2.177,55 ",2842371721,CFD," 0,00 "
31/10/2024 00:06:49,Open Position,NSDQ100/USD," 300,00 ",0.295854," 0,00 "," 5.387,48 "," 1.877,55 ",2842376287,CFD," 0,00 "
31/10/2024 00:07:07,Open Position,NSDQ100/USD," 349,99 ",0.345292," 0,00 "," 5.387,48 "," 1.527,56 ",2842376307,CFD," 0,00 "
31/10/2024 00:29:46,Index price adjustment,NSDQ100/USD," 0,48 ",-," 0,48 "," 5.387,96 "," 1.528,04 ",2841999722,CFD," 0,00 "
31/10/2024 00:29:46,Index price adjustment,NSDQ100/USD," 0,64 ",-," 0,64 "," 5.388,60 "," 1.528,68 ",2842133872,CFD," 0,00 "
31/10/2024 00:29:46,Index price adjustment,NSDQ100/USD," 0,48 ",-," 0,48 "," 5.389,08 "," 1.529,16 ",2842298201,CFD," 0,00 "
31/10/2024 00:29:46,Index price adjustment,NSDQ100/USD," 0,48 ",-," 0,48 "," 5.389,56 "," 1.529,64 ",2842349827,CFD," 0,00 "
31/10/2024 00:48:49,Overnight fee,Daily,"(0,15)",-,"(0,15)"," 5.389,41 "," 1.529,49 ",2842271878,CFD," 0,00 "
31/10/2024 00:48:49,Overnight fee,Daily,"(0,23)",-,"(0,23)"," 5.389,18 "," 1.529,26 ",2842271686,CFD," 0,00 "
31/10/2024 00:48:49,Overnight fee,Daily,"(0,30)",-,"(0,30)"," 5.388,88 "," 1.528,96 ",2841887128,CFD," 0,00 "
31/10/2024 00:48:49,Overnight fee,Daily,"(1,51)",-,"(1,51)"," 5.387,37 "," 1.527,45 ",2841999722,CFD," 0,00 "
31/10/2024 00:48:49,Overnight fee,Daily,"(1,52)",-,"(1,52)"," 5.385,85 "," 1.525,93 ",2842298201,CFD," 0,00 "
31/10/2024 00:48:49,Overnight fee,Daily,"(1,52)",-,"(1,52)"," 5.384,33 "," 1.524,41 ",2842349827,CFD," 0,00 "
31/10/2024 00:48:49,Overnight fee,Daily,"(2,01)",-,"(2,01)"," 5.382,32 "," 1.522,40 ",2842133872,CFD," 0,00 "
31/10/2024 07:17:28,Position closed,NSDQ100/USD," 376,94 ",0.345292," 26,95 "," 5.409,27 "," 1.899,34 ",2842376307,CFD," 0,00 "
31/10/2024 07:20:56,Open Position,NSDQ100/USD," 349,99 ",0.346681," 0,00 "," 5.409,27 "," 1.549,35 ",2842412890,CFD," 0,00 "
31/10/2024 07:23:41,Open Position,NSDQ100/USD," 350,00 ",0.346481," 0,00 "," 5.409,27 "," 1.199,35 ",2842413223,CFD," 0,00 "
31/10/2024 07:35:28,Open Position,NSDQ100/USD," 399,99 ",0.395974," 0,00 "," 5.409,27 "," 799,36 ",2842414960,CFD," 0,00 "
31/10/2024 07:56:16,Open Position,NSDQ100/USD," 199,99 ",0.198131," 0,00 "," 5.409,27 "," 599,37 ",2842417936,CFD," 0,00 "
31/10/2024 07:57:06,Open Position,NSDQ100/USD," 200,00 ",0.198164," 0,00 "," 5.409,27 "," 399,37 ",2842418030,CFD," 0,00 "
31/10/2024 08:03:57,Position closed,NSDQ100/USD," 202,11 ",0.198164," 2,11 "," 5.411,38 "," 601,48 ",2842418030,CFD," 0,00 "
31/10/2024 08:10:38,Open Position,NSDQ100/USD," 250,00 ",0.247816," 0,00 "," 5.411,38 "," 351,48 ",2842445133,CFD," 0,00 "
31/10/2024 08:11:09,Position closed,NSDQ100/USD," 249,55 ",0.247816,"(0,45)"," 5.410,93 "," 601,03 ",2842445133,CFD," 0,00 "
31/10/2024 08:13:04,Open Position,NSDQ100/USD," 300,00 ",0.297474," 0,00 "," 5.410,93 "," 301,03 ",2842445633,CFD," 0,00 "
31/10/2024 09:15:00,Position closed,NSDQ100/USD," 303,14 ",0.297474," 3,14 "," 5.414,07 "," 604,17 ",2842445633,CFD," 0,00 "
31/10/2024 09:32:50,Open Position,NSDQ100/USD," 300,00 ",0.297326," 0,00 "," 5.414,07 "," 304,17 ",2842479155,CFD," 0,00 "
31/10/2024 09:47:11,Position closed,NSDQ100/USD," 350,67 ",0.346681," 0,68 "," 5.414,75 "," 654,84 ",2842412890,CFD," 0,00 "
31/10/2024 09:47:39,Position closed,NSDQ100/USD," 200,84 ",0.198131," 0,85 "," 5.415,60 "," 855,68 ",2842417936,CFD," 0,00 "
31/10/2024 09:48:25,Position closed,NSDQ100/USD," 301,95 ",0.297326," 1,95 "," 5.417,55 "," 1.157,63 ",2842479155,CFD," 0,00 "
31/10/2024 09:49:44,Open Position,NSDQ100/USD," 300,00 ",0.297258," 0,00 "," 5.417,55 "," 857,63 ",2842485430,CFD," 0,00 "
31/10/2024 09:58:08,Position closed,NSDQ100/USD," 300,38 ",0.297258," 0,38 "," 5.417,93 "," 1.158,01 ",2842485430,CFD," 0,00 "
31/10/2024 09:58:58,Open Position,NSDQ100/USD," 300,00 ",0.297216," 0,00 "," 5.417,93 "," 858,01 ",2842487187,CFD," 0,00 "
31/10/2024 10:14:48,Open Position,NSDQ100/USD," 350,00 ",0.347154," 0,00 "," 5.417,93 "," 508,01 ",2842490792,CFD," 0,00 "
31/10/2024 10:22:32,Position closed,NSDQ100/USD," 352,49 ",0.347154," 2,49 "," 5.420,42 "," 860,50 ",2842490792,CFD," 0,00 "
31/10/2024 10:23:30,Open Position,NSDQ100/USD," 350,00 ",0.347044," 0,00 "," 5.420,42 "," 510,50 ",2842511760,CFD," 0,00 "
31/10/2024 10:26:55,Position closed,NSDQ100/USD," 352,52 ",0.347044," 2,52 "," 5.422,94 "," 863,02 ",2842511760,CFD," 0,00 "
31/10/2024 10:35:11,Open Position,NSDQ100/USD," 300,00 ",0.297298," 0,00 "," 5.422,94 "," 563,02 ",2842514220,CFD," 0,00 "
31/10/2024 10:47:29,Position closed,NSDQ100/USD," 300,41 ",0.297298," 0,41 "," 5.423,35 "," 863,43 ",2842514220,CFD," 0,00 "
31/10/2024 11:01:07,Position closed,NSDQ100/USD," 352,80 ",0.346481," 2,80 "," 5.426,15 "," 1.216,23 ",2842413223,CFD," 0,00 "
31/10/2024 11:02:09,Position closed,NSDQ100/USD," 403,38 ",0.395974," 3,39 "," 5.429,54 "," 1.619,61 ",2842414960,CFD," 0,00 "
31/10/2024 11:05:14,Position closed,NSDQ100/USD," 310,81 ",0.297216," 10,81 "," 5.440,35 "," 1.930,42 ",2842487187,CFD," 0,00 "
31/10/2024 11:07:58,Open Position,NSDQ100/USD," 300,00 ",0.296703," 0,00 "," 5.440,35 "," 1.630,42 ",2842522052,CFD," 0,00 "
31/10/2024 11:08:10,Open Position,NSDQ100/USD," 299,99 ",0.296778," 0,00 "," 5.440,35 "," 1.330,43 ",2842522085,CFD," 0,00 "
31/10/2024 11:10:55,Open Position,NSDQ100/USD," 249,99 ",0.247363," 0,00 "," 5.440,35 "," 1.080,44 ",2842522748,CFD," 0,00 "
31/10/2024 11:20:20,Position closed,NSDQ100/USD," 301,89 ",0.296703," 1,89 "," 5.442,24 "," 1.382,33 ",2842522052,CFD," 0,00 "
31/10/2024 11:20:43,Open Position,NSDQ100/USD," 349,99 ",0.345962," 0,00 "," 5.442,24 "," 1.032,34 ",2842526156,CFD," 0,00 "
31/10/2024 12:36:04,Position closed,NSDQ100/USD," 356,17 ",0.345962," 6,18 "," 5.448,42 "," 1.388,51 ",2842526156,CFD," 0,00 "
31/10/2024 12:38:20,Open Position,NSDQ100/USD," 350,00 ",0.345581," 0,00 "," 5.448,42 "," 1.038,51 ",2842546239,CFD," 0,00 "
31/10/2024 12:44:46,Position closed,NSDQ100/USD," 354,31 ",0.345581," 4,31 "," 5.452,73 "," 1.392,82 ",2842546239,CFD," 0,00 "
31/10/2024 12:45:19,Open Position,NSDQ100/USD," 250,00 ",0.246568," 0,00 "," 5.452,73 "," 1.142,82 ",2842547990,CFD," 0,00 "
31/10/2024 12:59:09,Open Position,NSDQ100/USD," 300,00 ",0.296284," 0,00 "," 5.452,73 "," 842,82 ",2842551828,CFD," 0,00 "
31/10/2024 13:10:29,Open Position,NSDQ100/USD," 200,00 ",0.197632," 0,00 "," 5.452,73 "," 642,82 ",2842555148,CFD," 0,00 "
31/10/2024 13:31:16,Position closed,NSDQ100/USD," 207,81 ",0.197632," 7,81 "," 5.460,54 "," 850,63 ",2842555148,CFD," 0,00 "
31/10/2024 13:31:23,Position closed,NSDQ100/USD," 305,93 ",0.296778," 5,94 "," 5.466,48 "," 1.156,56 ",2842522085,CFD," 0,00 "
31/10/2024 13:31:53,Position closed,META/USD," 85,85 ",0.840010,"(14,13)"," 5.452,35 "," 1.242,41 ",2842271878,CFD," 0,00 "
31/10/2024 13:33:28,Position closed,NSDQ100/USD," 269,54 ",0.247363," 19,55 "," 5.471,90 "," 1.511,95 ",2842522748,CFD," 0,00 "
31/10/2024 13:34:10,Open Position,NSDQ100/USD," 299,99 ",0.297941," 0,00 "," 5.471,90 "," 1.211,96 ",2842635927,CFD," 0,00 "
31/10/2024 13:34:24,Open Position,NSDQ100/USD," 250,00 ",0.248201," 0,00 "," 5.471,90 "," 961,96 ",2842637612,CFD," 0,00 "
31/10/2024 13:38:06,Position closed,NSDQ100/USD," 306,90 ",0.297941," 6,91 "," 5.478,81 "," 1.268,86 ",2842635927,CFD," 0,00 "
31/10/2024 13:38:30,Position closed,NSDQ100/USD," 252,25 ",0.248201," 2,25 "," 5.481,06 "," 1.521,11 ",2842637612,CFD," 0,00 "
31/10/2024 13:39:40,Open Position,NSDQ100/USD," 299,99 ",0.297919," 0,00 "," 5.481,06 "," 1.221,12 ",2842660947,CFD," 0,00 "
31/10/2024 13:46:06,Open Position,NSDQ100/USD," 350,00 ",0.348203," 0,00 "," 5.481,06 "," 871,12 ",2842682210,CFD," 0,00 "
31/10/2024 13:49:34,Position closed,NSDQ100/USD," 149,88 ",0.291897,"(150,11)"," 5.330,95 "," 1.021,00 ",2841999722,CFD," 0,00 "
31/10/2024 13:49:47,Edit Stop Loss,-,"(10,51)",-," 0,00 "," 5.330,95 "," 1.010,49 ",2842133872,-," 0,00 "
31/10/2024 13:51:13,Edit Stop Loss,-,"(19,48)",-," 0,00 "," 5.330,95 "," 991,01 ",2842133872,-," 0,00 "
31/10/2024 13:51:24,Open Position,NSDQ100/USD," 419,99 ",0.419078," 0,00 "," 5.330,95 "," 571,02 ",2842739905,CFD," 0,00 "
31/10/2024 14:04:33,Open Position,NSDQ100/USD," 299,99 ",0.299597," 0,00 "," 5.330,95 "," 271,03 ",2842814545,CFD," 0,00 "
31/10/2024 14:07:11,Position closed,NSDQ100/USD," 302,18 ",0.299597," 2,19 "," 5.333,14 "," 573,21 ",2842814545,CFD," 0,00 "
31/10/2024 14:09:48,Open Position,NSDQ100/USD," 299,99 ",0.299608," 0,00 "," 5.333,14 "," 273,22 ",2842835968,CFD," 0,00 "
31/10/2024 14:21:05,Position closed,NSDQ100/USD," 307,00 ",0.299608," 7,01 "," 5.340,15 "," 580,22 ",2842835968,CFD," 0,00 "
31/10/2024 14:21:26,Position closed,NSDQ100/USD," 423,55 ",0.419078," 3,56 "," 5.343,71 "," 1.003,77 ",2842739905,CFD," 0,00 "
31/10/2024 14:23:49,Open Position,NSDQ100/USD," 299,99 ",0.299110," 0,00 "," 5.343,71 "," 703,78 ",2842882765,CFD," 0,00 "
31/10/2024 14:32:41,Open Position,NSDQ100/USD," 299,96 ",0.299730," 0,00 "," 5.343,71 "," 403,82 ",2842901183,CFD," 0,00 "
31/10/2024 14:44:57,Open Position,NSDQ100/USD," 299,99 ",0.300123," 0,00 "," 5.343,71 "," 103,83 ",2842927275,CFD," 0,00 "
31/10/2024 14:49:42,Position closed,NSDQ100/USD," 199,84 ",0.389470,"(230,15)"," 5.113,56 "," 303,67 ",2842133872,CFD," 0,00 "
31/10/2024 14:53:29,Open Position,NSDQ100/USD," 200,00 ",0.200393," 0,00 "," 5.113,56 "," 103,67 ",2842947142,CFD," 0,00 "
31/10/2024 15:02:29,Position closed,NSDQ100/USD," 150,21 ",0.293550,"(149,78)"," 4.963,78 "," 253,88 ",2842298201,CFD," 0,00 "
31/10/2024 15:39:40,Open Position,NSDQ100/USD," 200,00 ",0.200679," 0,00 "," 4.963,78 "," 53,88 ",2843027073,CFD," 0,00 "
31/10/2024 15:51:43,Position closed,NSDQ100/USD," 149,92 ",0.294006,"(150,07)"," 4.813,71 "," 203,80 ",2842349827,CFD," 0,00 "
31/10/2024 15:54:42,Open Position,NSDQ100/USD," 149,99 ",0.150738," 0,00 "," 4.813,71 "," 53,81 ",2843048396,CFD," 0,00 "
31/10/2024 16:02:13,Position closed,NSDQ100/USD," 154,03 ",0.150738," 4,04 "," 4.817,75 "," 207,84 ",2843048396,CFD," 0,00 "
31/10/2024 16:04:27,Deposit,3800.00 USDRON CreditCard," 806,47 ",-," 806,47 "," 5.624,22 "," 1.014,31 ",-,-," 0,00 "
31/10/2024 16:04:27,Deposit Conversion Fee,-,"(23,79)",-," 0,00 "," 5.624,22 "," 1.014,31 ",-,-," 0,00 "
31/10/2024 16:04:59,Open Position,NSDQ100/USD," 399,98 ",0.401198," 0,00 "," 5.624,22 "," 614,33 ",2843068750,CFD," 0,00 "
31/10/2024 16:09:35,Position closed,NSDQ100/USD," 402,91 ",0.401198," 2,93 "," 5.627,15 "," 1.017,24 ",2843068750,CFD," 0,00 "
31/10/2024 16:09:42,Position closed,NSDQ100/USD," 202,33 ",0.200679," 2,33 "," 5.629,48 "," 1.219,57 ",2843027073,CFD," 0,00 "
31/10/2024 16:11:45,Open Position,NSDQ100/USD," 399,99 ",0.401164," 0,00 "," 5.629,48 "," 819,58 ",2843078829,CFD," 0,00 "
31/10/2024 16:29:16,Open Position,NSDQ100/USD," 250,00 ",0.250652," 0,00 "," 5.629,48 "," 569,58 ",2843102368,CFD," 0,00 "
31/10/2024 16:46:58,Position closed,NSDQ100/USD," 253,04 ",0.250652," 3,04 "," 5.632,52 "," 822,62 ",2843102368,CFD," 0,00 "
31/10/2024 16:47:08,Position closed,NSDQ100/USD," 405,45 ",0.401164," 5,46 "," 5.637,98 "," 1.228,07 ",2843078829,CFD," 0,00 "
31/10/2024 16:47:36,Open Position,NSDQ100/USD," 349,99 ",0.350639," 0,00 "," 5.637,98 "," 878,08 ",2843119205,CFD," 0,00 "
31/10/2024 16:47:53,Open Position,NSDQ100/USD," 200,00 ",0.200356," 0,00 "," 5.637,98 "," 678,08 ",2843119311,CFD," 0,00 "
31/10/2024 17:47:24,Open Position,NSDQ100/USD," 299,99 ",0.301406," 0,00 "," 5.637,98 "," 378,09 ",2843168144,CFD," 0,00 "
31/10/2024 18:00:14,Open Position,NVDA/USD," 99,98 ",3.754804," 0,00 "," 5.637,98 "," 278,11 ",2843177029,CFD," 0,00 "
31/10/2024 18:49:25,Position closed,NVDA/USD," 96,08 ",3.754804,"(3,90)"," 5.634,08 "," 374,19 ",2843177029,CFD," 0,00 "
31/10/2024 18:50:06,Open Position,NSDQ100/USD," 299,99 ",0.301544," 0,00 "," 5.634,08 "," 74,20 ",2843221070,CFD," 0,00 "
31/10/2024 18:52:24,Position closed,NSDQ100/USD," 300,12 ",0.301544," 0,13 "," 5.634,21 "," 374,32 ",2843221070,CFD," 0,00 "
31/10/2024 18:52:38,Open Position,NSDQ100/USD," 299,99 ",0.301514," 0,00 "," 5.634,21 "," 74,33 ",2843225290,CFD," 0,00 "
31/10/2024 19:01:25,Position closed,NSDQ100/USD," 305,63 ",0.301514," 5,64 "," 5.639,85 "," 379,96 ",2843225290,CFD," 0,00 "
31/10/2024 19:01:53,Position closed,NSDQ100/USD," 305,51 ",0.301406," 5,52 "," 5.645,37 "," 685,47 ",2843168144,CFD," 0,00 "
31/10/2024 19:02:41,Open Position,NSDQ100/USD," 250,00 ",0.250911," 0,00 "," 5.645,37 "," 435,47 ",2843231742,CFD," 0,00 "
31/10/2024 19:38:37,Position closed,NSDQ100/USD," 252,91 ",0.250911," 2,91 "," 5.648,28 "," 688,38 ",2843231742,CFD," 0,00 "
31/10/2024 19:49:31,Position closed,NSDQ100/USD," 300,98 ",0.300123," 0,99 "," 5.649,27 "," 989,36 ",2842927275,CFD," 0,00 "
31/10/2024 19:50:35,Position closed,NSDQ100/USD," 205,83 ",0.200393," 5,83 "," 5.655,10 "," 1.195,19 ",2842947142,CFD," 0,00 "
31/10/2024 19:51:04,Position closed,NSDQ100/USD," 358,20 ",0.350639," 8,21 "," 5.663,31 "," 1.553,39 ",2843119205,CFD," 0,00 "
31/10/2024 19:51:38,Position closed,NSDQ100/USD," 201,66 ",0.200356," 1,66 "," 5.664,97 "," 1.755,05 ",2843119311,CFD," 0,00 "
31/10/2024 19:54:00,Open Position,NSDQ100/USD," 350,00 ",0.350925," 0,00 "," 5.664,97 "," 1.405,05 ",2843272479,CFD," 0,00 "
31/10/2024 19:59:56,Open Position,NSDQ100/USD," 360,00 ",0.362053," 0,00 "," 5.664,97 "," 1.045,05 ",2843281302,CFD," 0,00 "
31/10/2024 20:00:07,Open Position,NSDQ100/USD," 350,00 ",0.351769," 0,00 "," 5.664,97 "," 695,05 ",2843281396,CFD," 0,00 "
31/10/2024 20:07:22,Position closed,NSDQ100/USD," 372,26 ",0.362053," 12,26 "," 5.677,23 "," 1.067,31 ",2843281302,CFD," 0,00 "
31/10/2024 20:07:29,Position closed,NSDQ100/USD," 354,09 ",0.351769," 4,09 "," 5.681,32 "," 1.421,40 ",2843281396,CFD," 0,00 "
31/10/2024 20:07:42,Open Position,NSDQ100/USD," 449,99 ",0.451845," 0,00 "," 5.681,32 "," 971,41 ",2843285586,CFD," 0,00 "
31/10/2024 20:08:10,Open Position,NSDQ100/USD," 199,99 ",0.200791," 0,00 "," 5.681,32 "," 771,42 ",2843285671,CFD," 0,00 "
31/10/2024 20:12:22,Open Position,NSDQ100/USD," 300,00 ",0.301206," 0,00 "," 5.681,32 "," 471,42 ",2843286314,CFD," 0,00 "
31/10/2024 20:16:54,Open Position,NSDQ100/USD," 249,99 ",0.250805," 0,00 "," 5.681,32 "," 221,43 ",2843287212,CFD," 0,00 "
31/10/2024 20:18:04,Position closed,NSDQ100/USD," 457,22 ",0.451845," 7,23 "," 5.688,55 "," 678,65 ",2843285586,CFD," 0,00 "
31/10/2024 20:18:10,Position closed,NSDQ100/USD," 202,16 ",0.200791," 2,17 "," 5.690,72 "," 880,81 ",2843285671,CFD," 0,00 "
31/10/2024 20:18:21,Position closed,NSDQ100/USD," 303,02 ",0.301206," 3,02 "," 5.693,74 "," 1.183,83 ",2843286314,CFD," 0,00 "
31/10/2024 20:18:31,Open Position,NSDQ100/USD," 300,00 ",0.300981," 0,00 "," 5.693,74 "," 883,83 ",2843287394,CFD," 0,00 "
31/10/2024 20:18:49,Open Position,NSDQ100/USD," 350,00 ",0.351283," 0,00 "," 5.693,74 "," 533,83 ",2843287439,CFD," 0,00 "
31/10/2024 20:35:02,Open Position,NSDQ100/USD," 300,00 ",0.301418," 0,00 "," 5.693,74 "," 233,83 ",2843290531,CFD," 0,00 "
31/10/2024 22:21:51,Position closed,NSDQ100/USD," 350,55 ",0.350925," 0,55 "," 5.694,29 "," 584,38 ",2843272479,CFD," 0,00 "
31/10/2024 22:22:43,Position closed,NSDQ100/USD," 253,55 ",0.250805," 3,56 "," 5.697,85 "," 837,93 ",2843287212,CFD," 0,00 "
31/10/2024 22:22:56,Position closed,NSDQ100/USD," 303,76 ",0.300981," 3,76 "," 5.701,61 "," 1.141,69 ",2843287394,CFD," 0,00 "
31/10/2024 22:23:03,Position closed,NSDQ100/USD," 357,34 ",0.351283," 7,34 "," 5.708,95 "," 1.499,03 ",2843287439,CFD," 0,00 "
31/10/2024 22:23:18,Position closed,NSDQ100/USD," 313,05 ",0.301418," 13,05 "," 5.722,00 "," 1.812,08 ",2843290531,CFD," 0,00 "
31/10/2024 22:24:07,Open Position,NSDQ100/USD," 300,00 ",0.300726," 0,00 "," 5.722,00 "," 1.512,08 ",2843298399,CFD," 0,00 "
31/10/2024 22:25:10,Open Position,NSDQ100/USD," 350,00 ",0.350822," 0,00 "," 5.722,00 "," 1.162,08 ",2843298450,CFD," 0,00 "
31/10/2024 22:25:20,Open Position,NSDQ100/USD," 149,99 ",0.150352," 0,00 "," 5.722,00 "," 1.012,09 ",2843298458,CFD," 0,00 "
01/11/2024 00:48:46,Overnight fee,Daily,"(0,21)",-,"(0,21)"," 5.721,79 "," 1.011,88 ",2842271686,CFD," 0,00 "
01/11/2024 00:48:46,Overnight fee,Daily,"(0,28)",-,"(0,28)"," 5.721,51 "," 1.011,60 ",2841887128,CFD," 0,00 "
01/11/2024 00:48:46,Overnight fee,Daily,"(1,27)",-,"(1,27)"," 5.720,24 "," 1.010,33 ",2842547990,CFD," 0,00 "
01/11/2024 00:48:46,Overnight fee,Daily,"(1,27)",-,"(1,27)"," 5.718,97 "," 1.009,06 ",2842371548,CFD," 0,00 "
01/11/2024 00:48:46,Overnight fee,Daily,"(1,30)",-,"(1,30)"," 5.717,67 "," 1.007,76 ",2843287212,CFD," 0,00 "
01/11/2024 00:48:46,Overnight fee,Daily,"(1,53)",-,"(1,53)"," 5.716,14 "," 1.006,23 ",2842551828,CFD," 0,00 "
01/11/2024 00:48:46,Overnight fee,Daily,"(1,53)",-,"(1,53)"," 5.714,61 "," 1.004,70 ",2842370522,CFD," 0,00 "
01/11/2024 00:48:46,Overnight fee,Daily,"(1,53)",-,"(1,53)"," 5.713,08 "," 1.003,17 ",2842376287,CFD," 0,00 "
01/11/2024 00:48:46,Overnight fee,Daily,"(1,54)",-,"(1,54)"," 5.711,54 "," 1.001,63 ",2842882765,CFD," 0,00 "
01/11/2024 00:48:46,Overnight fee,Daily,"(1,54)",-,"(1,54)"," 5.710,00 "," 1.000,09 ",2842660947,CFD," 0,00 "
01/11/2024 00:48:46,Overnight fee,Daily,"(1,55)",-,"(1,55)"," 5.708,45 "," 998,54 ",2842901183,CFD," 0,00 "
01/11/2024 00:48:46,Overnight fee,Daily,"(1,55)",-,"(1,55)"," 5.706,90 "," 996,99 ",2843287394,CFD," 0,00 "
01/11/2024 00:48:46,Overnight fee,Daily,"(1,56)",-,"(1,56)"," 5.705,34 "," 995,43 ",2843290531,CFD," 0,00 "
01/11/2024 00:48:46,Overnight fee,Daily,"(1,80)",-,"(1,80)"," 5.703,54 "," 993,63 ",2842682210,CFD," 0,00 "
01/11/2024 00:48:46,Overnight fee,Daily,"(1,81)",-,"(1,81)"," 5.701,73 "," 991,82 ",2843272479,CFD," 0,00 "
01/11/2024 00:48:46,Overnight fee,Daily,"(1,81)",-,"(1,81)"," 5.699,92 "," 990,01 ",2843287439,CFD," 0,00 "
01/11/2024 00:48:46,Overnight fee,Daily,"(4,63)",-,"(4,63)"," 5.695,29 "," 985,38 ",2842367034,CFD," 0,00 "
01/11/2024 01:08:33,Index price adjustment,NSDQ100/USD," 0,61 ",-," 0,61 "," 5.695,90 "," 985,99 ",2842367034,CFD," 0,00 "
01/11/2024 01:08:33,Index price adjustment,NSDQ100/USD," 0,20 ",-," 0,20 "," 5.696,10 "," 986,19 ",2842370522,CFD," 0,00 "
01/11/2024 01:08:33,Index price adjustment,NSDQ100/USD," 0,17 ",-," 0,17 "," 5.696,27 "," 986,36 ",2842371548,CFD," 0,00 "
01/11/2024 01:08:33,Index price adjustment,NSDQ100/USD," 0,20 ",-," 0,20 "," 5.696,47 "," 986,56 ",2842376287,CFD," 0,00 "
01/11/2024 01:08:33,Index price adjustment,NSDQ100/USD," 0,17 ",-," 0,17 "," 5.696,64 "," 986,73 ",2842547990,CFD," 0,00 "
01/11/2024 01:08:33,Index price adjustment,NSDQ100/USD," 0,20 ",-," 0,20 "," 5.696,84 "," 986,93 ",2842551828,CFD," 0,00 "
01/11/2024 01:08:33,Index price adjustment,NSDQ100/USD," 0,20 ",-," 0,20 "," 5.697,04 "," 987,13 ",2842660947,CFD," 0,00 "
01/11/2024 01:08:33,Index price adjustment,NSDQ100/USD," 0,24 ",-," 0,24 "," 5.697,28 "," 987,37 ",2842682210,CFD," 0,00 "
01/11/2024 01:08:33,Index price adjustment,NSDQ100/USD," 0,20 ",-," 0,20 "," 5.697,48 "," 987,57 ",2842882765,CFD," 0,00 "
01/11/2024 01:08:33,Index price adjustment,NSDQ100/USD," 0,20 ",-," 0,20 "," 5.697,68 "," 987,77 ",2842901183,CFD," 0,00 "
01/11/2024 01:08:33,Index price adjustment,NSDQ100/USD," 0,24 ",-," 0,24 "," 5.697,92 "," 988,01 ",2843272479,CFD," 0,00 "
01/11/2024 01:08:33,Index price adjustment,NSDQ100/USD," 0,25 ",-," 0,25 "," 5.698,17 "," 988,26 ",2843281302,CFD," 0,00 "
01/11/2024 06:32:41,Position closed,NSDQ100/USD," 304,63 ",0.300726," 4,63 "," 5.702,80 "," 1.292,89 ",2843298399,CFD," 0,00 "
01/11/2024 06:32:47,Position closed,NSDQ100/USD," 354,70 ",0.350822," 4,70 "," 5.707,50 "," 1.647,59 ",2843298450,CFD," 0,00 "
01/11/2024 06:32:55,Position closed,NSDQ100/USD," 151,83 ",0.150352," 1,84 "," 5.709,34 "," 1.799,42 ",2843298458,CFD," 0,00 "
01/11/2024 06:35:31,Open Position,NSDQ100/USD," 350,00 ",0.350539," 0,00 "," 5.709,34 "," 1.449,42 ",2843323478,CFD," 0,00 "
01/11/2024 06:35:51,Open Position,NSDQ100/USD," 350,00 ",0.350520," 0,00 "," 5.709,34 "," 1.099,42 ",2843323579,CFD," 0,00 "
01/11/2024 06:36:11,Open Position,NSDQ100/USD," 250,00 ",0.250373," 0,00 "," 5.709,34 "," 849,42 ",2843323599,CFD," 0,00 "
01/11/2024 08:16:52,Position closed,NSDQ100/USD," 252,10 ",0.250373," 2,10 "," 5.711,44 "," 1.101,52 ",2843323599,CFD," 0,00 "
01/11/2024 08:17:18,Position closed,NSDQ100/USD," 353,65 ",0.350520," 3,65 "," 5.715,09 "," 1.455,17 ",2843323579,CFD," 0,00 "
01/11/2024 08:18:14,Position closed,NSDQ100/USD," 353,54 ",0.350539," 3,54 "," 5.718,63 "," 1.808,71 ",2843323478,CFD," 0,00 "
01/11/2024 08:20:09,Open Position,NSDQ100/USD," 350,00 ",0.350329," 0,00 "," 5.718,63 "," 1.458,71 ",2843353226,CFD," 0,00 "
01/11/2024 08:30:35,Open Position,NSDQ100/USD," 300,00 ",0.300258," 0,00 "," 5.718,63 "," 1.158,71 ",2843371468,CFD," 0,00 "
01/11/2024 09:29:14,Position closed,NSDQ100/USD," 352,49 ",0.350329," 2,49 "," 5.721,12 "," 1.511,20 ",2843353226,CFD," 0,00 "
01/11/2024 09:32:30,Open Position,NSDQ100/USD," 479,99 ",0.480381," 0,00 "," 5.721,12 "," 1.031,21 ",2843384650,CFD," 0,00 "
01/11/2024 09:32:38,Open Position,NSDQ100/USD," 250,00 ",0.250203," 0,00 "," 5.721,12 "," 781,21 ",2843384700,CFD," 0,00 "
01/11/2024 10:22:51,Position closed,NSDQ100/USD," 300,09 ",0.300258," 0,09 "," 5.721,21 "," 1.081,30 ",2843371468,CFD," 0,00 "
01/11/2024 10:52:23,Position closed,NSDQ100/USD," 482,82 ",0.480381," 2,83 "," 5.724,04 "," 1.564,12 ",2843384650,CFD," 0,00 "
01/11/2024 10:52:30,Position closed,NSDQ100/USD," 251,48 ",0.250203," 1,48 "," 5.725,52 "," 1.815,60 ",2843384700,CFD," 0,00 "
01/11/2024 10:52:55,Open Position,NSDQ100/USD," 300,00 ",0.300115," 0,00 "," 5.725,52 "," 1.515,60 ",2843405349,CFD," 0,00 "
01/11/2024 10:53:27,Open Position,NSDQ100/USD," 250,00 ",0.250087," 0,00 "," 5.725,52 "," 1.265,60 ",2843405427,CFD," 0,00 "
01/11/2024 10:58:32,Open Position,NSDQ100/USD," 250,00 ",0.250060," 0,00 "," 5.725,52 "," 1.015,60 ",2843406498,CFD," 0,00 "
01/11/2024 11:40:28,Position closed,NSDQ100/USD," 302,25 ",0.300115," 2,25 "," 5.727,77 "," 1.317,85 ",2843405349,CFD," 0,00 "
01/11/2024 11:40:34,Position closed,NSDQ100/USD," 251,15 ",0.250060," 1,15 "," 5.728,92 "," 1.569,00 ",2843406498,CFD," 0,00 "
01/11/2024 11:40:56,Position closed,NSDQ100/USD," 252,08 ",0.250087," 2,08 "," 5.731,00 "," 1.821,08 ",2843405427,CFD," 0,00 "
01/11/2024 11:41:04,Open Position,NSDQ100/USD," 350,00 ",0.349909," 0,00 "," 5.731,00 "," 1.471,08 ",2843416204,CFD," 0,00 "
01/11/2024 11:41:54,Open Position,NSDQ100/USD," 300,00 ",0.299920," 0,00 "," 5.731,00 "," 1.171,08 ",2843416303,CFD," 0,00 "
01/11/2024 13:25:47,Open Position,NSDQ100/USD," 349,99 ",0.350532," 0,00 "," 5.731,00 "," 821,09 ",2843451497,CFD," 0,00 "
01/11/2024 13:31:07,Position closed,NSDQ100/USD," 354,32 ",0.350532," 4,33 "," 5.735,33 "," 1.175,41 ",2843451497,CFD," 0,00 "
01/11/2024 13:31:21,Open Position,NSDQ100/USD," 299,99 ",0.300346," 0,00 "," 5.735,33 "," 875,42 ",2843525658,CFD," 0,00 "
01/11/2024 13:33:43,Position closed,NSDQ100/USD," 301,37 ",0.300346," 1,38 "," 5.736,71 "," 1.176,79 ",2843525658,CFD," 0,00 "
01/11/2024 13:35:59,Open Position,NSDQ100/USD," 299,99 ",0.300431," 0,00 "," 5.736,71 "," 876,80 ",2843588281,CFD," 0,00 "
01/11/2024 13:42:46,Position closed,NSDQ100/USD," 301,49 ",0.299730," 1,53 "," 5.738,24 "," 1.178,29 ",2842901183,CFD," 0,00 "
01/11/2024 13:44:07,Position closed,NSDQ100/USD," 357,93 ",0.349909," 7,93 "," 5.746,17 "," 1.536,22 ",2843416204,CFD," 0,00 "
01/11/2024 13:44:12,Position closed,NSDQ100/USD," 316,30 ",0.300431," 16,31 "," 5.762,48 "," 1.852,52 ",2843588281,CFD," 0,00 "
01/11/2024 13:44:17,Position closed,NSDQ100/USD," 306,22 ",0.299920," 6,22 "," 5.768,70 "," 2.158,74 ",2843416303,CFD," 0,00 "
01/11/2024 13:44:54,Open Position,NSDQ100/USD," 299,99 ",0.299545," 0,00 "," 5.768,70 "," 1.858,75 ",2843604430,CFD," 0,00 "
01/11/2024 13:57:49,Position closed,NSDQ100/USD," 305,38 ",0.299545," 5,39 "," 5.774,09 "," 2.164,13 ",2843604430,CFD," 0,00 "
01/11/2024 13:59:33,Open Position,NSDQ100/USD," 249,99 ",0.249345," 0,00 "," 5.774,09 "," 1.914,14 ",2843764657,CFD," 0,00 "
01/11/2024 14:08:27,Position closed,NSDQ100/USD," 299,87 ",0.299110,"(0,12)"," 5.773,97 "," 2.214,01 ",2842882765,CFD," 0,00 "
01/11/2024 14:11:45,Position closed,NSDQ100/USD," 254,47 ",0.249345," 4,48 "," 5.778,45 "," 2.468,48 ",2843764657,CFD," 0,00 "
01/11/2024 14:12:07,Open Position,NSDQ100/USD," 299,99 ",0.298808," 0,00 "," 5.778,45 "," 2.168,49 ",2843787450,CFD," 0,00 "
01/11/2024 14:14:23,Position closed,NSDQ100/USD," 303,30 ",0.298808," 3,31 "," 5.781,76 "," 2.471,79 ",2843787450,CFD," 0,00 "
01/11/2024 14:15:02,Open Position,NSDQ100/USD," 400,00 ",0.398044," 0,00 "," 5.781,76 "," 2.071,79 ",2843791396,CFD," 0,00 "
01/11/2024 14:21:17,Position closed,NSDQ100/USD," 404,06 ",0.398044," 4,06 "," 5.785,82 "," 2.475,85 ",2843791396,CFD," 0,00 "
01/11/2024 14:21:23,Position closed,NSDQ100/USD," 352,12 ",0.348203," 2,12 "," 5.787,94 "," 2.827,97 ",2842682210,CFD," 0,00 "
01/11/2024 14:22:03,Open Position,NSDQ100/USD," 530,00 ",0.526785," 0,00 "," 5.787,94 "," 2.297,97 ",2843804298,CFD," 0,00 "
01/11/2024 14:27:19,Position closed,NSDQ100/USD," 532,62 ",0.526785," 2,62 "," 5.790,56 "," 2.830,59 ",2843804298,CFD," 0,00 "
01/11/2024 14:27:58,Open Position,NSDQ100/USD," 299,98 ",0.298059," 0,00 "," 5.790,56 "," 2.530,61 ",2843832236,CFD," 0,00 "
01/11/2024 14:35:30,Position closed,NSDQ100/USD," 300,01 ",0.297919," 0,02 "," 5.790,58 "," 2.830,62 ",2842660947,CFD," 0,00 "
01/11/2024 14:35:57,Position closed,NSDQ100/USD," 302,18 ",0.298059," 2,20 "," 5.792,78 "," 3.132,80 ",2843832236,CFD," 0,00 "
01/11/2024 14:37:57,Open Position,NSDQ100/USD," 350,00 ",0.347861," 0,00 "," 5.792,78 "," 2.782,80 ",2843857823,CFD," 0,00 "
01/11/2024 14:38:39,Open Position,NSDQ100/USD," 350,00 ",0.347864," 0,00 "," 5.792,78 "," 2.432,80 ",2843859641,CFD," 0,00 "
01/11/2024 14:42:50,Open Position,NSDQ100/USD," 250,00 ",0.248836," 0,00 "," 5.792,78 "," 2.182,80 ",2843866282,CFD," 0,00 "
01/11/2024 14:59:07,Position closed,NSDQ100/USD," 252,96 ",0.248836," 2,96 "," 5.795,74 "," 2.435,76 ",2843866282,CFD," 0,00 "
01/11/2024 15:04:47,Position closed,NSDQ100/USD," 349,12 ",0.347864,"(0,88)"," 5.794,86 "," 2.784,88 ",2843859641,CFD," 0,00 "
01/11/2024 15:17:11,Position closed,NSDQ100/USD," 354,62 ",0.347861," 4,62 "," 5.799,48 "," 3.139,50 ",2843857823,CFD," 0,00 "
01/11/2024 15:17:32,Open Position,NSDQ100/USD," 299,99 ",0.297864," 0,00 "," 5.799,48 "," 2.839,51 ",2843911975,CFD," 0,00 "
01/11/2024 15:29:33,Position closed,NSDQ100/USD," 303,32 ",0.297864," 3,33 "," 5.802,81 "," 3.142,83 ",2843911975,CFD," 0,00 "
01/11/2024 15:30:11,Open Position,NSDQ100/USD," 400,00 ",0.396800," 0,00 "," 5.802,81 "," 2.742,83 ",2843924539,CFD," 0,00 "
01/11/2024 15:55:32,Open Position,NSDQ100/USD," 200,00 ",0.198977," 0,00 "," 5.802,81 "," 2.542,83 ",2843959591,CFD," 0,00 "
01/11/2024 16:03:18,Position closed,NSDQ100/USD," 202,18 ",0.198977," 2,18 "," 5.804,99 "," 2.745,01 ",2843959591,CFD," 0,00 "
01/11/2024 16:09:58,Open Position,NSDQ100/USD," 299,99 ",0.298080," 0,00 "," 5.804,99 "," 2.445,02 ",2843968076,CFD," 0,00 "
01/11/2024 16:11:34,Open Position,NSDQ100/USD," 150,00 ",0.149093," 0,00 "," 5.804,99 "," 2.295,02 ",2843968808,CFD," 0,00 "
01/11/2024 16:45:57,Position closed,NSDQ100/USD," 155,26 ",0.149093," 5,26 "," 5.810,25 "," 2.450,28 ",2843968808,CFD," 0,00 "
01/11/2024 18:12:28,Open Position,NSDQ100/USD," 299,98 ",0.299603," 0,00 "," 5.810,25 "," 2.150,30 ",2844072146,CFD," 0,00 "
01/11/2024 18:24:38,Position closed,NSDQ100/USD," 305,88 ",0.299603," 5,90 "," 5.816,15 "," 2.456,18 ",2844072146,CFD," 0,00 "
01/11/2024 20:26:57,Open Position,NSDQ100/USD," 250,00 ",0.249418," 0,00 "," 5.816,15 "," 2.206,18 ",2844147051,CFD," 0,00 "
02/11/2024 00:12:46,Index price adjustment,NSDQ100/USD," 0,25 ",-," 0,25 "," 5.816,40 "," 2.206,43 ",2842367034,CFD," 0,00 "
02/11/2024 00:12:46,Index price adjustment,NSDQ100/USD," 0,08 ",-," 0,08 "," 5.816,48 "," 2.206,51 ",2842370522,CFD," 0,00 "
02/11/2024 00:12:46,Index price adjustment,NSDQ100/USD," 0,07 ",-," 0,07 "," 5.816,55 "," 2.206,58 ",2842371548,CFD," 0,00 "
02/11/2024 00:12:46,Index price adjustment,NSDQ100/USD," 0,08 ",-," 0,08 "," 5.816,63 "," 2.206,66 ",2842376287,CFD," 0,00 "
02/11/2024 00:12:46,Index price adjustment,NSDQ100/USD," 0,07 ",-," 0,07 "," 5.816,70 "," 2.206,73 ",2842547990,CFD," 0,00 "
02/11/2024 00:12:46,Index price adjustment,NSDQ100/USD," 0,08 ",-," 0,08 "," 5.816,78 "," 2.206,81 ",2842551828,CFD," 0,00 "
02/11/2024 00:12:46,Index price adjustment,NSDQ100/USD," 0,11 ",-," 0,11 "," 5.816,89 "," 2.206,92 ",2843924539,CFD," 0,00 "
02/11/2024 00:12:46,Index price adjustment,NSDQ100/USD," 0,08 ",-," 0,08 "," 5.816,97 "," 2.207,00 ",2843968076,CFD," 0,00 "
02/11/2024 00:49:10,Overnight fee,Weekend Fee,"(0,08)",-,"(0,08)"," 5.816,89 "," 2.206,92 ",2844147051,CFD," 0,00 "
02/11/2024 00:49:10,Overnight fee,Weekend Fee,"(0,65)",-,"(0,65)"," 5.816,24 "," 2.206,27 ",2842271686,CFD," 0,00 "
02/11/2024 00:49:10,Overnight fee,Weekend Fee,"(0,86)",-,"(0,86)"," 5.815,38 "," 2.205,41 ",2841887128,CFD," 0,00 "
02/11/2024 00:49:10,Overnight fee,Weekend Fee,"(3,81)",-,"(3,81)"," 5.811,57 "," 2.201,60 ",2842371548,CFD," 0,00 "
02/11/2024 00:49:10,Overnight fee,Weekend Fee,"(3,82)",-,"(3,82)"," 5.807,75 "," 2.197,78 ",2842547990,CFD," 0,00 "
02/11/2024 00:49:10,Overnight fee,Weekend Fee,"(4,58)",-,"(4,58)"," 5.803,17 "," 2.193,20 ",2842376287,CFD," 0,00 "
02/11/2024 00:49:10,Overnight fee,Weekend Fee,"(4,58)",-,"(4,58)"," 5.798,59 "," 2.188,62 ",2842370522,CFD," 0,00 "
02/11/2024 00:49:10,Overnight fee,Weekend Fee,"(4,59)",-,"(4,59)"," 5.794,00 "," 2.184,03 ",2842551828,CFD," 0,00 "
02/11/2024 00:49:10,Overnight fee,Weekend Fee,"(4,62)",-,"(4,62)"," 5.789,38 "," 2.179,41 ",2843968076,CFD," 0,00 "
02/11/2024 00:49:10,Overnight fee,Weekend Fee,"(6,15)",-,"(6,15)"," 5.783,23 "," 2.173,26 ",2843924539,CFD," 0,00 "
02/11/2024 00:49:10,Overnight fee,Weekend Fee,"(13,89)",-,"(13,89)"," 5.769,34 "," 2.159,37 ",2842367034,CFD," 0,00 "
03/11/2024 23:01:28,Open Position,NSDQ100/USD," 349,98 ",0.350468," 0,00 "," 5.769,34 "," 1.809,39 ",2844216730,CFD," 0,00 "
04/11/2024 00:48:52,Position closed,NSDQ100/USD," 258,48 ",0.249418," 8,48 "," 5.777,82 "," 2.067,87 ",2844147051,CFD," 0,00 "
04/11/2024 00:49:08,Open Position,NSDQ100/USD," 249,99 ",0.249847," 0,00 "," 5.777,82 "," 1.817,88 ",2844226989,CFD," 0,00 "
04/11/2024 06:16:17,Position closed,NSDQ100/USD," 278,12 ",0.249847," 28,13 "," 5.805,95 "," 2.096,00 ",2844226989,CFD," 0,00 "
04/11/2024 06:16:37,Position closed,NSDQ100/USD," 298,78 ",0.298080,"(1,21)"," 5.804,74 "," 2.394,78 ",2843968076,CFD," 0,00 "
04/11/2024 06:17:10,Open Position,NSDQ100/USD," 300,00 ",0.298055," 0,00 "," 5.804,74 "," 2.094,78 ",2844253504,CFD," 0,00 "
04/11/2024 07:21:05,Open Position,NSDQ100/USD," 350,00 ",0.348092," 0,00 "," 5.804,74 "," 1.744,78 ",2844259597,CFD," 0,00 "
04/11/2024 07:47:23,Open Position,NSDQ100/USD," 300,00 ",0.298886," 0,00 "," 5.804,74 "," 1.444,78 ",2844262156,CFD," 0,00 "
04/11/2024 09:13:00,Open Position,NSDQ100/USD," 200,00 ",0.199632," 0,00 "," 5.804,74 "," 1.244,78 ",2844334888,CFD," 0,00 "
04/11/2024 13:30:33,Position closed,NSDQ100/USD," 198,42 ",0.199632,"(1,58)"," 5.803,16 "," 1.443,20 ",2844334888,CFD," 0,00 "
04/11/2024 13:34:16,Open Position,NSDQ100/USD," 199,99 ",0.199479," 0,00 "," 5.803,16 "," 1.243,21 ",2844565449,CFD," 0,00 "
04/11/2024 14:37:13,Position closed,NSDQ100/USD," 373,72 ",0.350468," 23,74 "," 5.826,90 "," 1.616,93 ",2844216730,CFD," 0,00 "
04/11/2024 14:39:12,Open Position,NSDQ100/USD," 349,99 ",0.351531," 0,00 "," 5.826,90 "," 1.266,94 ",2844769658,CFD," 0,00 "
04/11/2024 14:41:42,Position closed,NSDQ100/USD," 364,72 ",0.351531," 14,73 "," 5.841,63 "," 1.631,66 ",2844769658,CFD," 0,00 "
04/11/2024 14:42:51,Open Position,NSDQ100/USD," 299,99 ",0.300626," 0,00 "," 5.841,63 "," 1.331,67 ",2844793067,CFD," 0,00 "
04/11/2024 14:49:52,Position closed,NSDQ100/USD," 315,93 ",0.300626," 15,94 "," 5.857,57 "," 1.647,60 ",2844793067,CFD," 0,00 "
04/11/2024 14:51:00,Open Position,NSDQ100/USD," 249,99 ",0.250130," 0,00 "," 5.857,57 "," 1.397,61 ",2844816145,CFD," 0,00 "
04/11/2024 15:00:20,Position closed,NSDQ100/USD," 257,62 ",0.250130," 7,63 "," 5.865,20 "," 1.655,23 ",2844816145,CFD," 0,00 "
04/11/2024 15:00:43,Open Position,NSDQ100/USD," 400,00 ",0.399691," 0,00 "," 5.865,20 "," 1.255,23 ",2845032739,CFD," 0,00 "
04/11/2024 15:07:29,Position closed,NSDQ100/USD," 406,95 ",0.399691," 6,95 "," 5.872,15 "," 1.662,18 ",2845032739,CFD," 0,00 "
04/11/2024 15:08:10,Open Position,NSDQ100/USD," 299,99 ",0.299657," 0,00 "," 5.872,15 "," 1.362,19 ",2845049755,CFD," 0,00 "
04/11/2024 15:20:36,Position closed,NSDQ100/USD," 306,58 ",0.299657," 6,59 "," 5.878,74 "," 1.668,77 ",2845049755,CFD," 0,00 "
04/11/2024 15:21:12,Position closed,NSDQ100/USD," 200,52 ",0.199479," 0,53 "," 5.879,27 "," 1.869,29 ",2844565449,CFD," 0,00 "
04/11/2024 15:50:06,Position closed,NSDQ100/USD," 303,99 ",0.298886," 3,99 "," 5.883,26 "," 2.173,28 ",2844262156,CFD," 0,00 "
04/11/2024 16:35:37,Open Position,NSDQ100/USD," 299,99 ",0.299543," 0,00 "," 5.883,26 "," 1.873,29 ",2845152068,CFD," 0,00 "
04/11/2024 16:56:04,Open Position,NSDQ100/USD," 299,99 ",0.300511," 0,00 "," 5.883,26 "," 1.573,30 ",2845179470,CFD," 0,00 "
04/11/2024 18:16:52,Position closed,NSDQ100/USD," 299,63 ",0.299543,"(0,36)"," 5.882,90 "," 1.872,93 ",2845152068,CFD," 0,00 "
04/11/2024 18:17:11,Position closed,NSDQ100/USD," 318,20 ",0.300511," 18,21 "," 5.901,11 "," 2.191,13 ",2845179470,CFD," 0,00 "
04/11/2024 18:18:13,Open Position,NSDQ100/USD," 249,99 ",0.249710," 0,00 "," 5.901,11 "," 1.941,14 ",2845293350,CFD," 0,00 "
04/11/2024 19:58:38,Position closed,NSDQ100/USD," 251,56 ",0.249710," 1,57 "," 5.902,68 "," 2.192,70 ",2845293350,CFD," 0,00 "
04/11/2024 21:35:46,Open Position,NSDQ100/USD," 300,00 ",0.300145," 0,00 "," 5.902,68 "," 1.892,70 ",2845380697,CFD," 0,00 "
04/11/2024 23:16:41,Open Position,NSDQ100/USD," 300,00 ",0.300196," 0,00 "," 5.902,68 "," 1.592,70 ",2845387214,CFD," 0,00 "
05/11/2024 00:18:59,Open Position,NSDQ100/USD," 249,99 ",0.250402," 0,00 "," 5.902,68 "," 1.342,71 ",2845389645,CFD," 0,00 "
05/11/2024 00:48:33,Overnight fee,Daily,"(0,21)",-,"(0,21)"," 5.902,47 "," 1.342,50 ",2842271686,CFD," 0,00 "
05/11/2024 00:48:33,Overnight fee,Daily,"(0,28)",-,"(0,28)"," 5.902,19 "," 1.342,22 ",2841887128,CFD," 0,00 "
05/11/2024 00:48:33,Overnight fee,Daily,"(1,24)",-,"(1,24)"," 5.900,95 "," 1.340,98 ",2842547990,CFD," 0,00 "
05/11/2024 00:48:33,Overnight fee,Daily,"(1,24)",-,"(1,24)"," 5.899,71 "," 1.339,74 ",2842371548,CFD," 0,00 "
05/11/2024 00:48:33,Overnight fee,Daily,"(1,49)",-,"(1,49)"," 5.898,22 "," 1.338,25 ",2842370522,CFD," 0,00 "
05/11/2024 00:48:33,Overnight fee,Daily,"(1,49)",-,"(1,49)"," 5.896,73 "," 1.336,76 ",2842376287,CFD," 0,00 "
05/11/2024 00:48:34,Overnight fee,Daily,"(1,49)",-,"(1,49)"," 5.895,24 "," 1.335,27 ",2842551828,CFD," 0,00 "
05/11/2024 00:48:34,Overnight fee,Daily,"(1,50)",-,"(1,50)"," 5.893,74 "," 1.333,77 ",2844253504,CFD," 0,00 "
05/11/2024 00:48:34,Overnight fee,Daily,"(1,51)",-,"(1,51)"," 5.892,23 "," 1.332,26 ",2845380697,CFD," 0,00 "
05/11/2024 00:48:34,Overnight fee,Daily,"(1,75)",-,"(1,75)"," 5.890,48 "," 1.330,51 ",2844259597,CFD," 0,00 "
05/11/2024 00:48:34,Overnight fee,Daily,"(1,99)",-,"(1,99)"," 5.888,49 "," 1.328,52 ",2843924539,CFD," 0,00 "
05/11/2024 00:48:34,Overnight fee,Daily,"(4,50)",-,"(4,50)"," 5.883,99 "," 1.324,02 ",2842367034,CFD," 0,00 "
05/11/2024 06:16:14,Position closed,NSDQ100/USD," 254,27 ",0.250402," 4,28 "," 5.888,27 "," 1.578,29 ",2845389645,CFD," 0,00 "
05/11/2024 07:22:03,Position closed,NSDQ100/USD," 309,33 ",0.300145," 9,33 "," 5.897,60 "," 1.887,62 ",2845380697,CFD," 0,00 "
05/11/2024 07:22:14,Position closed,NSDQ100/USD," 310,33 ",0.300196," 10,33 "," 5.907,93 "," 2.197,95 ",2845387214,CFD," 0,00 "
05/11/2024 07:23:02,Open Position,NSDQ100/USD," 250,00 ",0.249741," 0,00 "," 5.907,93 "," 1.947,95 ",2845411319,CFD," 0,00 "
05/11/2024 07:23:14,Open Position,NSDQ100/USD," 249,99 ",0.249706," 0,00 "," 5.907,93 "," 1.697,96 ",2845411331,CFD," 0,00 "
05/11/2024 07:47:33,Position closed,NSDQ100/USD," 253,35 ",0.249741," 3,35 "," 5.911,28 "," 1.951,31 ",2845411319,CFD," 0,00 "
05/11/2024 07:55:21,Open Position,NSDQ100/USD," 249,99 ",0.249857," 0,00 "," 5.911,28 "," 1.701,32 ",2845414163,CFD," 0,00 "
05/11/2024 08:19:38,Open Position,NSDQ100/USD," 600,00 ",0.600090," 0,00 "," 5.911,28 "," 1.101,32 ",2845432627,CFD," 0,00 "
05/11/2024 08:27:05,Position closed,NSDQ100/USD," 603,60 ",0.600090," 3,60 "," 5.914,88 "," 1.704,92 ",2845432627,CFD," 0,00 "
05/11/2024 08:37:23,Position closed,NSDQ100/USD," 251,49 ",0.249857," 1,50 "," 5.916,38 "," 1.956,41 ",2845414163,CFD," 0,00 "
05/11/2024 10:09:10,Open Position,NSDQ100/USD," 249,99 ",0.249707," 0,00 "," 5.916,38 "," 1.706,42 ",2845460605,CFD," 0,00 "
05/11/2024 10:33:25,Position closed,NSDQ100/USD," 250,11 ",0.249706," 0,12 "," 5.916,50 "," 1.956,53 ",2845411331,CFD," 0,00 "
05/11/2024 10:47:53,Position closed,NSDQ100/USD," 249,09 ",0.249707,"(0,90)"," 5.915,60 "," 2.205,62 ",2845460605,CFD," 0,00 "
05/11/2024 11:30:03,Position closed,NSDQ100/USD," 353,27 ",0.396800,"(46,73)"," 5.868,87 "," 2.558,89 ",2843924539,CFD," 0,00 "
05/11/2024 12:24:17,Open Position,NSDQ100/USD," 300,00 ",0.299600," 0,00 "," 5.868,87 "," 2.258,89 ",2845488976,CFD," 0,00 "
05/11/2024 13:32:59,Position closed,NSDQ100/USD," 304,22 ",0.299600," 4,22 "," 5.873,09 "," 2.563,11 ",2845488976,CFD," 0,00 "
05/11/2024 14:11:21,Open Position,NSDQ100/USD," 249,99 ",0.249863," 0,00 "," 5.873,09 "," 2.313,12 ",2845594228,CFD," 0,00 "
05/11/2024 14:23:34,Position closed,NSDQ100/USD," 254,56 ",0.249863," 4,57 "," 5.877,66 "," 2.567,68 ",2845594228,CFD," 0,00 "
05/11/2024 14:27:07,Open Position,NSDQ100/USD," 300,00 ",0.299493," 0,00 "," 5.877,66 "," 2.267,68 ",2845599788,CFD," 0,00 "
05/11/2024 14:39:45,Position closed,NSDQ100/USD," 350,46 ",0.348092," 0,46 "," 5.878,12 "," 2.618,14 ",2844259597,CFD," 0,00 "
05/11/2024 14:41:05,Position closed,NSDQ100/USD," 325,95 ",0.299493," 25,95 "," 5.904,07 "," 2.944,09 ",2845599788,CFD," 0,00 "
05/11/2024 14:41:17,Position closed,NSDQ100/USD," 295,87 ",0.298055,"(4,13)"," 5.899,94 "," 3.239,96 ",2844253504,CFD," 0,00 "
05/11/2024 14:41:47,Position closed,NSDQ100/USD," 723,78 ",0.896135,"(186,21)"," 5.713,73 "," 3.963,74 ",2842367034,CFD," 0,00 "
05/11/2024 14:44:04,Open Position,NSDQ100/USD," 315,22 ",0.298545," 0,00 "," 5.713,73 "," 3.663,74 ",2845724411,CFD," 0,00 "
05/11/2024 15:07:48,Open Position,NSDQ100/USD," 249,99 ",0.247880," 0,00 "," 5.713,73 "," 3.413,75 ",2845819795,CFD," 0,00 "
05/11/2024 15:08:04,Position closed,NSDQ100/USD," 214,20 ",0.246082,"(35,80)"," 5.677,93 "," 3.627,95 ",2842371548,CFD," 0,00 "
05/11/2024 15:08:42,Open Position,NSDQ100/USD," 149,99 ",0.148583," 0,00 "," 5.677,93 "," 3.477,96 ",2845828114,CFD," 0,00 "
05/11/2024 15:15:04,Position closed,NSDQ100/USD," 258,75 ",0.295544,"(41,25)"," 5.636,68 "," 3.736,71 ",2842370522,CFD," 0,00 "
05/11/2024 15:16:12,Open Position,NSDQ100/USD," 300,00 ",0.297563," 0,00 "," 5.636,68 "," 3.436,71 ",2845838239,CFD," 0,00 "
05/11/2024 15:56:17,Open Position,NSDQ100/USD," 304,47 ",0.298023," 0,00 "," 5.636,68 "," 3.136,71 ",2845884407,CFD," 0,00 "
05/11/2024 15:57:05,Position closed,NSDQ100/USD," 306,54 ",0.297563," 6,54 "," 5.643,22 "," 3.443,25 ",2845838239,CFD," 0,00 "
05/11/2024 16:46:44,Position closed,NSDQ100/USD," 151,07 ",0.148583," 1,08 "," 5.644,30 "," 3.594,32 ",2845828114,CFD," 0,00 "
05/11/2024 16:47:34,Open Position,NSDQ100/USD," 200,00 ",0.197997," 0,00 "," 5.644,30 "," 3.394,32 ",2845927588,CFD," 0,00 "
05/11/2024 16:48:51,Position closed,NSDQ100/USD," 238,58 ",0.247880,"(11,41)"," 5.632,89 "," 3.632,90 ",2845819795,CFD," 0,00 "
05/11/2024 16:49:42,Position closed,NSDQ100/USD," 201,52 ",0.197997," 1,52 "," 5.634,41 "," 3.834,42 ",2845927588,CFD," 0,00 "
05/11/2024 16:49:56,Open Position,NSDQ100/USD," 250,00 ",0.247384," 0,00 "," 5.634,41 "," 3.584,42 ",2845929215,CFD," 0,00 "
05/11/2024 16:59:43,Position closed,NSDQ100/USD," 252,71 ",0.247384," 2,71 "," 5.637,12 "," 3.837,13 ",2845929215,CFD," 0,00 "
05/11/2024 17:00:42,Open Position,NSDQ100/USD," 250,00 ",0.247268," 0,00 "," 5.637,12 "," 3.587,13 ",2845939189,CFD," 0,00 "
05/11/2024 17:03:07,Position closed,NSDQ100/USD," 289,28 ",0.296284,"(10,72)"," 5.626,40 "," 3.876,41 ",2842551828,CFD," 0,00 "
05/11/2024 17:03:20,Position closed,NSDQ100/USD," 280,39 ",0.295854,"(19,61)"," 5.606,79 "," 4.156,80 ",2842376287,CFD," 0,00 "
05/11/2024 17:03:32,Position closed,NSDQ100/USD," 234,05 ",0.246568,"(15,95)"," 5.590,84 "," 4.390,85 ",2842547990,CFD," 0,00 "
05/11/2024 17:39:47,Position closed,NSDQ100/USD," 252,51 ",0.247268," 2,51 "," 5.593,35 "," 4.643,36 ",2845939189,CFD," 0,00 "
05/11/2024 18:20:06,Open Position,NSDQ100/USD," 249,99 ",0.247213," 0,00 "," 5.593,35 "," 4.393,37 ",2845991840,CFD," 0,00 "
05/11/2024 18:25:59,Open Position,NSDQ100/USD," 349,99 ",0.346441," 0,00 "," 5.593,35 "," 4.043,38 ",2845994895,CFD," 0,00 "
05/11/2024 18:27:02,Open Position,NSDQ100/USD," 249,99 ",0.247298," 0,00 "," 5.593,35 "," 3.793,39 ",2845995296,CFD," 0,00 "
05/11/2024 19:36:12,Position closed,NSDQ100/USD," 247,39 ",0.247298,"(2,60)"," 5.590,75 "," 4.040,78 ",2845995296,CFD," 0,00 "
05/11/2024 19:36:51,Position closed,NSDQ100/USD," 253,42 ",0.247213," 3,43 "," 5.594,18 "," 4.294,20 ",2845991840,CFD," 0,00 "
05/11/2024 19:37:39,Open Position,NSDQ100/USD," 249,99 ",0.247504," 0,00 "," 5.594,18 "," 4.044,21 ",2846032505,CFD," 0,00 "
05/11/2024 19:58:29,Position closed,NSDQ100/USD," 358,74 ",0.346441," 8,75 "," 5.602,93 "," 4.402,95 ",2845994895,CFD," 0,00 "
05/11/2024 19:58:36,Position closed,NSDQ100/USD," 255,33 ",0.247504," 5,34 "," 5.608,27 "," 4.658,28 ",2846032505,CFD," 0,00 "
05/11/2024 20:00:03,Open Position,NSDQ100/USD," 250,00 ",0.247823," 0,00 "," 5.608,27 "," 4.408,28 ",2846048461,CFD," 0,00 "
05/11/2024 20:00:13,Open Position,NSDQ100/USD," 322,90 ",0.297479," 0,00 "," 5.608,27 "," 4.108,28 ",2846048516,CFD," 0,00 "
05/11/2024 20:11:46,Position closed,NSDQ100/USD," 258,17 ",0.247823," 8,17 "," 5.616,44 "," 4.366,45 ",2846048461,CFD," 0,00 "
05/11/2024 20:45:12,Open Position,NSDQ100/USD," 249,99 ",0.247494," 0,00 "," 5.616,44 "," 4.116,46 ",2846074358,CFD," 0,00 "
05/11/2024 20:49:19,Open Position,NSDQ100/USD," 299,99 ",0.296873," 0,00 "," 5.616,44 "," 3.816,47 ",2846077912,CFD," 0,00 "
05/11/2024 20:50:15,Position closed,NSDQ100/USD," 251,20 ",0.247494," 1,21 "," 5.617,65 "," 4.067,67 ",2846074358,CFD," 0,00 "
05/11/2024 21:21:25,Position closed,NSDQ100/USD," 311,72 ",0.296873," 11,73 "," 5.629,38 "," 4.379,39 ",2846077912,CFD," 0,00 "
05/11/2024 21:22:05,Open Position,NSDQ100/USD," 250,00 ",0.246853," 0,00 "," 5.629,38 "," 4.129,39 ",2846090810,CFD," 0,00 "
06/11/2024 00:42:48,Position closed,NSDQ100/USD," 254,88 ",0.246853," 4,88 "," 5.634,26 "," 4.384,27 ",2846090810,CFD," 0,00 "
06/11/2024 00:43:03,Open Position,NSDQ100/USD," 299,99 ",0.295829," 0,00 "," 5.634,26 "," 4.084,28 ",2846104416,CFD," 0,00 "
06/11/2024 00:48:35,Overnight fee,Daily,"(0,04)",-,"(0,04)"," 5.634,22 "," 4.084,24 ",2845724411,CFD," 0,00 "
06/11/2024 00:48:35,Overnight fee,Daily,"(0,04)",-,"(0,04)"," 5.634,18 "," 4.084,20 ",2846048516,CFD," 0,00 "
06/11/2024 00:48:35,Overnight fee,Daily,"(0,04)",-,"(0,04)"," 5.634,14 "," 4.084,16 ",2845884407,CFD," 0,00 "
06/11/2024 00:48:35,Overnight fee,Daily,"(0,21)",-,"(0,21)"," 5.633,93 "," 4.083,95 ",2842271686,CFD," 0,00 "
06/11/2024 00:48:35,Overnight fee,Daily,"(0,29)",-,"(0,29)"," 5.633,64 "," 4.083,66 ",2841887128,CFD," 0,00 "
06/11/2024 00:48:35,Overnight fee,Daily,"(1,24)",-,"(1,24)"," 5.632,40 "," 4.082,42 ",2846090810,CFD," 0,00 "
06/11/2024 06:43:33,Position closed,NSDQ100/USD," 372,89 ",0.295829," 72,90 "," 5.705,30 "," 4.455,31 ",2846104416,CFD," 0,00 "
06/11/2024 06:47:26,Open Position,NSDQ100/USD," 400,00 ",0.389917," 0,00 "," 5.705,30 "," 4.055,31 ",2846188992,CFD," 0,00 "
06/11/2024 06:51:26,Open Position,NSDQ100/USD," 149,99 ",0.146066," 0,00 "," 5.705,30 "," 3.905,32 ",2846190822,CFD," 0,00 "
06/11/2024 06:56:28,Position closed,NSDQ100/USD," 151,25 ",0.146066," 1,26 "," 5.706,56 "," 4.056,57 ",2846190822,CFD," 0,00 "
06/11/2024 07:03:37,Open Position,NSDQ100/USD," 250,00 ",0.243038," 0,00 "," 5.706,56 "," 3.806,57 ",2846197856,CFD," 0,00 "
06/11/2024 07:05:54,Edit Stop Loss,-,"(15,22)",-," 0,00 "," 5.706,56 "," 3.791,35 ",2845724411,-," 0,00 "
06/11/2024 07:06:06,Edit Stop Loss,-,"(4,47)",-," 0,00 "," 5.706,56 "," 3.786,88 ",2845884407,-," 0,00 "
06/11/2024 07:07:00,Open Position,NSDQ100/USD," 299,99 ",0.291663," 0,00 "," 5.706,56 "," 3.486,89 ",2846199914,CFD," 0,00 "
06/11/2024 07:14:38,Position closed,NSDQ100/USD," 292,73 ",0.291663,"(7,26)"," 5.699,30 "," 3.779,62 ",2846199914,CFD," 0,00 "
06/11/2024 07:14:49,Position closed,NSDQ100/USD," 255,08 ",0.243038," 5,08 "," 5.704,38 "," 4.034,70 ",2846197856,CFD," 0,00 "
06/11/2024 07:16:31,Open Position,NSDQ100/USD," 299,99 ",0.291486," 0,00 "," 5.704,38 "," 3.734,71 ",2846208100,CFD," 0,00 "
06/11/2024 07:16:43,Open Position,NSDQ100/USD," 250,00 ",0.242788," 0,00 "," 5.704,38 "," 3.484,71 ",2846208202,CFD," 0,00 "
06/11/2024 07:25:11,Position closed,NSDQ100/USD," 303,75 ",0.291486," 3,76 "," 5.708,14 "," 3.788,46 ",2846208100,CFD," 0,00 "
06/11/2024 07:27:38,Open Position,NSDQ100/USD," 350,00 ",0.340297," 0,00 "," 5.708,14 "," 3.438,46 ",2846214457,CFD," 0,00 "
06/11/2024 07:27:55,Open Position,NSDQ100/USD," 249,99 ",0.243076," 0,00 "," 5.708,14 "," 3.188,47 ",2846214560,CFD," 0,00 "
06/11/2024 07:32:04,Position closed,NSDQ100/USD," 352,35 ",0.340297," 2,35 "," 5.710,49 "," 3.540,82 ",2846214457,CFD," 0,00 "
06/11/2024 07:41:12,Position closed,NSDQ100/USD," 250,43 ",0.243076," 0,44 "," 5.710,93 "," 3.791,25 ",2846214560,CFD," 0,00 "
06/11/2024 07:41:54,Open Position,NSDQ100/USD," 520,00 ",0.505719," 0,00 "," 5.710,93 "," 3.271,25 ",2846221583,CFD," 0,00 "
06/11/2024 07:42:35,Open Position,NSDQ100/USD," 299,99 ",0.291964," 0,00 "," 5.710,93 "," 2.971,26 ",2846221866,CFD," 0,00 "
06/11/2024 07:43:14,Position closed,NSDQ100/USD," 515,41 ",0.505719,"(4,59)"," 5.706,34 "," 3.486,67 ",2846221583,CFD," 0,00 "
06/11/2024 07:45:12,Open Position,NSDQ100/USD," 249,99 ",0.243368," 0,00 "," 5.706,34 "," 3.236,68 ",2846222937,CFD," 0,00 "
06/11/2024 07:45:44,Open Position,NSDQ100/USD," 250,00 ",0.243273," 0,00 "," 5.706,34 "," 2.986,68 ",2846223223,CFD," 0,00 "
06/11/2024 07:46:24,Open Position,NSDQ100/USD," 300,00 ",0.291825," 0,00 "," 5.706,34 "," 2.686,68 ",2846223481,CFD," 0,00 "
06/11/2024 07:48:24,Position closed,NSDQ100/USD," 300,87 ",0.291964," 0,88 "," 5.707,22 "," 2.987,55 ",2846221866,CFD," 0,00 "
06/11/2024 07:48:47,Open Position,NSDQ100/USD," 349,99 ",0.340699," 0,00 "," 5.707,22 "," 2.637,56 ",2846224551,CFD," 0,00 "
06/11/2024 07:50:27,Position closed,NSDQ100/USD," 247,06 ",0.243273,"(2,94)"," 5.704,28 "," 2.884,62 ",2846223223,CFD," 0,00 "
06/11/2024 07:51:02,Position closed,NSDQ100/USD," 293,56 ",0.291825,"(6,44)"," 5.697,84 "," 3.178,18 ",2846223481,CFD," 0,00 "
06/11/2024 07:53:06,Open Position,NSDQ100/USD," 299,99 ",0.291893," 0,00 "," 5.697,84 "," 2.878,19 ",2846226520,CFD," 0,00 "
06/11/2024 07:53:37,Open Position,NSDQ100/USD," 250,00 ",0.243167," 0,00 "," 5.697,84 "," 2.628,19 ",2846226747,CFD," 0,00 "
06/11/2024 07:54:41,Position closed,NSDQ100/USD," 251,07 ",0.243167," 1,07 "," 5.698,91 "," 2.879,26 ",2846226747,CFD," 0,00 "
06/11/2024 07:55:28,Open Position,NSDQ100/USD," 249,97 ",0.243227," 0,00 "," 5.698,91 "," 2.629,29 ",2846227419,CFD," 0,00 "
06/11/2024 07:55:59,Open Position,NSDQ100/USD," 250,00 ",0.243199," 0,00 "," 5.698,91 "," 2.379,29 ",2846227601,CFD," 0,00 "
06/11/2024 07:56:53,Position closed,NSDQ100/USD," 250,49 ",0.243199," 0,49 "," 5.699,40 "," 2.629,78 ",2846227601,CFD," 0,00 "
06/11/2024 07:57:19,Open Position,NSDQ100/USD," 300,00 ",0.291662," 0,00 "," 5.699,40 "," 2.329,78 ",2846228319,CFD," 0,00 "
06/11/2024 07:58:50,Position closed,NSDQ100/USD," 301,96 ",0.291662," 1,96 "," 5.701,36 "," 2.631,74 ",2846228319,CFD," 0,00 "
06/11/2024 07:59:09,Open Position,NSDQ100/USD," 299,99 ",0.291691," 0,00 "," 5.701,36 "," 2.331,75 ",2846228906,CFD," 0,00 "
06/11/2024 08:06:02,Position closed,NSDQ100/USD," 302,88 ",0.291691," 2,89 "," 5.704,25 "," 2.634,63 ",2846228906,CFD," 0,00 "
06/11/2024 08:06:48,Position closed,NSDQ100/USD," 249,63 ",0.243227,"(0,34)"," 5.703,91 "," 2.884,26 ",2846227419,CFD," 0,00 "
06/11/2024 08:08:01,Position closed,NSDQ100/USD," 301,13 ",0.291893," 1,14 "," 5.705,05 "," 3.185,39 ",2846226520,CFD," 0,00 "
06/11/2024 08:08:50,Open Position,NSDQ100/USD," 250,00 ",0.243293," 0,00 "," 5.705,05 "," 2.935,39 ",2846252066,CFD," 0,00 "
06/11/2024 08:11:05,Position closed,NSDQ100/USD," 249,47 ",0.243293,"(0,53)"," 5.704,52 "," 3.184,86 ",2846252066,CFD," 0,00 "
06/11/2024 08:11:55,Open Position,NSDQ100/USD," 300,00 ",0.291957," 0,00 "," 5.704,52 "," 2.884,86 ",2846256441,CFD," 0,00 "
06/11/2024 08:14:03,Position closed,NSDQ100/USD," 301,17 ",0.291957," 1,17 "," 5.705,69 "," 3.186,03 ",2846256441,CFD," 0,00 "
06/11/2024 08:15:23,Open Position,NSDQ100/USD," 519,99 ",0.505758," 0,00 "," 5.705,69 "," 2.666,04 ",2846259675,CFD," 0,00 "
06/11/2024 08:15:34,Open Position,NSDQ100/USD," 250,00 ",0.243105," 0,00 "," 5.705,69 "," 2.416,04 ",2846259754,CFD," 0,00 "
06/11/2024 08:18:28,Position closed,NSDQ100/USD," 520,20 ",0.505758," 0,21 "," 5.705,90 "," 2.936,24 ",2846259675,CFD," 0,00 "
06/11/2024 08:18:47,Open Position,NSDQ100/USD," 400,00 ",0.389295," 0,00 "," 5.705,90 "," 2.536,24 ",2846273763,CFD," 0,00 "
06/11/2024 08:22:50,Position closed,NSDQ100/USD," 251,22 ",0.243105," 1,22 "," 5.707,12 "," 2.787,46 ",2846259754,CFD," 0,00 "
06/11/2024 08:24:39,Open Position,NSDQ100/USD," 299,99 ",0.291765," 0,00 "," 5.707,12 "," 2.487,47 ",2846336369,CFD," 0,00 "
06/11/2024 08:29:04,Open Position,NSDQ100/USD," 400,00 ",0.388912," 0,00 "," 5.707,12 "," 2.087,47 ",2846339473,CFD," 0,00 "
06/11/2024 08:32:01,Position closed,NSDQ100/USD," 401,45 ",0.388912," 1,45 "," 5.708,57 "," 2.488,92 ",2846339473,CFD," 0,00 "
06/11/2024 08:35:49,Open Position,NSDQ100/USD," 519,99 ",0.505562," 0,00 "," 5.708,57 "," 1.968,93 ",2846349486,CFD," 0,00 "
06/11/2024 08:46:05,Position closed,NSDQ100/USD," 247,31 ",0.242788,"(2,69)"," 5.705,88 "," 2.216,24 ",2846208202,CFD," 0,00 "
06/11/2024 08:46:16,Open Position,NSDQ100/USD," 700,00 ",0.680217," 0,00 "," 5.705,88 "," 1.516,24 ",2846357316,CFD," 0,00 "
06/11/2024 08:46:27,Open Position,NSDQ100/USD," 499,99 ",0.485928," 0,00 "," 5.705,88 "," 1.016,25 ",2846357368,CFD," 0,00 "
06/11/2024 08:48:26,Open Position,NSDQ100/USD," 519,99 ",0.505264," 0,00 "," 5.705,88 "," 496,26 ",2846358227,CFD," 0,00 "
06/11/2024 08:52:42,Open Position,NSDQ100/USD," 200,00 ",0.194101," 0,00 "," 5.705,88 "," 296,26 ",2846361531,CFD," 0,00 "
06/11/2024 08:52:53,Position closed,NSDQ100/USD," 201,61 ",0.194101," 1,61 "," 5.707,49 "," 497,87 ",2846361531,CFD," 0,00 "
06/11/2024 08:55:25,Open Position,NSDQ100/USD," 250,00 ",0.242855," 0,00 "," 5.707,49 "," 247,87 ",2846362905,CFD," 0,00 "
06/11/2024 09:04:55,Position closed,NSDQ100/USD," 499,12 ",0.485928,"(0,87)"," 5.706,62 "," 746,99 ",2846357368,CFD," 0,00 "
06/11/2024 09:05:08,Position closed,NSDQ100/USD," 701,91 ",0.680217," 1,91 "," 5.708,53 "," 1.448,90 ",2846357316,CFD," 0,00 "
06/11/2024 09:05:36,Position closed,NSDQ100/USD," 521,21 ",0.505562," 1,22 "," 5.709,75 "," 1.970,11 ",2846349486,CFD," 0,00 "
06/11/2024 09:06:01,Position closed,NSDQ100/USD," 525,50 ",0.505264," 5,51 "," 5.715,26 "," 2.495,61 ",2846358227,CFD," 0,00 "
06/11/2024 09:07:15,Open Position,NSDQ100/USD," 519,99 ",0.505385," 0,00 "," 5.715,26 "," 1.975,62 ",2846371859,CFD," 0,00 "
06/11/2024 09:13:13,Position closed,NSDQ100/USD," 301,92 ",0.291765," 1,93 "," 5.717,19 "," 2.277,54 ",2846336369,CFD," 0,00 "
06/11/2024 09:13:58,Position closed,NSDQ100/USD," 530,76 ",0.505385," 10,77 "," 5.727,96 "," 2.808,30 ",2846371859,CFD," 0,00 "
06/11/2024 09:14:50,Open Position,NSDQ100/USD," 299,99 ",0.291793," 0,00 "," 5.727,96 "," 2.508,31 ",2846375548,CFD," 0,00 "
06/11/2024 09:18:20,Open Position,NSDQ100/USD," 249,99 ",0.243108," 0,00 "," 5.727,96 "," 2.258,32 ",2846376943,CFD," 0,00 "
06/11/2024 09:28:14,Open Position,NSDQ100/USD," 299,99 ",0.291575," 0,00 "," 5.727,96 "," 1.958,33 ",2846381562,CFD," 0,00 "
06/11/2024 09:31:44,Position closed,NSDQ100/USD," 250,49 ",0.242855," 0,49 "," 5.728,45 "," 2.208,82 ",2846362905,CFD," 0,00 "
06/11/2024 09:32:28,Open Position,NSDQ100/USD," 519,99 ",0.504936," 0,00 "," 5.728,45 "," 1.688,83 ",2846383456,CFD," 0,00 "
06/11/2024 09:32:41,Open Position,NSDQ100/USD," 509,99 ",0.495158," 0,00 "," 5.728,45 "," 1.178,84 ",2846383568,CFD," 0,00 "
06/11/2024 09:38:19,Open Position,NSDQ100/USD," 519,98 ",0.504865," 0,00 "," 5.728,45 "," 658,86 ",2846387396,CFD," 0,00 "
06/11/2024 09:41:47,Position closed,NSDQ100/USD," 522,17 ",0.504936," 2,18 "," 5.730,63 "," 1.181,03 ",2846383456,CFD," 0,00 "
06/11/2024 09:42:17,Position closed,NSDQ100/USD," 526,09 ",0.504865," 6,11 "," 5.736,74 "," 1.707,12 ",2846387396,CFD," 0,00 "
06/11/2024 09:42:36,Position closed,NSDQ100/USD," 513,75 ",0.495158," 3,76 "," 5.740,50 "," 2.220,87 ",2846383568,CFD," 0,00 "
06/11/2024 09:43:26,Open Position,NSDQ100/USD," 519,99 ",0.505044," 0,00 "," 5.740,50 "," 1.700,88 ",2846390366,CFD," 0,00 "
06/11/2024 09:43:35,Open Position,NSDQ100/USD," 519,99 ",0.504965," 0,00 "," 5.740,50 "," 1.180,89 ",2846390457,CFD," 0,00 "
06/11/2024 09:59:30,Open Position,NSDQ100/USD," 509,99 ",0.494901," 0,00 "," 5.740,50 "," 670,90 ",2846398680,CFD," 0,00 "
06/11/2024 09:59:48,Open Position,NSDQ100/USD," 509,99 ",0.494870," 0,00 "," 5.740,50 "," 160,91 ",2846398847,CFD," 0,00 "
06/11/2024 10:07:06,Position closed,NSDQ100/USD," 525,95 ",0.505044," 5,96 "," 5.746,46 "," 686,86 ",2846390366,CFD," 0,00 "
06/11/2024 10:07:13,Position closed,NSDQ100/USD," 298,56 ",0.291575,"(1,43)"," 5.745,03 "," 985,42 ",2846381562,CFD," 0,00 "
06/11/2024 10:07:22,Position closed,NSDQ100/USD," 524,74 ",0.504965," 4,75 "," 5.749,78 "," 1.510,16 ",2846390457,CFD," 0,00 "
06/11/2024 10:07:45,Position closed,NSDQ100/USD," 522,46 ",0.494870," 12,47 "," 5.762,25 "," 2.032,62 ",2846398847,CFD," 0,00 "
06/11/2024 10:07:54,Position closed,NSDQ100/USD," 520,28 ",0.494901," 10,29 "," 5.772,54 "," 2.552,90 ",2846398680,CFD," 0,00 "
06/11/2024 10:09:01,Open Position,NSDQ100/USD," 299,99 ",0.291547," 0,00 "," 5.772,54 "," 2.252,91 ",2846404830,CFD," 0,00 "
06/11/2024 10:12:27,Open Position,NSDQ100/USD," 369,98 ",0.359401," 0,00 "," 5.772,54 "," 1.882,93 ",2846406047,CFD," 0,00 "
06/11/2024 10:34:55,Position closed,NSDQ100/USD," 372,93 ",0.359401," 2,95 "," 5.775,49 "," 2.255,86 ",2846406047,CFD," 0,00 "
06/11/2024 10:35:08,Open Position,NSDQ100/USD," 519,99 ",0.504946," 0,00 "," 5.775,49 "," 1.735,87 ",2846459292,CFD," 0,00 "
06/11/2024 10:35:28,Open Position,NSDQ100/USD," 200,00 ",0.194223," 0,00 "," 5.775,49 "," 1.535,87 ",2846459395,CFD," 0,00 "
06/11/2024 10:48:31,Position closed,NSDQ100/USD," 200,93 ",0.194223," 0,93 "," 5.776,42 "," 1.736,80 ",2846459395,CFD," 0,00 "
06/11/2024 10:48:48,Position closed,NSDQ100/USD," 522,62 ",0.504946," 2,63 "," 5.779,05 "," 2.259,42 ",2846459292,CFD," 0,00 "
06/11/2024 10:51:34,Position closed,NSDQ100/USD," 300,11 ",0.291547," 0,12 "," 5.779,17 "," 2.559,53 ",2846404830,CFD," 0,00 "
06/11/2024 10:52:50,Open Position,NSDQ100/USD," 300,00 ",0.291487," 0,00 "," 5.779,17 "," 2.259,53 ",2846464917,CFD," 0,00 "
06/11/2024 10:53:02,Open Position,NSDQ100/USD," 249,99 ",0.242938," 0,00 "," 5.779,17 "," 2.009,54 ",2846464975,CFD," 0,00 "
06/11/2024 11:00:47,Position closed,NSDQ100/USD," 252,18 ",0.242938," 2,19 "," 5.781,36 "," 2.261,72 ",2846464975,CFD," 0,00 "
06/11/2024 11:02:21,Position closed,NSDQ100/USD," 300,00 ",0.291793," 0,01 "," 5.781,37 "," 2.561,72 ",2846375548,CFD," 0,00 "
06/11/2024 11:03:30,Position closed,NSDQ100/USD," 251,33 ",0.243108," 1,34 "," 5.782,71 "," 2.813,05 ",2846376943,CFD," 0,00 "
06/11/2024 11:04:11,Open Position,NSDQ100/USD," 250,00 ",0.243190," 0,00 "," 5.782,71 "," 2.563,05 ",2846468943,CFD," 0,00 "
06/11/2024 11:08:16,Position closed,NSDQ100/USD," 251,88 ",0.243190," 1,88 "," 5.784,59 "," 2.814,93 ",2846468943,CFD," 0,00 "
06/11/2024 11:09:03,Open Position,NSDQ100/USD," 349,99 ",0.340303," 0,00 "," 5.784,59 "," 2.464,94 ",2846470542,CFD," 0,00 "
06/11/2024 11:41:35,Position closed,NSDQ100/USD," 403,71 ",0.389295," 3,71 "," 5.788,30 "," 2.868,65 ",2846273763,CFD," 0,00 "
06/11/2024 11:42:01,Position closed,NSDQ100/USD," 351,90 ",0.340699," 1,91 "," 5.790,21 "," 3.220,55 ",2846224551,CFD," 0,00 "
06/11/2024 11:42:09,Position closed,NSDQ100/USD," 250,63 ",0.243368," 0,64 "," 5.790,85 "," 3.471,18 ",2846222937,CFD," 0,00 "
06/11/2024 11:42:59,Open Position,NSDQ100/USD," 349,98 ",0.340618," 0,00 "," 5.790,85 "," 3.121,20 ",2846489747,CFD," 0,00 "
06/11/2024 11:43:27,Position closed,NSDQ100/USD," 351,86 ",0.340618," 1,88 "," 5.792,73 "," 3.473,06 ",2846489747,CFD," 0,00 "
06/11/2024 11:43:33,Open Position,NSDQ100/USD," 530,00 ",0.515583," 0,00 "," 5.792,73 "," 2.943,06 ",2846490246,CFD," 0,00 "
06/11/2024 11:43:52,Open Position,NSDQ100/USD," 200,00 ",0.194625," 0,00 "," 5.792,73 "," 2.743,06 ",2846490431,CFD," 0,00 "
06/11/2024 11:46:54,Position closed,NSDQ100/USD," 201,17 ",0.194625," 1,17 "," 5.793,90 "," 2.944,23 ",2846490431,CFD," 0,00 "
06/11/2024 11:47:44,Open Position,NSDQ100/USD," 250,00 ",0.243412," 0,00 "," 5.793,90 "," 2.694,23 ",2846492288,CFD," 0,00 "
06/11/2024 11:48:13,Position closed,NSDQ100/USD," 388,43 ",0.389917,"(11,57)"," 5.782,33 "," 3.082,66 ",2846188992,CFD," 0,00 "
06/11/2024 11:48:45,Open Position,NSDQ100/USD," 299,99 ",0.292123," 0,00 "," 5.782,33 "," 2.782,67 ",2846492703,CFD," 0,00 "
06/11/2024 11:50:28,Position closed,NSDQ100/USD," 303,18 ",0.292123," 3,19 "," 5.785,52 "," 3.085,85 ",2846492703,CFD," 0,00 "
06/11/2024 11:51:40,Open Position,NSDQ100/USD," 299,99 ",0.292415," 0,00 "," 5.785,52 "," 2.785,86 ",2846494137,CFD," 0,00 "
06/11/2024 11:56:11,Position closed,NSDQ100/USD," 305,35 ",0.292415," 5,36 "," 5.790,88 "," 3.091,21 ",2846494137,CFD," 0,00 "
06/11/2024 11:56:55,Open Position,NSDQ100/USD," 249,99 ",0.243963," 0,00 "," 5.790,88 "," 2.841,22 ",2846497475,CFD," 0,00 "
06/11/2024 11:59:00,Position closed,NSDQ100/USD," 194,97 ",0.298545,"(120,25)"," 5.670,63 "," 3.036,19 ",2845724411,CFD," 0,00 "
06/11/2024 11:59:56,Open Position,NSDQ100/USD," 200,00 ",0.195208," 0,00 "," 5.670,63 "," 2.836,19 ",2846499021,CFD," 0,00 "
06/11/2024 12:01:27,Position closed,NSDQ100/USD," 192,15 ",0.298023,"(112,32)"," 5.558,31 "," 3.028,34 ",2845884407,CFD," 0,00 "
06/11/2024 12:02:21,Open Position,NSDQ100/USD," 300,00 ",0.292726," 0,00 "," 5.558,31 "," 2.728,34 ",2846500881,CFD," 0,00 "
06/11/2024 12:17:15,Position closed,NSDQ100/USD," 315,96 ",0.292726," 15,96 "," 5.574,27 "," 3.044,30 ",2846500881,CFD," 0,00 "
06/11/2024 12:17:33,Position closed,NSDQ100/USD," 252,32 ",0.243412," 2,32 "," 5.576,59 "," 3.296,62 ",2846492288,CFD," 0,00 "
06/11/2024 12:18:40,Open Position,NSDQ100/USD," 249,99 ",0.243371," 0,00 "," 5.576,59 "," 3.046,63 ",2846510681,CFD," 0,00 "
06/11/2024 12:27:17,Position closed,NSDQ100/USD," 250,60 ",0.243371," 0,61 "," 5.577,20 "," 3.297,23 ",2846510681,CFD," 0,00 "
06/11/2024 12:29:34,Position closed,NSDQ100/USD," 520,68 ",0.515583,"(9,32)"," 5.567,88 "," 3.817,91 ",2846490246,CFD," 0,00 "
06/11/2024 12:30:19,Open Position,NSDQ100/USD," 299,99 ",0.292124," 0,00 "," 5.567,88 "," 3.517,92 ",2846515488,CFD," 0,00 "
06/11/2024 12:35:03,Position closed,NSDQ100/USD," 346,22 ",0.340303,"(3,77)"," 5.564,11 "," 3.864,14 ",2846470542,CFD," 0,00 "
06/11/2024 12:35:24,Open Position,NSDQ100/USD," 299,99 ",0.291818," 0,00 "," 5.564,11 "," 3.564,15 ",2846518162,CFD," 0,00 "
06/11/2024 12:41:39,Open Position,NSDQ100/USD," 300,00 ",0.291801," 0,00 "," 5.564,11 "," 3.264,15 ",2846520824,CFD," 0,00 "
06/11/2024 12:46:34,Position closed,NSDQ100/USD," 304,24 ",0.291801," 4,24 "," 5.568,35 "," 3.568,39 ",2846520824,CFD," 0,00 "
06/11/2024 12:47:38,Position closed,NSDQ100/USD," 299,62 ",0.291487,"(0,38)"," 5.567,97 "," 3.868,01 ",2846464917,CFD," 0,00 "
06/11/2024 12:47:50,Open Position,NSDQ100/USD," 529,99 ",0.514916," 0,00 "," 5.567,97 "," 3.338,02 ",2846523366,CFD," 0,00 "
06/11/2024 12:48:19,Open Position,NSDQ100/USD," 249,99 ",0.242889," 0,00 "," 5.567,97 "," 3.088,03 ",2846523711,CFD," 0,00 "
06/11/2024 12:50:30,Position closed,NSDQ100/USD," 252,79 ",0.242889," 2,80 "," 5.570,77 "," 3.340,82 ",2846523711,CFD," 0,00 "
06/11/2024 12:50:38,Position closed,NSDQ100/USD," 533,34 ",0.514916," 3,35 "," 5.574,12 "," 3.874,16 ",2846523366,CFD," 0,00 "
06/11/2024 12:50:51,Open Position,NSDQ100/USD," 529,99 ",0.515091," 0,00 "," 5.574,12 "," 3.344,17 ",2846524811,CFD," 0,00 "
06/11/2024 12:53:55,Open Position,NSDQ100/USD," 299,99 ",0.291582," 0,00 "," 5.574,12 "," 3.044,18 ",2846526122,CFD," 0,00 "
06/11/2024 12:57:13,Position closed,NSDQ100/USD," 531,69 ",0.515091," 1,70 "," 5.575,82 "," 3.575,87 ",2846524811,CFD," 0,00 "
06/11/2024 12:57:55,Position closed,NSDQ100/USD," 301,19 ",0.291582," 1,20 "," 5.577,02 "," 3.877,06 ",2846526122,CFD," 0,00 "
06/11/2024 12:58:14,Open Position,NSDQ100/USD," 249,99 ",0.243145," 0,00 "," 5.577,02 "," 3.627,07 ",2846527793,CFD," 0,00 "
06/11/2024 13:04:20,Position closed,NSDQ100/USD," 250,97 ",0.243145," 0,98 "," 5.578,00 "," 3.878,04 ",2846527793,CFD," 0,00 "
06/11/2024 13:06:15,Open Position,NSDQ100/USD," 1.999,99 ",1.945604," 0,00 "," 5.578,00 "," 1.878,05 ",2846532028,CFD," 0,00 "
06/11/2024 13:08:12,Position closed,NSDQ100/USD," 1.985,63 ",1.945604,"(14,36)"," 5.563,64 "," 3.863,68 ",2846532028,CFD," 0,00 "
06/11/2024 13:13:14,Position closed,NSDQ100/USD," 300,00 ",0.291818," 0,01 "," 5.563,65 "," 4.163,68 ",2846518162,CFD," 0,00 "
06/11/2024 13:18:09,Open Position,NSDQ100/USD," 539,99 ",0.525068," 0,00 "," 5.563,65 "," 3.623,69 ",2846539877,CFD," 0,00 "
06/11/2024 13:29:23,Open Position,NSDQ100/USD," 529,99 ",0.514956," 0,00 "," 5.563,65 "," 3.093,70 ",2846545101,CFD," 0,00 "
06/11/2024 13:29:33,Open Position,NSDQ100/USD," 250,00 ",0.242796," 0,00 "," 5.563,65 "," 2.843,70 ",2846545258,CFD," 0,00 "
06/11/2024 13:32:51,Position closed,NSDQ100/USD," 250,03 ",0.242796," 0,03 "," 5.563,68 "," 3.093,73 ",2846545258,CFD," 0,00 "
06/11/2024 13:34:53,Open Position,NSDQ100/USD," 529,99 ",0.514526," 0,00 "," 5.563,68 "," 2.563,74 ",2846548852,CFD," 0,00 "
06/11/2024 13:41:26,Position closed,NSDQ100/USD," 533,64 ",0.514526," 3,65 "," 5.567,33 "," 3.097,38 ",2846548852,CFD," 0,00 "
06/11/2024 13:42:33,Open Position,NSDQ100/USD," 529,99 ",0.514901," 0,00 "," 5.567,33 "," 2.567,39 ",2846554571,CFD," 0,00 "
06/11/2024 13:46:02,Position closed,NSDQ100/USD," 535,25 ",0.514901," 5,26 "," 5.572,59 "," 3.102,64 ",2846554571,CFD," 0,00 "
06/11/2024 13:46:30,Position closed,NSDQ100/USD," 537,98 ",0.514956," 7,99 "," 5.580,58 "," 3.640,62 ",2846545101,CFD," 0,00 "
06/11/2024 13:47:42,Open Position,NSDQ100/USD," 999,98 ",0.971743," 0,00 "," 5.580,58 "," 2.640,64 ",2846559272,CFD," 0,00 "
06/11/2024 13:50:01,Position closed,NSDQ100/USD," 1.010,58 ",0.971743," 10,60 "," 5.591,18 "," 3.651,22 ",2846559272,CFD," 0,00 "
06/11/2024 13:52:35,Open Position,NSDQ100/USD," 700,00 ",0.680471," 0,00 "," 5.591,18 "," 2.951,22 ",2846561839,CFD," 0,00 "
06/11/2024 13:57:51,Open Position,NSDQ100/USD," 529,99 ",0.514944," 0,00 "," 5.591,18 "," 2.421,23 ",2846565136,CFD," 0,00 "
06/11/2024 13:58:05,Open Position,NSDQ100/USD," 249,99 ",0.242966," 0,00 "," 5.591,18 "," 2.171,24 ",2846565215,CFD," 0,00 "
06/11/2024 13:58:19,Position closed,NSDQ100/USD," 535,14 ",0.514944," 5,15 "," 5.596,33 "," 2.706,38 ",2846565136,CFD," 0,00 "
06/11/2024 14:04:39,Position closed,NSDQ100/USD," 546,30 ",0.525068," 6,31 "," 5.602,64 "," 3.252,68 ",2846539877,CFD," 0,00 "
06/11/2024 14:04:45,Position closed,NSDQ100/USD," 711,24 ",0.680471," 11,24 "," 5.613,88 "," 3.963,92 ",2846561839,CFD," 0,00 "
06/11/2024 14:05:38,Position closed,NSDQ100/USD," 254,03 ",0.242966," 4,04 "," 5.617,92 "," 4.217,95 ",2846565215,CFD," 0,00 "
06/11/2024 14:08:36,Open Position,NSDQ100/USD," 539,99 ",0.525119," 0,00 "," 5.617,92 "," 3.677,96 ",2846575297,CFD," 0,00 "
06/11/2024 14:14:23,Position closed,NSDQ100/USD," 547,72 ",0.525119," 7,73 "," 5.625,65 "," 4.225,68 ",2846575297,CFD," 0,00 "
06/11/2024 14:15:13,Open Position,NSDQ100/USD," 299,99 ",0.292032," 0,00 "," 5.625,65 "," 3.925,69 ",2846580099,CFD," 0,00 "
06/11/2024 14:21:20,Open Position,NSDQ100/USD," 299,99 ",0.291896," 0,00 "," 5.625,65 "," 3.625,70 ",2846583331,CFD," 0,00 "
06/11/2024 14:31:59,Open Position,NSDQ100/USD," 539,99 ",0.525094," 0,00 "," 5.625,65 "," 3.085,71 ",2846716997,CFD," 0,00 "
06/11/2024 14:32:39,Open Position,NSDQ100/USD," 529,99 ",0.514500," 0,00 "," 5.625,65 "," 2.555,72 ",2846724911,CFD," 0,00 "
06/11/2024 14:33:07,Position closed,NSDQ100/USD," 532,15 ",0.514500," 2,16 "," 5.627,81 "," 3.087,87 ",2846724911,CFD," 0,00 "
06/11/2024 14:33:45,Open Position,NSDQ100/USD," 529,99 ",0.513767," 0,00 "," 5.627,81 "," 2.557,88 ",2846732463,CFD," 0,00 "
06/11/2024 14:34:07,Edit Stop Loss,-,"(8,03)",-," 0,00 "," 5.627,81 "," 2.549,85 ",2846048516,-," 0,00 "
06/11/2024 14:34:23,Edit Stop Loss,-,"(14,87)",-," 0,00 "," 5.627,81 "," 2.534,98 ",2846048516,-," 0,00 "
06/11/2024 14:35:04,Position closed,NSDQ100/USD," 537,34 ",0.513767," 7,35 "," 5.635,16 "," 3.072,32 ",2846732463,CFD," 0,00 "
06/11/2024 14:35:33,Open Position,NSDQ100/USD," 529,99 ",0.513680," 0,00 "," 5.635,16 "," 2.542,33 ",2846742102,CFD," 0,00 "
06/11/2024 14:35:53,Open Position,NSDQ100/USD," 529,99 ",0.513725," 0,00 "," 5.635,16 "," 2.012,34 ",2846743992,CFD," 0,00 "
06/11/2024 14:36:13,Open Position,NSDQ100/USD," 529,97 ",0.513648," 0,00 "," 5.635,16 "," 1.482,37 ",2846748465,CFD," 0,00 "
06/11/2024 14:36:46,Open Position,NSDQ100/USD," 519,93 ",0.503761," 0,00 "," 5.635,16 "," 962,44 ",2846750903,CFD," 0,00 "
06/11/2024 14:38:56,Open Position,NSDQ100/USD," 519,99 ",0.503444," 0,00 "," 5.635,16 "," 442,45 ",2846796702,CFD," 0,00 "
06/11/2024 14:41:43,Open Position,NSDQ100/USD," 199,99 ",0.193478," 0,00 "," 5.635,16 "," 242,46 ",2846835625,CFD," 0,00 "
06/11/2024 14:43:19,Position closed,NSDQ100/USD," 202,20 ",0.193478," 2,21 "," 5.637,37 "," 444,66 ",2846835625,CFD," 0,00 "
06/11/2024 14:44:01,Position closed,NSDQ100/USD," 520,44 ",0.503444," 0,45 "," 5.637,82 "," 965,10 ",2846796702,CFD," 0,00 "
06/11/2024 14:44:09,Open Position,NSDQ100/USD," 519,99 ",0.503766," 0,00 "," 5.637,82 "," 445,11 ",2846862108,CFD," 0,00 "
06/11/2024 14:44:24,Position closed,NSDQ100/USD," 524,22 ",0.503766," 4,23 "," 5.642,05 "," 969,33 ",2846862108,CFD," 0,00 "
06/11/2024 14:45:55,Position closed,NSDQ100/USD," 525,93 ",0.503761," 6,00 "," 5.648,05 "," 1.495,26 ",2846750903,CFD," 0,00 "
06/11/2024 14:46:11,Position closed,NSDQ100/USD," 536,65 ",0.513648," 6,68 "," 5.654,73 "," 2.031,91 ",2846748465,CFD," 0,00 "
06/11/2024 14:46:24,Position closed,NSDQ100/USD," 543,50 ",0.513680," 13,51 "," 5.668,24 "," 2.575,41 ",2846742102,CFD," 0,00 "
06/11/2024 14:46:57,Position closed,NSDQ100/USD," 549,77 ",0.513725," 19,78 "," 5.688,02 "," 3.125,18 ",2846743992,CFD," 0,00 "
06/11/2024 14:47:14,Open Position,NSDQ100/USD," 300,00 ",0.291552," 0,00 "," 5.688,02 "," 2.825,18 ",2846876319,CFD," 0,00 "
06/11/2024 14:48:37,Position closed,NSDQ100/USD," 541,37 ",0.525094," 1,38 "," 5.689,40 "," 3.366,55 ",2846716997,CFD," 0,00 "
06/11/2024 14:48:55,Position closed,NSDQ100/USD," 302,74 ",0.291552," 2,74 "," 5.692,14 "," 3.669,29 ",2846876319,CFD," 0,00 "
06/11/2024 14:50:05,Open Position,NSDQ100/USD," 200,00 ",0.194509," 0,00 "," 5.692,14 "," 3.469,29 ",2846889168,CFD," 0,00 "
06/11/2024 14:50:21,Open Position,NSDQ100/USD," 299,99 ",0.292105," 0,00 "," 5.692,14 "," 3.169,30 ",2846890498,CFD," 0,00 "
06/11/2024 14:50:32,Position closed,NSDQ100/USD," 193,80 ",0.194509,"(6,20)"," 5.685,94 "," 3.363,10 ",2846889168,CFD," 0,00 "
06/11/2024 14:50:39,Position closed,NSDQ100/USD," 305,26 ",0.291896," 5,27 "," 5.691,21 "," 3.668,36 ",2846583331,CFD," 0,00 "
06/11/2024 14:53:45,Open Position,NSDQ100/USD," 299,99 ",0.291715," 0,00 "," 5.691,21 "," 3.368,37 ",2847008130,CFD," 0,00 "
06/11/2024 14:54:31,Position closed,NSDQ100/USD," 304,28 ",0.291715," 4,29 "," 5.695,50 "," 3.672,65 ",2847008130,CFD," 0,00 "
06/11/2024 14:55:37,Open Position,NSDQ100/USD," 325,40 ",0.291977," 0,00 "," 5.695,50 "," 3.372,65 ",2847023274,CFD," 0,00 "
06/11/2024 14:56:40,Open Position,TSLA/USD," 299,98 ",5.393132," 0,00 "," 5.695,50 "," 3.072,67 ",2847030209,CFD," 0,00 "
06/11/2024 14:57:42,Open Position,NSDQ100/USD," 249,99 ",0.243271," 0,00 "," 5.695,50 "," 2.822,68 ",2847034866,CFD," 0,00 "
06/11/2024 15:01:37,Open Position,NSDQ100/USD," 539,97 ",0.524195," 0,00 "," 5.695,50 "," 2.282,71 ",2847048492,CFD," 0,00 "
06/11/2024 15:04:40,Position closed,NSDQ100/USD," 547,94 ",0.524195," 7,97 "," 5.703,47 "," 2.830,65 ",2847048492,CFD," 0,00 "
06/11/2024 15:05:04,Open Position,NSDQ100/USD," 288,63 ",0.242989," 0,00 "," 5.703,47 "," 2.580,66 ",2847058998,CFD," 0,00 "
06/11/2024 15:19:41,Open Position,NSDQ100/USD," 599,99 ",0.580770," 0,00 "," 5.703,47 "," 1.980,67 ",2847103789,CFD," 0,00 "
06/11/2024 15:25:23,Position closed,NSDQ100/USD," 605,04 ",0.580770," 5,05 "," 5.708,52 "," 2.585,71 ",2847103789,CFD," 0,00 "
06/11/2024 15:25:34,Open Position,NSDQ100/USD," 349,99 ",0.339001," 0,00 "," 5.708,52 "," 2.235,72 ",2847125059,CFD," 0,00 "
06/11/2024 15:27:08,Open Position,NSDQ100/USD," 519,99 ",0.503178," 0,00 "," 5.708,52 "," 1.715,73 ",2847128355,CFD," 0,00 "
06/11/2024 15:38:58,Position closed,NSDQ100/USD," 526,68 ",0.503178," 6,69 "," 5.715,21 "," 2.242,41 ",2847128355,CFD," 0,00 "
06/11/2024 15:40:23,Position closed,NSDQ100/USD," 354,02 ",0.339001," 4,03 "," 5.719,24 "," 2.596,43 ",2847125059,CFD," 0,00 "
06/11/2024 15:40:55,Open Position,NSDQ100/USD," 529,99 ",0.513523," 0,00 "," 5.719,24 "," 2.066,44 ",2847167955,CFD," 0,00 "
06/11/2024 15:42:27,Open Position,NSDQ100/USD," 300,00 ",0.290603," 0,00 "," 5.719,24 "," 1.766,44 ",2847170927,CFD," 0,00 "
06/11/2024 15:43:18,Position closed,NSDQ100/USD," 303,49 ",0.290603," 3,49 "," 5.722,73 "," 2.069,93 ",2847170927,CFD," 0,00 "
06/11/2024 15:43:24,Position closed,NSDQ100/USD," 530,81 ",0.513523," 0,82 "," 5.723,55 "," 2.600,74 ",2847167955,CFD," 0,00 "
06/11/2024 15:43:59,Open Position,NSDQ100/USD," 529,99 ",0.513777," 0,00 "," 5.723,55 "," 2.070,75 ",2847174226,CFD," 0,00 "
06/11/2024 15:44:15,Open Position,NSDQ100/USD," 249,99 ",0.242336," 0,00 "," 5.723,55 "," 1.820,76 ",2847174557,CFD," 0,00 "
06/11/2024 15:48:07,Open Position,NSDQ100/USD," 300,00 ",0.290751," 0,00 "," 5.723,55 "," 1.520,76 ",2847185576,CFD," 0,00 "
06/11/2024 15:52:27,Position closed,NSDQ100/USD," 537,34 ",0.513777," 7,35 "," 5.730,90 "," 2.058,10 ",2847174226,CFD," 0,00 "
06/11/2024 15:53:02,Position closed,NSDQ100/USD," 254,65 ",0.242336," 4,66 "," 5.735,56 "," 2.312,75 ",2847174557,CFD," 0,00 "
06/11/2024 15:53:12,Position closed,NSDQ100/USD," 307,18 ",0.290751," 7,18 "," 5.742,74 "," 2.619,93 ",2847185576,CFD," 0,00 "
06/11/2024 15:53:22,Open Position,NSDQ100/USD," 324,46 ",0.291242," 0,00 "," 5.742,74 "," 2.319,93 ",2847198895,CFD," 0,00 "
06/11/2024 16:13:13,Open Position,NSDQ100/USD," 313,37 ",0.290720," 0,00 "," 5.742,74 "," 2.019,93 ",2847245760,CFD," 0,00 "
06/11/2024 16:36:08,Open Position,NSDQ100/USD," 519,99 ",0.502981," 0,00 "," 5.742,74 "," 1.499,94 ",2847320753,CFD," 0,00 "
06/11/2024 16:36:17,Open Position,NSDQ100/USD," 302,03 ",0.290177," 0,00 "," 5.742,74 "," 1.199,94 ",2847320892,CFD," 0,00 "
06/11/2024 16:42:58,Open Position,NSDQ100/USD," 249,98 ",0.241668," 0,00 "," 5.742,74 "," 949,96 ",2847337335,CFD," 0,00 "
06/11/2024 17:00:28,Open Position,NSDQ100/USD," 239,99 ",0.232159," 0,00 "," 5.742,74 "," 709,97 ",2847357115,CFD," 0,00 "
06/11/2024 17:17:55,Position closed,NSDQ100/USD," 250,10 ",0.241668," 0,12 "," 5.742,86 "," 960,07 ",2847337335,CFD," 0,00 "
06/11/2024 18:30:02,Position closed,NSDQ100/USD," 149,84 ",0.297479,"(173,06)"," 5.569,80 "," 1.109,91 ",2846048516,CFD," 0,00 "
06/11/2024 18:31:10,Open Position,NSDQ100/USD," 99,99 ",0.096407," 0,00 "," 5.569,80 "," 1.009,92 ",2847529946,CFD," 0,00 "
06/11/2024 18:31:19,Open Position,NSDQ100/USD," 249,99 ",0.241049," 0,00 "," 5.569,80 "," 759,93 ",2847530044,CFD," 0,00 "
06/11/2024 18:41:59,Position closed,NSDQ100/USD," 100,22 ",0.096407," 0,23 "," 5.570,03 "," 860,15 ",2847529946,CFD," 0,00 "
06/11/2024 18:45:30,Open Position,NSDQ100/USD," 149,99 ",0.144528," 0,00 "," 5.570,03 "," 710,16 ",2847545489,CFD," 0,00 "
06/11/2024 19:53:00,Position closed,NSDQ100/USD," 151,46 ",0.144528," 1,47 "," 5.571,50 "," 861,62 ",2847545489,CFD," 0,00 "
06/11/2024 19:53:38,Open Position,NSDQ100/USD," 200,00 ",0.192631," 0,00 "," 5.571,50 "," 661,62 ",2847615604,CFD," 0,00 "
06/11/2024 20:13:21,Position closed,NSDQ100/USD," 205,43 ",0.192631," 5,43 "," 5.576,93 "," 867,05 ",2847615604,CFD," 0,00 "
06/11/2024 20:16:17,Open Position,NSDQ100/USD," 300,00 ",0.288435," 0,00 "," 5.576,93 "," 567,05 ",2847646559,CFD," 0,00 "
06/11/2024 20:55:03,Position closed,NSDQ100/USD," 304,55 ",0.288435," 4,55 "," 5.581,48 "," 871,60 ",2847646559,CFD," 0,00 "
06/11/2024 20:55:58,Open Position,NSDQ100/USD," 219,98 ",0.211649," 0,00 "," 5.581,48 "," 651,62 ",2847689158,CFD," 0,00 "
06/11/2024 23:06:22,Open Position,NSDQ100/USD," 169,99 ",0.163428," 0,00 "," 5.581,48 "," 481,63 ",2847713529,CFD," 0,00 "
07/11/2024 00:10:09,Index price adjustment,NSDQ100/USD,"(0,11)",-,"(0,11)"," 5.581,37 "," 481,52 ",2846497475,CFD," 0,00 "
07/11/2024 00:10:09,Index price adjustment,NSDQ100/USD,"(0,09)",-,"(0,09)"," 5.581,28 "," 481,43 ",2846499021,CFD," 0,00 "
07/11/2024 00:10:09,Index price adjustment,NSDQ100/USD,"(0,14)",-,"(0,14)"," 5.581,14 "," 481,29 ",2846515488,CFD," 0,00 "
07/11/2024 00:10:09,Index price adjustment,NSDQ100/USD,"(0,14)",-,"(0,14)"," 5.581,00 "," 481,15 ",2846580099,CFD," 0,00 "
07/11/2024 00:10:09,Index price adjustment,NSDQ100/USD,"(0,14)",-,"(0,14)"," 5.580,86 "," 481,01 ",2846890498,CFD," 0,00 "
07/11/2024 00:10:09,Index price adjustment,NSDQ100/USD,"(0,14)",-,"(0,14)"," 5.580,72 "," 480,87 ",2847023274,CFD," 0,00 "
07/11/2024 00:10:09,Index price adjustment,NSDQ100/USD,"(0,11)",-,"(0,11)"," 5.580,61 "," 480,76 ",2847034866,CFD," 0,00 "
07/11/2024 00:10:09,Index price adjustment,NSDQ100/USD,"(0,11)",-,"(0,11)"," 5.580,50 "," 480,65 ",2847058998,CFD," 0,00 "
07/11/2024 00:10:09,Index price adjustment,NSDQ100/USD,"(0,14)",-,"(0,14)"," 5.580,36 "," 480,51 ",2847198895,CFD," 0,00 "
07/11/2024 00:10:09,Index price adjustment,NSDQ100/USD,"(0,14)",-,"(0,14)"," 5.580,22 "," 480,37 ",2847245760,CFD," 0,00 "
07/11/2024 00:10:09,Index price adjustment,NSDQ100/USD,"(0,23)",-,"(0,23)"," 5.579,99 "," 480,14 ",2847320753,CFD," 0,00 "
07/11/2024 00:10:09,Index price adjustment,NSDQ100/USD,"(0,14)",-,"(0,14)"," 5.579,85 "," 480,00 ",2847320892,CFD," 0,00 "
07/11/2024 00:10:09,Index price adjustment,NSDQ100/USD,"(0,11)",-,"(0,11)"," 5.579,74 "," 479,89 ",2847357115,CFD," 0,00 "
07/11/2024 00:10:09,Index price adjustment,NSDQ100/USD,"(0,11)",-,"(0,11)"," 5.579,63 "," 479,78 ",2847530044,CFD," 0,00 "
07/11/2024 00:10:09,Index price adjustment,NSDQ100/USD,"(0,10)",-,"(0,10)"," 5.579,53 "," 479,68 ",2847689158,CFD," 0,00 "
07/11/2024 00:48:32,Overnight fee,Daily,"(0,03)",-,"(0,03)"," 5.579,50 "," 479,65 ",2847530044,CFD," 0,00 "
07/11/2024 00:48:32,Overnight fee,Daily,"(0,04)",-,"(0,04)"," 5.579,46 "," 479,61 ",2846580099,CFD," 0,00 "
07/11/2024 00:48:32,Overnight fee,Daily,"(0,04)",-,"(0,04)"," 5.579,42 "," 479,57 ",2847245760,CFD," 0,00 "
07/11/2024 00:48:32,Overnight fee,Daily,"(0,04)",-,"(0,04)"," 5.579,38 "," 479,53 ",2847198895,CFD," 0,00 "
07/11/2024 00:48:32,Overnight fee,Daily,"(0,04)",-,"(0,04)"," 5.579,34 "," 479,49 ",2846890498,CFD," 0,00 "
07/11/2024 00:48:32,Overnight fee,Daily,"(0,04)",-,"(0,04)"," 5.579,30 "," 479,45 ",2847023274,CFD," 0,00 "
07/11/2024 00:48:32,Overnight fee,Daily,"(0,04)",-,"(0,04)"," 5.579,26 "," 479,41 ",2846515488,CFD," 0,00 "
07/11/2024 00:48:32,Overnight fee,Daily,"(0,04)",-,"(0,04)"," 5.579,22 "," 479,37 ",2847320892,CFD," 0,00 "
07/11/2024 00:48:32,Overnight fee,Daily,"(0,07)",-,"(0,07)"," 5.579,15 "," 479,30 ",2847320753,CFD," 0,00 "
07/11/2024 00:48:32,Overnight fee,Daily,"(0,22)",-,"(0,22)"," 5.578,93 "," 479,08 ",2842271686,CFD," 0,00 "
07/11/2024 00:48:32,Overnight fee,Daily,"(0,29)",-,"(0,29)"," 5.578,64 "," 478,79 ",2841887128,CFD," 0,00 "
07/11/2024 00:48:32,Overnight fee,Daily,"(0,03)",-,"(0,03)"," 5.578,61 "," 478,76 ",2847034866,CFD," 0,00 "
07/11/2024 00:48:32,Overnight fee,Daily,"(0,03)",-,"(0,03)"," 5.578,58 "," 478,73 ",2847689158,CFD," 0,00 "
07/11/2024 00:48:32,Overnight fee,Daily,"(0,03)",-,"(0,03)"," 5.578,55 "," 478,70 ",2847058998,CFD," 0,00 "
07/11/2024 00:48:32,Overnight fee,Daily,"(0,03)",-,"(0,03)"," 5.578,52 "," 478,67 ",2846499021,CFD," 0,00 "
07/11/2024 00:48:32,Overnight fee,Daily,"(0,03)",-,"(0,03)"," 5.578,49 "," 478,64 ",2847357115,CFD," 0,00 "
07/11/2024 00:48:32,Overnight fee,Daily,"(0,03)",-,"(0,03)"," 5.578,46 "," 478,61 ",2846497475,CFD," 0,00 "
07/11/2024 06:42:27,Position closed,NSDQ100/USD," 175,90 ",0.163428," 5,91 "," 5.584,37 "," 654,51 ",2847713529,CFD," 0,00 "
07/11/2024 06:53:58,Open Position,NSDQ100/USD," 299,99 ",0.287904," 0,00 "," 5.584,37 "," 354,52 ",2847762625,CFD," 0,00 "
07/11/2024 07:06:15,Position closed,NSDQ100/USD," 302,69 ",0.287904," 2,70 "," 5.587,07 "," 657,21 ",2847762625,CFD," 0,00 "
07/11/2024 07:16:10,Open Position,NSDQ100/USD," 300,00 ",0.288043," 0,00 "," 5.587,07 "," 357,21 ",2847766778,CFD," 0,00 "
07/11/2024 07:30:07,Position closed,NSDQ100/USD," 217,36 ",0.211649,"(2,62)"," 5.584,45 "," 574,57 ",2847689158,CFD," 0,00 "
07/11/2024 07:31:01,Open Position,NSDQ100/USD," 249,99 ",0.240328," 0,00 "," 5.584,45 "," 324,58 ",2847773386,CFD," 0,00 "
07/11/2024 07:55:08,Position closed,NSDQ100/USD," 252,72 ",0.240328," 2,73 "," 5.587,18 "," 577,30 ",2847773386,CFD," 0,00 "
07/11/2024 07:59:08,Open Position,NSDQ100/USD," 200,00 ",0.192183," 0,00 "," 5.587,18 "," 377,30 ",2847777299,CFD," 0,00 "
07/11/2024 07:59:30,Position closed,NSDQ100/USD," 200,02 ",0.192183," 0,02 "," 5.587,20 "," 577,32 ",2847777299,CFD," 0,00 "
07/11/2024 08:08:27,Position closed,NSDQ100/USD," 297,03 ",0.288043,"(2,97)"," 5.584,23 "," 874,35 ",2847766778,CFD," 0,00 "
07/11/2024 08:09:27,Open Position,NSDQ100/USD," 299,99 ",0.288145," 0,00 "," 5.584,23 "," 574,36 ",2847804169,CFD," 0,00 "
07/11/2024 08:10:58,Position closed,NSDQ100/USD," 300,33 ",0.288145," 0,34 "," 5.584,57 "," 874,69 ",2847804169,CFD," 0,00 "
07/11/2024 08:15:24,Open Position,NSDQ100/USD," 299,99 ",0.288269," 0,00 "," 5.584,57 "," 574,70 ",2847806114,CFD," 0,00 "
07/11/2024 08:28:22,Open Position,NSDQ100/USD," 299,99 ",0.287934," 0,00 "," 5.584,57 "," 274,71 ",2847829251,CFD," 0,00 "
07/11/2024 08:31:42,Position closed,NSDQ100/USD," 301,77 ",0.287934," 1,78 "," 5.586,35 "," 576,48 ",2847829251,CFD," 0,00 "
07/11/2024 08:31:48,Position closed,NSDQ100/USD," 293,50 ",0.288269,"(6,49)"," 5.579,86 "," 869,98 ",2847806114,CFD," 0,00 "
07/11/2024 08:37:43,Open Position,NSDQ100/USD," 300,00 ",0.288182," 0,00 "," 5.579,86 "," 569,98 ",2847833003,CFD," 0,00 "
07/11/2024 08:45:39,Position closed,NSDQ100/USD," 300,92 ",0.288182," 0,92 "," 5.580,78 "," 870,90 ",2847833003,CFD," 0,00 "
07/11/2024 09:00:58,Open Position,NSDQ100/USD," 250,00 ",0.240153," 0,00 "," 5.580,78 "," 620,90 ",2847840869,CFD," 0,00 "
07/11/2024 09:10:44,Position closed,NSDQ100/USD," 252,73 ",0.240153," 2,73 "," 5.583,51 "," 873,63 ",2847840869,CFD," 0,00 "
07/11/2024 09:27:07,Open Position,NSDQ100/USD," 299,99 ",0.287941," 0,00 "," 5.583,51 "," 573,64 ",2847849062,CFD," 0,00 "
07/11/2024 10:03:48,Position closed,NSDQ100/USD," 301,40 ",0.287941," 1,41 "," 5.584,92 "," 875,04 ",2847849062,CFD," 0,00 "
07/11/2024 10:15:54,Open Position,NSDQ100/USD," 299,99 ",0.287998," 0,00 "," 5.584,92 "," 575,05 ",2847862743,CFD," 0,00 "
07/11/2024 11:03:56,Position closed,NSDQ100/USD," 302,58 ",0.287998," 2,59 "," 5.587,51 "," 877,63 ",2847862743,CFD," 0,00 "
07/11/2024 11:04:23,Open Position,NSDQ100/USD," 199,99 ",0.192095," 0,00 "," 5.587,51 "," 677,64 ",2847886380,CFD," 0,00 "
07/11/2024 11:40:58,Position closed,NSDQ100/USD," 199,53 ",0.192095,"(0,46)"," 5.587,05 "," 877,17 ",2847886380,CFD," 0,00 "
07/11/2024 11:41:41,Open Position,NSDQ100/USD," 350,00 ",0.336127," 0,00 "," 5.587,05 "," 527,17 ",2847899924,CFD," 0,00 "
07/11/2024 12:17:14,Position closed,NSDQ100/USD," 356,65 ",0.336127," 6,65 "," 5.593,70 "," 883,82 ",2847899924,CFD," 0,00 "
07/11/2024 12:17:27,Open Position,NSDQ100/USD," 349,99 ",0.335829," 0,00 "," 5.593,70 "," 533,83 ",2847912555,CFD," 0,00 "
07/11/2024 12:39:07,Position closed,NSDQ100/USD," 344,07 ",0.335829,"(5,92)"," 5.587,78 "," 877,90 ",2847912555,CFD," 0,00 "
07/11/2024 12:40:19,Open Position,NSDQ100/USD," 200,00 ",0.191779," 0,00 "," 5.587,78 "," 677,90 ",2847919218,CFD," 0,00 "
07/11/2024 12:42:20,Position closed,NSDQ100/USD," 201,20 ",0.191779," 1,20 "," 5.588,98 "," 879,10 ",2847919218,CFD," 0,00 "
07/11/2024 12:42:41,Open Position,NSDQ100/USD," 200,00 ",0.191875," 0,00 "," 5.588,98 "," 679,10 ",2847919691,CFD," 0,00 "
07/11/2024 12:44:08,Position closed,NSDQ100/USD," 199,36 ",0.191875,"(0,64)"," 5.588,34 "," 878,46 ",2847919691,CFD," 0,00 "
07/11/2024 13:05:20,Open Position,NSDQ100/USD," 450,00 ",0.431370," 0,00 "," 5.588,34 "," 428,46 ",2847926029,CFD," 0,00 "
07/11/2024 13:11:17,Open Position,NSDQ100/USD," 250,00 ",0.239464," 0,00 "," 5.588,34 "," 178,46 ",2847928279,CFD," 0,00 "
07/11/2024 13:13:42,Open Position,NSDQ100/USD," 149,99 ",0.143640," 0,00 "," 5.588,34 "," 28,47 ",2847929090,CFD," 0,00 "
07/11/2024 13:25:53,Position closed,NSDQ100/USD," 146,70 ",0.143640,"(3,29)"," 5.585,05 "," 175,17 ",2847929090,CFD," 0,00 "
07/11/2024 13:34:49,Position closed,NSDQ100/USD," 453,48 ",0.431370," 3,48 "," 5.588,53 "," 628,65 ",2847926029,CFD," 0,00 "
07/11/2024 13:35:18,Open Position,NSDQ100/USD," 249,99 ",0.239786," 0,00 "," 5.588,53 "," 378,66 ",2847941497,CFD," 0,00 "
07/11/2024 13:35:29,Position closed,NSDQ100/USD," 247,92 ",0.239786,"(2,07)"," 5.586,46 "," 626,58 ",2847941497,CFD," 0,00 "
07/11/2024 13:35:38,Open Position,NSDQ100/USD," 199,99 ",0.191762," 0,00 "," 5.586,46 "," 426,59 ",2847942142,CFD," 0,00 "
07/11/2024 13:52:17,Position closed,NSDQ100/USD," 203,30 ",0.191762," 3,31 "," 5.589,77 "," 629,89 ",2847942142,CFD," 0,00 "
07/11/2024 13:54:35,Open Position,NSDQ100/USD," 300,00 ",0.287374," 0,00 "," 5.589,77 "," 329,89 ",2848000337,CFD," 0,00 "
07/11/2024 14:04:01,Position closed,NSDQ100/USD," 301,89 ",0.287374," 1,89 "," 5.591,66 "," 631,78 ",2848000337,CFD," 0,00 "
07/11/2024 14:04:07,Position closed,NSDQ100/USD," 251,05 ",0.239464," 1,05 "," 5.592,71 "," 882,83 ",2847928279,CFD," 0,00 "
07/11/2024 14:04:36,Open Position,NSDQ100/USD," 300,00 ",0.287239," 0,00 "," 5.592,71 "," 582,83 ",2848003879,CFD," 0,00 "
07/11/2024 14:07:39,Position closed,NSDQ100/USD," 300,36 ",0.287239," 0,36 "," 5.593,07 "," 883,19 ",2848003879,CFD," 0,00 "
07/11/2024 14:09:53,Open Position,NSDQ100/USD," 199,99 ",0.191369," 0,00 "," 5.593,07 "," 683,20 ",2848047156,CFD," 0,00 "
07/11/2024 14:23:19,Position closed,NSDQ100/USD," 200,19 ",0.191369," 0,20 "," 5.593,27 "," 883,39 ",2848047156,CFD," 0,00 "
07/11/2024 14:23:43,Open Position,NSDQ100/USD," 199,99 ",0.191324," 0,00 "," 5.593,27 "," 683,40 ",2848053015,CFD," 0,00 "
07/11/2024 14:34:16,Position closed,NSDQ100/USD," 204,12 ",0.191324," 4,13 "," 5.597,40 "," 887,52 ",2848053015,CFD," 0,00 "
07/11/2024 14:35:10,Open Position,NSDQ100/USD," 300,00 ",0.286859," 0,00 "," 5.597,40 "," 587,52 ",2848237043,CFD," 0,00 "
07/11/2024 14:40:39,Open Position,NSDQ100/USD," 249,98 ",0.238470," 0,00 "," 5.597,40 "," 337,54 ",2848270702,CFD," 0,00 "
07/11/2024 15:02:57,Position closed,TSLA/USD," 217,48 ",5.393132,"(82,50)"," 5.514,90 "," 555,02 ",2847030209,CFD," 0,00 "
07/11/2024 15:03:28,Position closed,NSDQ100/USD," 253,81 ",0.238470," 3,83 "," 5.518,73 "," 808,83 ",2848270702,CFD," 0,00 "
07/11/2024 15:04:33,Position closed,NSDQ100/USD," 99,79 ",0.195208,"(100,21)"," 5.418,52 "," 908,62 ",2846499021,CFD," 0,00 "
07/11/2024 15:05:39,Position closed,NSDQ100/USD," 124,94 ",0.243963,"(125,05)"," 5.293,47 "," 1.033,56 ",2846497475,CFD," 0,00 "
07/11/2024 15:07:20,Open Position,NSDQ100/USD," 349,99 ",0.333156," 0,00 "," 5.293,47 "," 683,57 ",2848477689,CFD," 0,00 "
07/11/2024 15:10:38,Position closed,NSDQ100/USD," 357,31 ",0.502981,"(162,68)"," 5.130,79 "," 1.040,88 ",2847320753,CFD," 0,00 "
07/11/2024 15:12:44,Open Position,NSDQ100/USD," 499,99 ",0.476013," 0,00 "," 5.130,79 "," 540,89 ",2848492299,CFD," 0,00 "
07/11/2024 15:13:05,Position closed,NSDQ100/USD," 161,74 ",0.292124,"(138,25)"," 4.992,54 "," 702,63 ",2846515488,CFD," 0,00 "
07/11/2024 15:13:47,Position closed,NSDQ100/USD," 500,63 ",0.476013," 0,64 "," 4.993,18 "," 1.203,26 ",2848492299,CFD," 0,00 "
07/11/2024 15:13:59,Open Position,NSDQ100/USD," 390,00 ",0.371281," 0,00 "," 4.993,18 "," 813,26 ",2848496153,CFD," 0,00 "
07/11/2024 15:15:42,Open Position,NSDQ100/USD," 299,99 ",0.285665," 0,00 "," 4.993,18 "," 513,27 ",2848500742,CFD," 0,00 "
07/11/2024 15:21:09,Position closed,NSDQ100/USD," 297,75 ",0.285665,"(2,24)"," 4.990,94 "," 811,02 ",2848500742,CFD," 0,00 "
07/11/2024 15:22:32,Position closed,NSDQ100/USD," 382,34 ",0.371281,"(7,66)"," 4.983,28 "," 1.193,36 ",2848496153,CFD," 0,00 "
07/11/2024 15:22:37,Position closed,NSDQ100/USD," 341,88 ",0.333156,"(8,11)"," 4.975,17 "," 1.535,24 ",2848477689,CFD," 0,00 "
07/11/2024 15:22:51,Open Position,NSDQ100/USD," 300,00 ",0.285871," 0,00 "," 4.975,17 "," 1.235,24 ",2848515594,CFD," 0,00 "
07/11/2024 15:58:00,Position closed,NSDQ100/USD," 149,90 ",0.292105,"(150,09)"," 4.825,08 "," 1.385,14 ",2846890498,CFD," 0,00 "
07/11/2024 16:00:26,Position closed,NSDQ100/USD," 149,98 ",0.292032,"(150,01)"," 4.675,07 "," 1.535,12 ",2846580099,CFD," 0,00 "
07/11/2024 16:42:53,Edit Stop Loss,-,"(7,88)",-," 0,00 "," 4.675,07 "," 1.527,24 ",2847023274,-," 0,00 "
07/11/2024 16:48:35,Position closed,NSDQ100/USD," 124,92 ",0.243271,"(125,07)"," 4.550,00 "," 1.652,16 ",2847034866,CFD," 0,00 "
07/11/2024 17:44:17,Edit Stop Loss,-,"(17,52)",-," 0,00 "," 4.550,00 "," 1.634,64 ",2847023274,-," 0,00 "
07/11/2024 17:44:28,Edit Stop Loss,-,"(14,33)",-," 0,00 "," 4.550,00 "," 1.620,31 ",2847058998,-," 0,00 "
07/11/2024 17:44:51,Open Position,NSDQ100/USD," 499,99 ",0.474492," 0,00 "," 4.550,00 "," 1.120,32 ",2848757891,CFD," 0,00 "
07/11/2024 17:47:43,Position closed,NSDQ100/USD," 169,51 ",0.291977,"(155,89)"," 4.394,11 "," 1.289,83 ",2847023274,CFD," 0,00 "
07/11/2024 17:47:54,Open Position,NSDQ100/USD," 329,98 ",0.313031," 0,00 "," 4.394,11 "," 959,85 ",2848760306,CFD," 0,00 "
07/11/2024 17:49:21,Edit Stop Loss,-,"(24,31)",-," 0,00 "," 4.394,11 "," 935,54 ",2847058998,-," 0,00 "
07/11/2024 17:49:28,Edit Stop Loss,-,"(24,46)",-," 0,00 "," 4.394,11 "," 911,08 ",2847198895,-," 0,00 "
07/11/2024 17:49:40,Edit Stop Loss,-,"(13,37)",-," 0,00 "," 4.394,11 "," 897,71 ",2847245760,-," 0,00 "
07/11/2024 17:49:47,Edit Stop Loss,-,"(2,03)",-," 0,00 "," 4.394,11 "," 895,68 ",2847320892,-," 0,00 "
07/11/2024 18:37:06,Open Position,NSDQ100/USD," 230,00 ",0.218466," 0,00 "," 4.394,11 "," 665,68 ",2848948227,CFD," 0,00 "
07/11/2024 19:01:34,Position closed,NSDQ100/USD," 232,54 ",0.218466," 2,54 "," 4.396,65 "," 898,22 ",2848948227,CFD," 0,00 "
07/11/2024 19:03:47,Position closed,NSDQ100/USD," 490,71 ",0.474492,"(9,28)"," 4.387,37 "," 1.388,93 ",2848757891,CFD," 0,00 "
07/11/2024 20:26:54,Position closed,NSDQ100/USD," 344,49 ",0.313031," 14,51 "," 4.401,88 "," 1.733,42 ",2848760306,CFD," 0,00 "
07/11/2024 20:29:52,Open Position,NSDQ100/USD," 349,99 ",0.331507," 0,00 "," 4.401,88 "," 1.383,43 ",2849092000,CFD," 0,00 "
07/11/2024 21:31:18,Open Position,NSDQ100/USD," 500,00 ",0.473743," 0,00 "," 4.401,88 "," 883,43 ",2849148983,CFD," 0,00 "
07/11/2024 21:31:36,Open Position,NSDQ100/USD," 300,00 ",0.284252," 0,00 "," 4.401,88 "," 583,43 ",2849149009,CFD," 0,00 "
07/11/2024 21:31:47,Position closed,NSDQ100/USD," 353,07 ",0.331507," 3,08 "," 4.404,96 "," 936,50 ",2849092000,CFD," 0,00 "
07/11/2024 21:43:16,Position closed,NSDQ100/USD," 298,64 ",0.284252,"(1,36)"," 4.403,60 "," 1.235,14 ",2849149009,CFD," 0,00 "
07/11/2024 21:43:24,Position closed,NSDQ100/USD," 497,55 ",0.473743,"(2,45)"," 4.401,15 "," 1.732,69 ",2849148983,CFD," 0,00 "
07/11/2024 21:43:42,Open Position,NSDQ100/USD," 499,99 ",0.473829," 0,00 "," 4.401,15 "," 1.232,70 ",2849159895,CFD," 0,00 "
07/11/2024 21:44:01,Open Position,NSDQ100/USD," 499,99 ",0.473802," 0,00 "," 4.401,15 "," 732,71 ",2849159935,CFD," 0,00 "
08/11/2024 00:20:11,Index price adjustment,NSDQ100/USD,"(0,75)",-,"(0,75)"," 4.400,40 "," 731,96 ",2847058998,CFD," 0,00 "
08/11/2024 00:20:11,Index price adjustment,NSDQ100/USD,"(0,90)",-,"(0,90)"," 4.399,50 "," 731,06 ",2847198895,CFD," 0,00 "
08/11/2024 00:20:11,Index price adjustment,NSDQ100/USD,"(0,90)",-,"(0,90)"," 4.398,60 "," 730,16 ",2847245760,CFD," 0,00 "
08/11/2024 00:20:11,Index price adjustment,NSDQ100/USD,"(0,90)",-,"(0,90)"," 4.397,70 "," 729,26 ",2847320892,CFD," 0,00 "
08/11/2024 00:20:11,Index price adjustment,NSDQ100/USD,"(0,72)",-,"(0,72)"," 4.396,98 "," 728,54 ",2847357115,CFD," 0,00 "
08/11/2024 00:20:11,Index price adjustment,NSDQ100/USD,"(0,75)",-,"(0,75)"," 4.396,23 "," 727,79 ",2847530044,CFD," 0,00 "
08/11/2024 00:20:11,Index price adjustment,NSDQ100/USD,"(0,89)",-,"(0,89)"," 4.395,34 "," 726,90 ",2848237043,CFD," 0,00 "
08/11/2024 00:20:11,Index price adjustment,NSDQ100/USD,"(0,89)",-,"(0,89)"," 4.394,45 "," 726,01 ",2848515594,CFD," 0,00 "
08/11/2024 00:20:11,Index price adjustment,NSDQ100/USD,"(1,03)",-,"(1,03)"," 4.393,42 "," 724,98 ",2849092000,CFD," 0,00 "
08/11/2024 00:48:33,Overnight fee,Daily,"(0,03)",-,"(0,03)"," 4.393,39 "," 724,95 ",2847530044,CFD," 0,00 "
08/11/2024 00:48:33,Overnight fee,Daily,"(0,03)",-,"(0,03)"," 4.393,36 "," 724,92 ",2847058998,CFD," 0,00 "
08/11/2024 00:48:33,Overnight fee,Daily,"(0,03)",-,"(0,03)"," 4.393,33 "," 724,89 ",2847357115,CFD," 0,00 "
08/11/2024 00:48:33,Overnight fee,Daily,"(0,04)",-,"(0,04)"," 4.393,29 "," 724,85 ",2847245760,CFD," 0,00 "
08/11/2024 00:48:33,Overnight fee,Daily,"(0,04)",-,"(0,04)"," 4.393,25 "," 724,81 ",2848515594,CFD," 0,00 "
08/11/2024 00:48:33,Overnight fee,Daily,"(0,04)",-,"(0,04)"," 4.393,21 "," 724,77 ",2847198895,CFD," 0,00 "
08/11/2024 00:48:33,Overnight fee,Daily,"(0,04)",-,"(0,04)"," 4.393,17 "," 724,73 ",2848237043,CFD," 0,00 "
08/11/2024 00:48:33,Overnight fee,Daily,"(0,04)",-,"(0,04)"," 4.393,13 "," 724,69 ",2847320892,CFD," 0,00 "
08/11/2024 00:48:33,Overnight fee,Daily,"(0,06)",-,"(0,06)"," 4.393,07 "," 724,63 ",2849159895,CFD," 0,00 "
08/11/2024 00:48:33,Overnight fee,Daily,"(0,06)",-,"(0,06)"," 4.393,01 "," 724,57 ",2849159935,CFD," 0,00 "
08/11/2024 00:48:33,Overnight fee,Daily,"(0,22)",-,"(0,22)"," 4.392,79 "," 724,35 ",2842271686,CFD," 0,00 "
08/11/2024 00:48:33,Overnight fee,Daily,"(0,30)",-,"(0,30)"," 4.392,49 "," 724,05 ",2841887128,CFD," 0,00 "
08/11/2024 08:55:55,Deposit Conversion Fee,-,"(58,59)",-," 0,00 "," 6.393,86 "," 2.725,42 ",-,-," 0,00 "
08/11/2024 08:55:55,Deposit,9500.00 USDRON CreditCard," 2.001,37 ",-," 2.001,37 "," 6.393,86 "," 2.725,42 ",-,-," 0,00 "
08/11/2024 08:57:16,Deposit,8000.00 USDRON CreditCard," 1.685,47 ",-," 1.685,47 "," 8.079,33 "," 4.410,89 ",-,-," 0,00 "
08/11/2024 08:57:16,Deposit Conversion Fee,-,"(49,34)",-," 0,00 "," 8.079,33 "," 4.410,89 ",-,-," 0,00 "
08/11/2024 09:11:13,Open Position,NSDQ100/USD," 999,99 ",0.946914," 0,00 "," 8.079,33 "," 3.410,90 ",2849406289,CFD," 0,00 "
08/11/2024 09:12:35,Open Position,NSDQ100/USD," 300,00 ",0.284015," 0,00 "," 8.079,33 "," 3.110,90 ",2849406605,CFD," 0,00 "
08/11/2024 09:16:05,Position closed,NSDQ100/USD," 300,01 ",0.284015," 0,01 "," 8.079,34 "," 3.410,91 ",2849406605,CFD," 0,00 "
08/11/2024 09:20:42,Open Position,NSDQ100/USD," 720,00 ",0.681647," 0,00 "," 8.079,34 "," 2.690,91 ",2849408493,CFD," 0,00 "
08/11/2024 09:25:02,Position closed,NSDQ100/USD," 720,91 ",0.681647," 0,91 "," 8.080,25 "," 3.411,82 ",2849408493,CFD," 0,00 "
08/11/2024 09:34:11,Open Position,NSDQ100/USD," 720,00 ",0.681644," 0,00 "," 8.080,25 "," 2.691,82 ",2849411938,CFD," 0,00 "
08/11/2024 09:43:22,Position closed,NSDQ100/USD," 720,91 ",0.681644," 0,91 "," 8.081,16 "," 3.412,73 ",2849411938,CFD," 0,00 "
08/11/2024 09:43:42,Open Position,NSDQ100/USD," 499,99 ",0.473325," 0,00 "," 8.081,16 "," 2.912,74 ",2849414693,CFD," 0,00 "
08/11/2024 10:13:21,Position closed,NSDQ100/USD," 505,36 ",0.473829," 5,37 "," 8.086,53 "," 3.418,10 ",2849159895,CFD," 0,00 "
08/11/2024 10:14:38,Position closed,NSDQ100/USD," 1.027,58 ",0.946914," 27,59 "," 8.114,12 "," 4.445,68 ",2849406289,CFD," 0,00 "
08/11/2024 10:15:37,Position closed,NSDQ100/USD," 506,55 ",0.473802," 6,56 "," 8.120,68 "," 4.952,23 ",2849159935,CFD," 0,00 "
08/11/2024 10:16:07,Position closed,NSDQ100/USD," 515,44 ",0.473325," 15,45 "," 8.136,13 "," 5.467,67 ",2849414693,CFD," 0,00 "
08/11/2024 10:26:04,Open Position,NSDQ100/USD," 299,99 ",0.284533," 0,00 "," 8.136,13 "," 5.167,68 ",2849430238,CFD," 0,00 "
08/11/2024 10:28:59,Position closed,NSDQ100/USD," 300,94 ",0.284533," 0,95 "," 8.137,08 "," 5.468,62 ",2849430238,CFD," 0,00 "
08/11/2024 10:35:08,Open Position,NSDQ100/USD," 400,00 ",0.379841," 0,00 "," 8.137,08 "," 5.068,62 ",2849433105,CFD," 0,00 "
08/11/2024 10:35:40,Open Position,NSDQ100/USD," 300,00 ",0.284862," 0,00 "," 8.137,08 "," 4.768,62 ",2849433228,CFD," 0,00 "
08/11/2024 10:39:22,Position closed,NSDQ100/USD," 406,43 ",0.379841," 6,43 "," 8.143,51 "," 5.175,05 ",2849433105,CFD," 0,00 "
08/11/2024 10:39:26,Position closed,NSDQ100/USD," 293,72 ",0.284862,"(6,28)"," 8.137,23 "," 5.468,77 ",2849433228,CFD," 0,00 "
08/11/2024 10:41:50,Open Position,NSDQ100/USD," 499,99 ",0.475402," 0,00 "," 8.137,23 "," 4.968,78 ",2849436100,CFD," 0,00 "
08/11/2024 10:42:34,Open Position,NSDQ100/USD," 350,00 ",0.332526," 0,00 "," 8.137,23 "," 4.618,78 ",2849436399,CFD," 0,00 "
08/11/2024 11:04:42,Position closed,NSDQ100/USD," 338,51 ",0.332526,"(11,49)"," 8.125,74 "," 4.957,29 ",2849436399,CFD," 0,00 "
08/11/2024 11:04:50,Position closed,NSDQ100/USD," 507,38 ",0.475402," 7,39 "," 8.133,13 "," 5.464,67 ",2849436100,CFD," 0,00 "
08/11/2024 11:05:08,Open Position,NSDQ100/USD," 299,99 ",0.285499," 0,00 "," 8.133,13 "," 5.164,68 ",2849445787,CFD," 0,00 "
08/11/2024 11:13:00,Open Position,NSDQ100/USD," 299,99 ",0.285372," 0,00 "," 8.133,13 "," 4.864,69 ",2849448231,CFD," 0,00 "
08/11/2024 11:18:59,Open Position,NSDQ100/USD," 399,99 ",0.380195," 0,00 "," 8.133,13 "," 4.464,70 ",2849449763,CFD," 0,00 "
08/11/2024 11:46:21,Position closed,NSDQ100/USD," 400,31 ",0.380195," 0,32 "," 8.133,45 "," 4.865,01 ",2849449763,CFD," 0,00 "
08/11/2024 11:49:13,Open Position,NSDQ100/USD," 349,99 ",0.332489," 0,00 "," 8.133,45 "," 4.515,02 ",2849458574,CFD," 0,00 "
08/11/2024 13:18:17,Position closed,NSDQ100/USD," 352,36 ",0.332489," 2,37 "," 8.135,82 "," 4.867,38 ",2849458574,CFD," 0,00 "
08/11/2024 13:51:33,Open Position,NSDQ100/USD," 500,00 ",0.474854," 0,00 "," 8.135,82 "," 4.367,38 ",2849534249,CFD," 0,00 "
08/11/2024 14:21:32,Position closed,NSDQ100/USD," 503,20 ",0.474854," 3,20 "," 8.139,02 "," 4.870,58 ",2849534249,CFD," 0,00 "
08/11/2024 14:25:13,Open Position,NSDQ100/USD," 300,00 ",0.284750," 0,00 "," 8.139,02 "," 4.570,58 ",2849545920,CFD," 0,00 "
08/11/2024 14:31:40,Position closed,NSDQ100/USD," 306,38 ",0.284750," 6,38 "," 8.145,40 "," 4.876,96 ",2849545920,CFD," 0,00 "
08/11/2024 14:32:58,Open Position,NSDQ100/USD," 350,00 ",0.331646," 0,00 "," 8.145,40 "," 4.526,96 ",2849683342,CFD," 0,00 "
08/11/2024 14:33:49,Open Position,NSDQ100/USD," 399,98 ",0.378817," 0,00 "," 8.145,40 "," 4.126,98 ",2849689654,CFD," 0,00 "
08/11/2024 14:34:09,Position closed,NSDQ100/USD," 350,24 ",0.331646," 0,24 "," 8.145,64 "," 4.477,22 ",2849683342,CFD," 0,00 "
08/11/2024 14:36:29,Open Position,NSDQ100/USD," 349,99 ",0.331664," 0,00 "," 8.145,64 "," 4.127,23 ",2849696857,CFD," 0,00 "
08/11/2024 14:42:04,Position closed,NSDQ100/USD," 395,75 ",0.378817,"(4,23)"," 8.141,41 "," 4.522,98 ",2849689654,CFD," 0,00 "
08/11/2024 14:43:11,Position closed,NSDQ100/USD," 352,96 ",0.331664," 2,97 "," 8.144,38 "," 4.875,94 ",2849696857,CFD," 0,00 "
08/11/2024 14:43:17,Open Position,NSDQ100/USD," 729,99 ",0.692285," 0,00 "," 8.144,38 "," 4.145,95 ",2849717818,CFD," 0,00 "
08/11/2024 14:43:57,Position closed,NSDQ100/USD," 732,93 ",0.692285," 2,94 "," 8.147,32 "," 4.878,88 ",2849717818,CFD," 0,00 "
08/11/2024 14:44:13,Open Position,NSDQ100/USD," 500,00 ",0.474437," 0,00 "," 8.147,32 "," 4.378,88 ",2849719895,CFD," 0,00 "
08/11/2024 14:45:29,Position closed,NSDQ100/USD," 500,97 ",0.474437," 0,97 "," 8.148,29 "," 4.879,85 ",2849719895,CFD," 0,00 "
08/11/2024 14:45:40,Open Position,NSDQ100/USD," 739,99 ",0.702521," 0,00 "," 8.148,29 "," 4.139,86 ",2849723382,CFD," 0,00 "
08/11/2024 14:47:15,Open Position,NSDQ100/USD," 500,00 ",0.474255," 0,00 "," 8.148,29 "," 3.639,86 ",2849726735,CFD," 0,00 "
08/11/2024 14:48:43,Open Position,NSDQ100/USD," 500,00 ",0.474006," 0,00 "," 8.148,29 "," 3.139,86 ",2849729867,CFD," 0,00 "
08/11/2024 14:51:15,Open Position,NSDQ100/USD," 350,00 ",0.331718," 0,00 "," 8.148,29 "," 2.789,86 ",2849800655,CFD," 0,00 "
08/11/2024 14:55:18,Position closed,NSDQ100/USD," 351,40 ",0.331718," 1,40 "," 8.149,69 "," 3.141,26 ",2849800655,CFD," 0,00 "
08/11/2024 14:55:30,Open Position,NSDQ100/USD," 499,99 ",0.473712," 0,00 "," 8.149,69 "," 2.641,27 ",2849886377,CFD," 0,00 "
08/11/2024 15:06:20,Position closed,NSDQ100/USD," 503,72 ",0.474255," 3,72 "," 8.153,41 "," 3.144,99 ",2849726735,CFD," 0,00 "
08/11/2024 15:06:42,Position closed,NSDQ100/USD," 478,17 ",0.473712,"(21,82)"," 8.131,59 "," 3.623,16 ",2849886377,CFD," 0,00 "
08/11/2024 15:06:56,Position closed,NSDQ100/USD," 513,10 ",0.474006," 13,10 "," 8.144,69 "," 4.136,26 ",2849729867,CFD," 0,00 "
08/11/2024 15:10:27,Open Position,NSDQ100/USD," 199,99 ",0.189899," 0,00 "," 8.144,69 "," 3.936,27 ",2849935829,CFD," 0,00 "
08/11/2024 15:10:53,Position closed,NSDQ100/USD," 744,16 ",0.702521," 4,17 "," 8.148,86 "," 4.680,43 ",2849723382,CFD," 0,00 "
08/11/2024 15:12:24,Position closed,MSFT/USD," 130,23 ",1.722109,"(19,77)"," 8.129,09 "," 4.810,66 ",2842271686,CFD," 0,00 "
08/11/2024 15:12:24,Position closed,MSFT/USD," 174,98 ",2.299212,"(25,01)"," 8.104,08 "," 4.985,64 ",2841887128,CFD," 0,00 "
08/11/2024 15:12:57,Position closed,NSDQ100/USD," 200,11 ",0.189899," 0,12 "," 8.104,20 "," 5.185,75 ",2849935829,CFD," 0,00 "
08/11/2024 15:13:21,Open Position,NSDQ100/USD," 399,99 ",0.379836," 0,00 "," 8.104,20 "," 4.785,76 ",2849942295,CFD," 0,00 "
08/11/2024 15:14:10,Open Position,NSDQ100/USD," 300,00 ",0.284788," 0,00 "," 8.104,20 "," 4.485,76 ",2849945145,CFD," 0,00 "
08/11/2024 15:19:04,Open Position,NSDQ100/USD," 399,99 ",0.379436," 0,00 "," 8.104,20 "," 4.085,77 ",2849955825,CFD," 0,00 "
08/11/2024 15:36:43,Position closed,NSDQ100/USD," 402,51 ",0.379436," 2,52 "," 8.106,72 "," 4.488,28 ",2849955825,CFD," 0,00 "
08/11/2024 15:37:59,Open Position,NSDQ100/USD," 599,98 ",0.569362," 0,00 "," 8.106,72 "," 3.888,30 ",2849999505,CFD," 0,00 "
08/11/2024 15:38:27,Position closed,NSDQ100/USD," 602,96 ",0.569362," 2,98 "," 8.109,70 "," 4.491,26 ",2849999505,CFD," 0,00 "
08/11/2024 15:39:20,Open Position,NSDQ100/USD," 559,99 ",0.531357," 0,00 "," 8.109,70 "," 3.931,27 ",2850002528,CFD," 0,00 "
08/11/2024 15:41:10,Position closed,NSDQ100/USD," 563,36 ",0.531357," 3,37 "," 8.113,07 "," 4.494,63 ",2850002528,CFD," 0,00 "
08/11/2024 15:41:29,Open Position,NSDQ100/USD," 500,00 ",0.474433," 0,00 "," 8.113,07 "," 3.994,63 ",2850006934,CFD," 0,00 "
08/11/2024 15:43:25,Position closed,NSDQ100/USD," 500,16 ",0.474433," 0,16 "," 8.113,23 "," 4.494,79 ",2850006934,CFD," 0,00 "
08/11/2024 15:43:44,Open Position,NSDQ100/USD," 399,99 ",0.379572," 0,00 "," 8.113,23 "," 4.094,80 ",2850010101,CFD," 0,00 "
08/11/2024 15:44:45,Position closed,NSDQ100/USD," 402,21 ",0.379572," 2,22 "," 8.115,45 "," 4.497,01 ",2850010101,CFD," 0,00 "
08/11/2024 15:46:11,Open Position,NSDQ100/USD," 739,99 ",0.702358," 0,00 "," 8.115,45 "," 3.757,02 ",2850014665,CFD," 0,00 "
08/11/2024 15:48:51,Open Position,NSDQ100/USD," 729,99 ",0.692334," 0,00 "," 8.115,45 "," 3.027,03 ",2850022812,CFD," 0,00 "
08/11/2024 15:56:15,Position closed,NSDQ100/USD," 731,40 ",0.692334," 1,41 "," 8.116,86 "," 3.758,43 ",2850022812,CFD," 0,00 "
08/11/2024 15:56:33,Open Position,NSDQ100/USD," 300,00 ",0.284604," 0,00 "," 8.116,86 "," 3.458,43 ",2850037440,CFD," 0,00 "
08/11/2024 16:01:07,Position closed,NSDQ100/USD," 302,80 ",0.284604," 2,80 "," 8.119,66 "," 3.761,23 ",2850037440,CFD," 0,00 "
08/11/2024 16:02:33,Position closed,NSDQ100/USD," 741,84 ",0.702358," 1,85 "," 8.121,51 "," 4.503,07 ",2850014665,CFD," 0,00 "
08/11/2024 16:04:01,Position closed,NSDQ100/USD," 301,07 ",0.284788," 1,07 "," 8.122,58 "," 4.804,14 ",2849945145,CFD," 0,00 "
08/11/2024 16:05:35,Open Position,NSDQ100/USD," 739,99 ",0.702134," 0,00 "," 8.122,58 "," 4.064,15 ",2850063656,CFD," 0,00 "
08/11/2024 16:08:27,Open Position,NSDQ100/USD," 399,99 ",0.379472," 0,00 "," 8.122,58 "," 3.664,16 ",2850068076,CFD," 0,00 "
08/11/2024 16:27:01,Open Position,NSDQ100/USD," 349,99 ",0.331713," 0,00 "," 8.122,58 "," 3.314,17 ",2850095384,CFD," 0,00 "
08/11/2024 16:31:46,Open Position,NSDQ100/USD," 299,99 ",0.284269," 0,00 "," 8.122,58 "," 3.014,18 ",2850100840,CFD," 0,00 "
08/11/2024 16:44:28,Position closed,NSDQ100/USD," 353,82 ",0.331713," 3,83 "," 8.126,41 "," 3.368,00 ",2850095384,CFD," 0,00 "
08/11/2024 16:44:52,Position closed,NSDQ100/USD," 294,14 ",0.284269,"(5,85)"," 8.120,56 "," 3.662,14 ",2850100840,CFD," 0,00 "
08/11/2024 16:45:24,Open Position,NSDQ100/USD," 349,99 ",0.331931," 0,00 "," 8.120,56 "," 3.312,15 ",2850113186,CFD," 0,00 "
08/11/2024 16:49:46,Open Position,NSDQ100/USD," 729,99 ",0.691888," 0,00 "," 8.120,56 "," 2.582,16 ",2850116502,CFD," 0,00 "
08/11/2024 16:51:59,Open Position,NSDQ100/USD," 719,99 ",0.682226," 0,00 "," 8.120,56 "," 1.862,17 ",2850118469,CFD," 0,00 "
08/11/2024 16:56:25,Open Position,NSDQ100/USD," 500,00 ",0.473548," 0,00 "," 8.120,56 "," 1.362,17 ",2850122956,CFD," 0,00 "
08/11/2024 16:57:08,Open Position,NSDQ100/USD," 300,00 ",0.284106," 0,00 "," 8.120,56 "," 1.062,17 ",2850123465,CFD," 0,00 "
08/11/2024 17:00:35,Position closed,NSDQ100/USD," 302,25 ",0.284106," 2,25 "," 8.122,81 "," 1.364,42 ",2850123465,CFD," 0,00 "
08/11/2024 17:00:59,Position closed,NSDQ100/USD," 501,34 ",0.473548," 1,34 "," 8.124,15 "," 1.865,76 ",2850122956,CFD," 0,00 "
08/11/2024 17:01:32,Open Position,NSDQ100/USD," 719,99 ",0.682184," 0,00 "," 8.124,15 "," 1.145,77 ",2850138224,CFD," 0,00 "
08/11/2024 17:02:05,Position closed,NSDQ100/USD," 719,87 ",0.682226,"(0,12)"," 8.124,03 "," 1.865,64 ",2850118469,CFD," 0,00 "
08/11/2024 17:03:25,Position closed,NSDQ100/USD," 722,94 ",0.682184," 2,95 "," 8.126,98 "," 2.588,58 ",2850138224,CFD," 0,00 "
08/11/2024 17:04:20,Open Position,NSDQ100/USD," 500,00 ",0.473979," 0,00 "," 8.126,98 "," 2.088,58 ",2850140890,CFD," 0,00 "
08/11/2024 17:06:56,Open Position,NSDQ100/USD," 399,99 ",0.379224," 0,00 "," 8.126,98 "," 1.688,59 ",2850163293,CFD," 0,00 "
08/11/2024 17:11:32,Position closed,NSDQ100/USD," 730,36 ",0.691888," 0,37 "," 8.127,35 "," 2.418,95 ",2850116502,CFD," 0,00 "
08/11/2024 17:15:35,Position closed,NSDQ100/USD," 503,29 ",0.473979," 3,29 "," 8.130,64 "," 2.922,24 ",2850140890,CFD," 0,00 "
08/11/2024 17:16:16,Position closed,NSDQ100/USD," 401,83 ",0.379224," 1,84 "," 8.132,48 "," 3.324,07 ",2850163293,CFD," 0,00 "
08/11/2024 17:19:07,Open Position,NSDQ100/USD," 399,99 ",0.379233," 0,00 "," 8.132,48 "," 2.924,08 ",2850176515,CFD," 0,00 "
08/11/2024 17:21:05,Open Position,NSDQ100/USD," 729,99 ",0.692058," 0,00 "," 8.132,48 "," 2.194,09 ",2850178244,CFD," 0,00 "
08/11/2024 17:23:02,Position closed,NSDQ100/USD," 732,65 ",0.692058," 2,66 "," 8.135,14 "," 2.926,74 ",2850178244,CFD," 0,00 "
08/11/2024 17:23:39,Position closed,NSDQ100/USD," 401,64 ",0.379233," 1,65 "," 8.136,79 "," 3.328,38 ",2850176515,CFD," 0,00 "
08/11/2024 17:24:46,Open Position,NSDQ100/USD," 299,99 ",0.284517," 0,00 "," 8.136,79 "," 3.028,39 ",2850191180,CFD," 0,00 "
08/11/2024 17:30:23,Open Position,NSDQ100/USD," 299,99 ",0.284415," 0,00 "," 8.136,79 "," 2.728,40 ",2850197054,CFD," 0,00 "
08/11/2024 17:32:42,Position closed,NSDQ100/USD," 302,59 ",0.284415," 2,60 "," 8.139,39 "," 3.030,99 ",2850197054,CFD," 0,00 "
08/11/2024 17:33:04,Open Position,NSDQ100/USD," 300,00 ",0.284294," 0,00 "," 8.139,39 "," 2.730,99 ",2850199861,CFD," 0,00 "
08/11/2024 17:34:46,Open Position,NSDQ100/USD," 399,99 ",0.378987," 0,00 "," 8.139,39 "," 2.331,00 ",2850201354,CFD," 0,00 "
08/11/2024 17:34:56,Open Position,NSDQ100/USD," 299,99 ",0.284164," 0,00 "," 8.139,39 "," 2.031,01 ",2850201571,CFD," 0,00 "
08/11/2024 18:11:15,Position closed,NSDQ100/USD," 301,87 ",0.284164," 1,88 "," 8.141,27 "," 2.332,88 ",2850201571,CFD," 0,00 "
08/11/2024 18:43:10,Open Position,NSDQ100/USD," 500,00 ",0.472981," 0,00 "," 8.141,27 "," 1.832,88 ",2850280956,CFD," 0,00 "
08/11/2024 18:54:00,Position closed,NSDQ100/USD," 503,60 ",0.472981," 3,60 "," 8.144,87 "," 2.336,48 ",2850280956,CFD," 0,00 "
08/11/2024 19:14:40,Open Position,NSDQ100/USD," 200,00 ",0.189203," 0,00 "," 8.144,87 "," 2.136,48 ",2850310424,CFD," 0,00 "
08/11/2024 19:45:44,Position closed,NSDQ100/USD," 201,18 ",0.189203," 1,18 "," 8.146,05 "," 2.337,66 ",2850310424,CFD," 0,00 "
08/11/2024 19:53:29,Open Position,NSDQ100/USD," 299,99 ",0.283907," 0,00 "," 8.146,05 "," 2.037,67 ",2850342030,CFD," 0,00 "
08/11/2024 20:30:49,Position closed,NSDQ100/USD," 399,93 ",0.378987,"(0,06)"," 8.145,99 "," 2.437,60 ",2850201354,CFD," 0,00 "