Date,Type,Details,Amount,Units / Contracts,Realized Equity Change,Realized Equity,Balance,Position ID,Asset type,NWA
13/02/2025 00:09:17,Open Position,USD/JPY," 199,99 ",6000," 0,00 "," 4.970,99 "," 1.016,93 ",2941080391,CFD," 0,00 "
13/02/2025 00:47:55,Weekend refund,Weekend Fee," 3,50 ",-," 3,50 "," 4.974,49 "," 1.020,43 ",2940997965,CFD," 0,00 "
13/02/2025 00:47:55,Weekend refund,Weekend Fee," 2,80 ",-," 2,80 "," 4.977,29 "," 1.023,23 ",2940842464,CFD," 0,00 "
13/02/2025 00:47:55,Weekend refund,Weekend Fee," 2,80 ",-," 2,80 "," 4.980,09 "," 1.026,03 ",2940788628,CFD," 0,00 "
13/02/2025 00:47:55,Weekend refund,Weekend Fee," 1,75 ",-," 1,75 "," 4.981,84 "," 1.027,78 ",2940872465,CFD," 0,00 "
13/02/2025 00:47:55,Weekend refund,Weekend Fee," 1,40 ",-," 1,40 "," 4.983,24 "," 1.029,18 ",2940789027,CFD," 0,00 "
13/02/2025 00:47:55,Overnight fee,Daily,"(0,03)",-,"(0,03)"," 4.983,21 "," 1.029,15 ",2940436584,CFD," 0,00 "
13/02/2025 00:47:55,Overnight fee,Daily,"(1,20)",-,"(1,20)"," 4.982,01 "," 1.027,95 ",2938586783,CFD," 0,00 "
13/02/2025 00:47:55,Overnight fee,Weekend Fee,"(2,07)",-,"(2,07)"," 4.979,94 "," 1.025,88 ",2937534559,CFD," 0,00 "
13/02/2025 00:47:55,Overnight fee,Weekend Fee,"(2,07)",-,"(2,07)"," 4.977,87 "," 1.023,81 ",2939910134,CFD," 0,00 "
13/02/2025 00:47:55,Overnight fee,Weekend Fee,"(2,76)",-,"(2,76)"," 4.975,11 "," 1.021,05 ",2939961593,CFD," 0,00 "
13/02/2025 00:47:55,Overnight fee,Weekend Fee,"(2,76)",-,"(2,76)"," 4.972,35 "," 1.018,29 ",2939684671,CFD," 0,00 "
13/02/2025 00:47:55,Overnight fee,Weekend Fee,"(3,45)",-,"(3,45)"," 4.968,90 "," 1.014,84 ",2938476606,CFD," 0,00 "
13/02/2025 00:47:55,Overnight fee,Weekend Fee,"(3,45)",-,"(3,45)"," 4.965,45 "," 1.011,39 ",2939094941,CFD," 0,00 "
13/02/2025 00:47:55,Overnight fee,Weekend Fee,"(4,14)",-,"(4,14)"," 4.961,31 "," 1.007,25 ",2939176899,CFD," 0,00 "
13/02/2025 00:47:55,Overnight fee,Weekend Fee,"(5,52)",-,"(5,52)"," 4.955,79 "," 1.001,73 ",2939122280,CFD," 0,00 "
13/02/2025 07:14:17,Open Position,USD/JPY," 199,99 ",6000," 0,00 "," 4.955,79 "," 801,74 ",2941125103,CFD," 0,00 "
13/02/2025 07:58:24,Position closed,USD/JPY," 203,06 ",6000," 3,07 "," 4.958,86 "," 1.004,80 ",2941080391,CFD," 0,00 "
13/02/2025 07:58:31,Position closed,USD/JPY," 204,58 ",6000," 4,59 "," 4.963,45 "," 1.209,38 ",2941125103,CFD," 0,00 "
13/02/2025 07:59:18,Open Position,USD/JPY," 199,99 ",6000," 0,00 "," 4.963,45 "," 1.009,39 ",2941132308,CFD," 0,00 "
13/02/2025 08:47:58,Open Position,USD/JPY," 199,99 ",6000," 0,00 "," 4.963,45 "," 809,40 ",2941200534,CFD," 0,00 "
13/02/2025 08:48:56,Open Position,USD/JPY," 249,99 ",7500," 0,00 "," 4.963,45 "," 559,41 ",2941200833,CFD," 0,00 "
13/02/2025 09:09:52,Open Position,USD/JPY," 150,00 ",4500," 0,00 "," 4.963,45 "," 409,41 ",2941207648,CFD," 0,00 "
13/02/2025 09:20:40,Position closed,USD/JPY," 55,03 ",2252.979688,"(41,29)"," 4.922,16 "," 464,44 ",2941210550,CFD," 0,00 "
13/02/2025 09:21:16,Position closed,USD/JPY," 54,92 ",2247.020312,"(41,15)"," 4.881,01 "," 519,36 ",2937534559,CFD," 0,00 "
13/02/2025 09:42:39,Position closed,USD/JPY," 153,83 ",4500," 3,83 "," 4.884,84 "," 673,19 ",2941207648,CFD," 0,00 "
13/02/2025 10:05:21,Open Position,USD/JPY," 249,99 ",7500," 0,00 "," 4.884,84 "," 423,20 ",2941226215,CFD," 0,00 "
13/02/2025 10:32:19,Open Position,USD/JPY," 199,99 ",6000," 0,00 "," 4.884,84 "," 223,21 ",2941233312,CFD," 0,00 "
13/02/2025 12:48:57,Position closed,USD/JPY," 196,09 ",6000,"(3,90)"," 4.880,94 "," 419,30 ",2941233312,CFD," 0,00 "
13/02/2025 13:30:43,Position closed,USD/JPY," 251,50 ",7500," 1,51 "," 4.882,45 "," 670,80 ",2941226215,CFD," 0,00 "
13/02/2025 13:38:03,Position closed,NSDQ100/USD," 308,66 ",0.229433," 2,05 "," 4.884,50 "," 979,46 ",2938586783,CFD," 0,00 "
13/02/2025 13:46:41,Open Position,USD/JPY," 199,99 ",6000," 0,00 "," 4.884,50 "," 779,47 ",2941292796,CFD," 0,00 "
13/02/2025 13:52:33,Position closed,USD/JPY," 327,94 ",12000,"(109,50)"," 4.775,00 "," 1.107,41 ",2939122280,CFD," 0,00 "
13/02/2025 13:52:43,Open Position,USD/JPY," 249,99 ",7500," 0,00 "," 4.775,00 "," 857,42 ",2941300167,CFD," 0,00 "
13/02/2025 13:58:31,Open Position,USD/JPY," 200,00 ",6000," 0,00 "," 4.775,00 "," 657,42 ",2941301619,CFD," 0,00 "
13/02/2025 14:03:39,Position closed,USD/JPY," 251,11 ",7500," 1,12 "," 4.776,12 "," 908,53 ",2941300167,CFD," 0,00 "
13/02/2025 14:03:48,Open Position,USD/JPY," 199,99 ",6000," 0,00 "," 4.776,12 "," 708,54 ",2941303280,CFD," 0,00 "
13/02/2025 14:17:06,Position closed,USD/JPY," 201,76 ",6000," 1,76 "," 4.777,88 "," 910,30 ",2941301619,CFD," 0,00 "
13/02/2025 14:18:51,Open Position,USD/JPY," 150,00 ",4500," 0,00 "," 4.777,88 "," 760,30 ",2941307410,CFD," 0,00 "
13/02/2025 14:32:41,Edit Stop Loss,-,"(4,37)",-," 0,00 "," 4.777,88 "," 755,93 ",2940436584,-," 0,00 "
13/02/2025 14:32:51,Edit Stop Loss,-,"(9,29)",-," 0,00 "," 4.777,88 "," 746,64 ",2940436584,-," 0,00 "
13/02/2025 14:33:20,Position closed,USD/JPY," 152,11 ",4500," 2,11 "," 4.779,99 "," 898,75 ",2941307410,CFD," 0,00 "
13/02/2025 14:33:30,Open Position,USD/JPY," 150,00 ",4500," 0,00 "," 4.779,99 "," 748,75 ",2941413778,CFD," 0,00 "
13/02/2025 14:33:44,Open Position,NSDQ100/USD," 99,98 ",0.091539," 0,00 "," 4.779,99 "," 648,77 ",2941414443,CFD," 0,00 "
13/02/2025 14:44:18,Open Position,USD/JPY," 250,00 ",7500," 0,00 "," 4.779,99 "," 398,77 ",2941445319,CFD," 0,00 "
13/02/2025 14:51:44,Position closed,USD/JPY," 252,25 ",7500," 2,25 "," 4.782,24 "," 651,02 ",2941445319,CFD," 0,00 "
13/02/2025 14:55:07,Open Position,USD/JPY," 250,00 ",7500," 0,00 "," 4.782,24 "," 401,02 ",2941547351,CFD," 0,00 "
13/02/2025 15:23:37,Position closed,NSDQ100/USD," 104,58 ",0.091539," 4,60 "," 4.786,84 "," 505,60 ",2941414443,CFD," 0,00 "
13/02/2025 15:24:01,Open Position,NSDQ100/USD," 149,99 ",0.136966," 0,00 "," 4.786,84 "," 355,61 ",2941623090,CFD," 0,00 "
13/02/2025 15:24:37,Position closed,USD/JPY," 254,79 ",7500," 4,79 "," 4.791,63 "," 610,40 ",2941547351,CFD," 0,00 "
13/02/2025 15:25:18,Open Position,USD/JPY," 200,00 ",6000," 0,00 "," 4.791,63 "," 410,40 ",2941627509,CFD," 0,00 "
13/02/2025 15:32:23,Position closed,NSDQ100/USD," 149,81 ",0.136966,"(0,18)"," 4.791,45 "," 560,21 ",2941623090,CFD," 0,00 "
13/02/2025 15:33:46,Position closed,USD/JPY," 287,78 ",12000,"(112,22)"," 4.679,23 "," 847,99 ",2940788628,CFD," 0,00 "
13/02/2025 15:40:33,Position closed,USD/JPY," 201,41 ",6000," 1,41 "," 4.680,64 "," 1.049,40 ",2941627509,CFD," 0,00 "
13/02/2025 15:45:09,Open Position,USD/JPY," 200,00 ",6000," 0,00 "," 4.680,64 "," 849,40 ",2941672985,CFD," 0,00 "
13/02/2025 15:46:20,Position closed,USD/JPY," 200,27 ",6000," 0,27 "," 4.680,91 "," 1.049,67 ",2941672985,CFD," 0,00 "
13/02/2025 15:51:33,Open Position,USD/JPY," 150,00 ",4500," 0,00 "," 4.680,91 "," 899,67 ",2941684615,CFD," 0,00 "
13/02/2025 15:52:11,Open Position,USD/JPY," 99,99 ",3000," 0,00 "," 4.680,91 "," 799,68 ",2941687006,CFD," 0,00 "
13/02/2025 16:12:08,Position closed,USD/JPY," 100,83 ",3000," 0,84 "," 4.681,75 "," 900,51 ",2941687006,CFD," 0,00 "
13/02/2025 16:12:25,Open Position,USD/JPY," 200,00 ",6000," 0,00 "," 4.681,75 "," 700,51 ",2941719135,CFD," 0,00 "
13/02/2025 16:13:47,Position closed,USD/JPY," 146,59 ",4500,"(3,41)"," 4.678,34 "," 847,10 ",2941684615,CFD," 0,00 "
13/02/2025 16:16:47,Position closed,USD/JPY," 228,24 ",7500,"(54,20)"," 4.624,14 "," 1.075,34 ",2939094941,CFD," 0,00 "
13/02/2025 16:16:47,Position closed,USD/JPY," 182,78 ",6000,"(29,68)"," 4.594,46 "," 1.258,12 ",2939684671,CFD," 0,00 "
13/02/2025 16:16:47,Position closed,USD/JPY," 274,17 ",9000,"(45,04)"," 4.549,42 "," 1.532,29 ",2939176899,CFD," 0,00 "
13/02/2025 16:16:47,Position closed,USD/JPY," 280,19 ",12000,"(119,81)"," 4.429,61 "," 1.812,48 ",2940842464,CFD," 0,00 "
13/02/2025 16:16:47,Position closed,USD/JPY," 228,11 ",7500,"(70,71)"," 4.358,90 "," 2.040,59 ",2938476606,CFD," 0,00 "
13/02/2025 16:16:47,Position closed,USD/JPY," 186,00 ",6000,"(14,00)"," 4.344,90 "," 2.226,59 ",2939961593,CFD," 0,00 "
13/02/2025 16:16:47,Position closed,USD/JPY," 137,21 ",4500,"(17,52)"," 4.327,38 "," 2.363,80 ",2939910134,CFD," 0,00 "
13/02/2025 16:16:47,Position closed,USD/JPY," 131,61 ",6000,"(68,38)"," 4.259,00 "," 2.495,41 ",2940789027,CFD," 0,00 "
13/02/2025 16:16:47,Position closed,USD/JPY," 198,38 ",7500,"(51,61)"," 4.207,39 "," 2.693,79 ",2941200833,CFD," 0,00 "
13/02/2025 16:16:47,Position closed,USD/JPY," 150,63 ",6000,"(49,36)"," 4.158,03 "," 2.844,42 ",2941132308,CFD," 0,00 "
13/02/2025 16:16:47,Position closed,USD/JPY," 158,59 ",6000,"(41,40)"," 4.116,63 "," 3.003,01 ",2941200534,CFD," 0,00 "
13/02/2025 16:16:47,Position closed,USD/JPY," 180,40 ",7500,"(69,59)"," 4.047,04 "," 3.183,41 ",2940872465,CFD," 0,00 "
13/02/2025 16:16:47,Position closed,USD/JPY," 178,19 ",6000,"(21,80)"," 4.025,24 "," 3.361,60 ",2941303280,CFD," 0,00 "
13/02/2025 16:16:48,Position closed,USD/JPY," 135,47 ",4500,"(14,53)"," 4.010,71 "," 3.497,07 ",2941413778,CFD," 0,00 "
13/02/2025 16:16:48,Position closed,USD/JPY," 176,82 ",6000,"(23,17)"," 3.987,54 "," 3.673,89 ",2941292796,CFD," 0,00 "
13/02/2025 16:16:48,Position closed,USD/JPY," 199,88 ",6000,"(0,12)"," 3.987,42 "," 3.873,77 ",2941719135,CFD," 0,00 "
13/02/2025 16:35:07,Open Position,USD/JPY," 149,99 ",4500," 0,00 "," 3.987,42 "," 3.723,78 ",2941749405,CFD," 0,00 "
13/02/2025 16:38:47,Open Position,USD/JPY," 150,00 ",4500," 0,00 "," 3.987,42 "," 3.573,78 ",2941752714,CFD," 0,00 "
13/02/2025 16:40:25,Open Position,NSDQ100/USD," 199,98 ",0.182556," 0,00 "," 3.987,42 "," 3.373,80 ",2941753998,CFD," 0,00 "
13/02/2025 16:44:50,Position closed,USD/JPY," 151,44 ",4500," 1,44 "," 3.988,86 "," 3.525,24 ",2941752714,CFD," 0,00 "
13/02/2025 16:45:04,Open Position,USD/JPY," 259,99 ",7800," 0,00 "," 3.988,86 "," 3.265,25 ",2941758221,CFD," 0,00 "
13/02/2025 16:53:08,Position closed,NSDQ100/USD," 202,10 ",0.182556," 2,12 "," 3.990,98 "," 3.467,35 ",2941753998,CFD," 0,00 "
13/02/2025 16:53:48,Open Position,NSDQ100/USD," 199,98 ",0.182749," 0,00 "," 3.990,98 "," 3.267,37 ",2941765454,CFD," 0,00 "
13/02/2025 16:57:18,Position closed,NSDQ100/USD," 205,45 ",0.182749," 5,47 "," 3.996,45 "," 3.472,82 ",2941765454,CFD," 0,00 "
13/02/2025 16:57:56,Open Position,NSDQ100/USD," 100,00 ",0.091474," 0,00 "," 3.996,45 "," 3.372,82 ",2941769321,CFD," 0,00 "
13/02/2025 17:49:56,Open Position,NSDQ100/USD," 299,99 ",0.273922," 0,00 "," 3.996,45 "," 3.072,83 ",2941815549,CFD," 0,00 "
13/02/2025 18:52:02,Position closed,NSDQ100/USD," 307,53 ",0.273922," 7,54 "," 4.003,99 "," 3.380,36 ",2941815549,CFD," 0,00 "
13/02/2025 18:52:14,Open Position,NSDQ100/USD," 199,98 ",0.182971," 0,00 "," 4.003,99 "," 3.180,38 ",2941867797,CFD," 0,00 "
13/02/2025 18:52:31,Position closed,USD/JPY," 266,40 ",7800," 6,41 "," 4.010,40 "," 3.446,78 ",2941758221,CFD," 0,00 "
13/02/2025 18:52:42,Open Position,USD/JPY," 50,31 ",6000," 0,00 "," 4.010,40 "," 3.246,79 ",2941868070,CFD," 0,00 "
13/02/2025 19:10:52,Open Position,NSDQ100/USD," 299,99 ",0.273567," 0,00 "," 4.010,40 "," 2.946,80 ",2941886745,CFD," 0,00 "
13/02/2025 19:11:08,Open Position,NSDQ100/USD," 149,99 ",0.136754," 0,00 "," 4.010,40 "," 2.796,81 ",2941886955,CFD," 0,00 "
13/02/2025 19:21:01,Position closed,USD/JPY," 153,76 ",4500," 3,77 "," 4.014,17 "," 2.950,57 ",2941749405,CFD," 0,00 "
13/02/2025 19:22:10,Open Position,USD/JPY," 99,99 ",3000," 0,00 "," 4.014,17 "," 2.850,58 ",2941896627,CFD," 0,00 "
13/02/2025 19:22:59,Open Position,USD/JPY," 200,00 ",6000," 0,00 "," 4.014,17 "," 2.650,58 ",2941897137,CFD," 0,00 "
13/02/2025 19:42:26,Position closed,NSDQ100/USD," 152,01 ",0.136754," 2,02 "," 4.016,19 "," 2.802,59 ",2941886955,CFD," 0,00 "
13/02/2025 19:43:53,Open Position,NSDQ100/USD," 75,20 ",0.136667," 0,00 "," 4.016,19 "," 2.652,60 ",2941917933,CFD," 0,00 "
13/02/2025 19:44:01,Open Position,NSDQ100/USD," 200,00 ",0.182202," 0,00 "," 4.016,19 "," 2.452,60 ",2941917968,CFD," 0,00 "
13/02/2025 20:14:58,Position closed,NSDQ100/USD," 206,32 ",0.182202," 6,32 "," 4.022,51 "," 2.658,92 ",2941917968,CFD," 0,00 "
13/02/2025 20:15:33,Open Position,NSDQ100/USD," 149,99 ",0.136412," 0,00 "," 4.022,51 "," 2.508,93 ",2941954472,CFD," 0,00 "
13/02/2025 20:15:43,Open Position,NSDQ100/USD," 149,99 ",0.136436," 0,00 "," 4.022,51 "," 2.358,94 ",2941954565,CFD," 0,00 "
13/02/2025 20:23:59,Position closed,USD/JPY," 101,05 ",3000," 1,06 "," 4.023,57 "," 2.459,99 ",2941896627,CFD," 0,00 "
13/02/2025 20:24:06,Position closed,USD/JPY," 202,32 ",6000," 2,32 "," 4.025,89 "," 2.662,31 ",2941897137,CFD," 0,00 "
13/02/2025 20:24:18,Open Position,USD/JPY," 300,00 ",9000," 0,00 "," 4.025,89 "," 2.362,31 ",2941971720,CFD," 0,00 "
13/02/2025 20:24:42,Position closed,NSDQ100/USD," 150,28 ",0.136412," 0,29 "," 4.026,18 "," 2.512,59 ",2941954472,CFD," 0,00 "
13/02/2025 20:25:35,Open Position,NSDQ100/USD," 99,99 ",0.090953," 0,00 "," 4.026,18 "," 2.412,60 ",2941972771,CFD," 0,00 "
13/02/2025 20:25:52,Position closed,USD/JPY," 303,01 ",9000," 3,01 "," 4.029,19 "," 2.715,61 ",2941971720,CFD," 0,00 "
13/02/2025 20:26:19,Open Position,USD/JPY," 260,00 ",7800," 0,00 "," 4.029,19 "," 2.455,61 ",2941973158,CFD," 0,00 "
13/02/2025 20:59:04,Position closed,NSDQ100/USD," 103,35 ",0.090953," 3,36 "," 4.032,55 "," 2.558,96 ",2941972771,CFD," 0,00 "
13/02/2025 21:00:48,Open Position,NSDQ100/USD," 149,97 ",0.13636," 0,00 "," 4.032,55 "," 2.408,99 ",2942009960,CFD," 0,00 "
13/02/2025 21:01:00,Open Position,NSDQ100/USD," 49,99 ",0.045447," 0,00 "," 4.032,55 "," 2.359,00 ",2942011196,CFD," 0,00 "
13/02/2025 21:37:50,Position closed,NSDQ100/USD," 150,99 ",0.13636," 1,02 "," 4.033,57 "," 2.509,99 ",2942009960,CFD," 0,00 "
13/02/2025 23:21:15,Open Position,NSDQ100/USD," 149,99 ",0.136301," 0,00 "," 4.033,57 "," 2.360,00 ",2942024305,CFD," 0,00 "
13/02/2025 23:21:30,Position closed,NSDQ100/USD," 50,11 ",0.045447," 0,12 "," 4.033,69 "," 2.410,11 ",2942011196,CFD," 0,00 "
14/02/2025 00:32:01,Index price adjustment,NSDQ100/USD,"(0,26)",-,"(0,26)"," 4.033,43 "," 2.409,85 ",2940436584,CFD," 0,00 "
14/02/2025 00:32:01,Index price adjustment,NSDQ100/USD,"(0,26)",-,"(0,26)"," 4.033,17 "," 2.409,59 ",2941769321,CFD," 0,00 "
14/02/2025 00:32:01,Index price adjustment,NSDQ100/USD,"(0,52)",-,"(0,52)"," 4.032,65 "," 2.409,07 ",2941867797,CFD," 0,00 "
14/02/2025 00:32:01,Index price adjustment,NSDQ100/USD,"(0,78)",-,"(0,78)"," 4.031,87 "," 2.408,29 ",2941886745,CFD," 0,00 "
14/02/2025 00:32:01,Index price adjustment,NSDQ100/USD,"(0,39)",-,"(0,39)"," 4.031,48 "," 2.407,90 ",2941917933,CFD," 0,00 "
14/02/2025 00:32:01,Index price adjustment,NSDQ100/USD,"(0,39)",-,"(0,39)"," 4.031,09 "," 2.407,51 ",2941954565,CFD," 0,00 "
14/02/2025 00:48:08,Overnight refund,Daily," 0,47 ",-," 0,47 "," 4.031,56 "," 2.407,98 ",2941868070,CFD," 0,00 "
14/02/2025 00:48:08,Overnight fee,Daily,"(0,03)",-,"(0,03)"," 4.031,53 "," 2.407,95 ",2940436584,CFD," 0,00 "
14/02/2025 00:48:08,Overnight fee,Daily,"(0,03)",-,"(0,03)"," 4.031,50 "," 2.407,92 ",2941769321,CFD," 0,00 "
14/02/2025 00:48:08,Overnight fee,Daily,"(0,05)",-,"(0,05)"," 4.031,45 "," 2.407,87 ",2941954565,CFD," 0,00 "
14/02/2025 00:48:08,Overnight fee,Daily,"(0,05)",-,"(0,05)"," 4.031,40 "," 2.407,82 ",2941917933,CFD," 0,00 "
14/02/2025 00:48:08,Overnight fee,Daily,"(0,06)",-,"(0,06)"," 4.031,34 "," 2.407,76 ",2941867797,CFD," 0,00 "
14/02/2025 00:48:08,Overnight fee,Daily,"(0,09)",-,"(0,09)"," 4.031,25 "," 2.407,67 ",2941886745,CFD," 0,00 "
14/02/2025 00:48:08,Overnight fee,Daily,"(0,24)",-,"(0,24)"," 4.031,01 "," 2.407,43 ",2942011196,CFD," 0,00 "
14/02/2025 00:48:08,Overnight fee,Daily,"(1,20)",-,"(1,20)"," 4.029,81 "," 2.406,23 ",2941973158,CFD," 0,00 "
14/02/2025 01:04:40,Position closed,USD/JPY," 270,07 ",7800," 10,07 "," 4.039,88 "," 2.676,30 ",2941973158,CFD," 0,00 "
14/02/2025 07:18:42,Position closed,NSDQ100/USD," 158,23 ",0.136301," 8,24 "," 4.048,12 "," 2.834,53 ",2942024305,CFD," 0,00 "
14/02/2025 07:29:37,Open Position,NSDQ100/USD," 149,99 ",0.135921," 0,00 "," 4.048,12 "," 2.684,54 ",2942069260,CFD," 0,00 "
14/02/2025 07:36:02,Position closed,USD/JPY," 86,59 ",3000.059462,"(13,41)"," 4.034,71 "," 2.771,13 ",2942070040,CFD," 0,00 "
14/02/2025 07:36:26,Open Position,USD/JPY," 119,99 ",3600," 0,00 "," 4.034,71 "," 2.651,14 ",2942070085,CFD," 0,00 "
14/02/2025 07:37:21,Open Position,NSDQ100/USD," 99,99 ",0.090643," 0,00 "," 4.034,71 "," 2.551,15 ",2942070166,CFD," 0,00 "
14/02/2025 08:02:50,Open Position,NSDQ100/USD," 149,99 ",0.135999," 0,00 "," 4.034,71 "," 2.401,16 ",2942100890,CFD," 0,00 "
14/02/2025 08:35:53,Position closed,NSDQ100/USD," 101,29 ",0.090643," 1,30 "," 4.036,01 "," 2.502,45 ",2942070166,CFD," 0,00 "
14/02/2025 08:36:06,Open Position,NSDQ100/USD," 150,00 ",0.136075," 0,00 "," 4.036,01 "," 2.352,45 ",2942137383,CFD," 0,00 "
14/02/2025 10:11:25,Position closed,USD/JPY," 122,09 ",3600," 2,10 "," 4.038,11 "," 2.474,54 ",2942070085,CFD," 0,00 "
14/02/2025 10:12:18,Open Position,USD/JPY," 149,99 ",4500," 0,00 "," 4.038,11 "," 2.324,55 ",2942176904,CFD," 0,00 "
14/02/2025 10:12:39,Position closed,NSDQ100/USD," 151,90 ",0.136075," 1,90 "," 4.040,01 "," 2.476,45 ",2942137383,CFD," 0,00 "
14/02/2025 10:13:03,Open Position,NSDQ100/USD," 149,99 ",0.136187," 0,00 "," 4.040,01 "," 2.326,46 ",2942178265,CFD," 0,00 "
14/02/2025 11:19:50,Position closed,NSDQ100/USD," 154,96 ",0.136187," 4,97 "," 4.044,98 "," 2.481,42 ",2942178265,CFD," 0,00 "
14/02/2025 12:07:12,Position closed,NSDQ100/USD," 151,32 ",0.136436," 1,33 "," 4.046,31 "," 2.632,74 ",2941954565,CFD," 0,00 "
14/02/2025 12:19:57,Open Position,NSDQ100/USD," 99,99 ",0.090912," 0,00 "," 4.046,31 "," 2.532,75 ",2942215587,CFD," 0,00 "
14/02/2025 13:23:00,Position closed,NSDQ100/USD," 100,03 ",0.090912," 0,04 "," 4.046,35 "," 2.632,78 ",2942215587,CFD," 0,00 "
14/02/2025 13:30:32,Open Position,NSDQ100/USD," 250,00 ",0.227251," 0,00 "," 4.046,35 "," 2.382,78 ",2942231438,CFD," 0,00 "
14/02/2025 13:45:59,Position closed,NSDQ100/USD," 253,77 ",0.227251," 3,77 "," 4.050,12 "," 2.636,55 ",2942231438,CFD," 0,00 "
14/02/2025 13:46:10,Open Position,NSDQ100/USD," 249,99 ",0.227032," 0,00 "," 4.050,12 "," 2.386,56 ",2942236637,CFD," 0,00 "
14/02/2025 13:48:01,Position closed,USD/JPY," 159,96 ",4500," 9,97 "," 4.060,09 "," 2.546,52 ",2942176904,CFD," 0,00 "
14/02/2025 13:52:20,Open Position,NSDQ100/USD," 99,99 ",0.090814," 0,00 "," 4.060,09 "," 2.446,53 ",2942238378,CFD," 0,00 "
14/02/2025 13:59:39,Open Position,USD/JPY," 200,00 ",6000," 0,00 "," 4.060,09 "," 2.246,53 ",2942240334,CFD," 0,00 "
14/02/2025 14:22:11,Position closed,NSDQ100/USD," 99,39 ",0.090814,"(0,60)"," 4.059,49 "," 2.345,92 ",2942238378,CFD," 0,00 "
14/02/2025 15:38:29,Position closed,NSDQ100/USD," 250,81 ",0.227032," 0,82 "," 4.060,31 "," 2.596,73 ",2942236637,CFD," 0,00 "
14/02/2025 16:12:18,Position closed,NSDQ100/USD," 152,12 ",0.135999," 2,13 "," 4.062,44 "," 2.748,85 ",2942100890,CFD," 0,00 "
14/02/2025 16:13:45,Position closed,USD/JPY," 201,54 ",6000," 1,54 "," 4.063,98 "," 2.950,39 ",2942240334,CFD," 0,00 "
14/02/2025 16:15:53,Open Position,USD/JPY," 200,00 ",6000," 0,00 "," 4.063,98 "," 2.750,39 ",2942712638,CFD," 0,00 "
14/02/2025 16:20:03,Open Position,NSDQ100/USD," 149,99 ",0.136084," 0,00 "," 4.063,98 "," 2.600,40 ",2942720636,CFD," 0,00 "
14/02/2025 16:21:27,Open Position,NSDQ100/USD," 149,99 ",0.136241," 0,00 "," 4.063,98 "," 2.450,41 ",2942722830,CFD," 0,00 "
14/02/2025 16:34:52,Withdraw Fee,-,"(5,00)",-,"(5,00)"," 4.058,98 "," 2.445,41 ",-,-," 0,00 "
14/02/2025 16:34:52,Withdrawal Conversion Fee,-," 0,00 ",-," 0,00 "," 3.958,98 "," 2.345,41 ",-,-," 0,00 "
14/02/2025 16:34:52,Withdraw Request,-,"(100,00)",-,"(100,00)"," 3.958,98 "," 2.345,41 ",-,-," 0,00 "
14/02/2025 18:03:21,Position closed,NSDQ100/USD," 154,34 ",0.136084," 4,35 "," 3.963,33 "," 2.499,75 ",2942720636,CFD," 0,00 "
14/02/2025 19:10:14,Position closed,NSDQ100/USD," 155,38 ",0.135921," 5,39 "," 3.968,72 "," 2.655,13 ",2942069260,CFD," 0,00 "
14/02/2025 19:11:16,Open Position,NSDQ100/USD," 249,99 ",0.226073," 0,00 "," 3.968,72 "," 2.405,14 ",2942905362,CFD," 0,00 "
14/02/2025 19:14:41,Open Position,NSDQ100/USD," 200,00 ",0.180823," 0,00 "," 3.968,72 "," 2.205,14 ",2942908291,CFD," 0,00 "
14/02/2025 19:33:29,Open Position,NSDQ100/USD," 149,99 ",0.135814," 0,00 "," 3.968,72 "," 2.055,15 ",2942923290,CFD," 0,00 "
14/02/2025 19:33:57,Open Position,NSDQ100/USD," 149,99 ",0.135845," 0,00 "," 3.968,72 "," 1.905,16 ",2942923786,CFD," 0,00 "
14/02/2025 20:15:32,Position closed,NSDQ100/USD," 151,26 ",0.135814," 1,27 "," 3.969,99 "," 2.056,42 ",2942923290,CFD," 0,00 "
14/02/2025 21:08:13,Position closed,NSDQ100/USD," 251,17 ",0.226073," 1,18 "," 3.971,17 "," 2.307,59 ",2942905362,CFD," 0,00 "
14/02/2025 21:08:46,Edit Stop Loss,-,"(9,30)",-," 0,00 "," 3.971,17 "," 2.298,29 ",2940436584,-," 0,00 "
15/02/2025 00:47:39,Overnight refund,Daily," 0,23 ",-," 0,23 "," 3.971,40 "," 2.298,52 ",2941868070,CFD," 0,00 "
15/02/2025 00:47:39,Overnight fee,Weekend Fee,"(0,09)",-,"(0,09)"," 3.971,31 "," 2.298,43 ",2941769321,CFD," 0,00 "
15/02/2025 00:47:39,Overnight fee,Weekend Fee,"(0,10)",-,"(0,10)"," 3.971,21 "," 2.298,33 ",2940436584,CFD," 0,00 "
15/02/2025 00:47:39,Overnight fee,Weekend Fee,"(0,14)",-,"(0,14)"," 3.971,07 "," 2.298,19 ",2942722830,CFD," 0,00 "
15/02/2025 00:47:39,Overnight fee,Weekend Fee,"(0,14)",-,"(0,14)"," 3.970,93 "," 2.298,05 ",2941917933,CFD," 0,00 "
15/02/2025 00:47:39,Overnight fee,Weekend Fee,"(0,14)",-,"(0,14)"," 3.970,79 "," 2.297,91 ",2942923786,CFD," 0,00 "
15/02/2025 00:47:39,Overnight fee,Weekend Fee,"(0,19)",-,"(0,19)"," 3.970,60 "," 2.297,72 ",2941867797,CFD," 0,00 "
15/02/2025 00:47:39,Overnight fee,Weekend Fee,"(0,28)",-,"(0,28)"," 3.970,32 "," 2.297,44 ",2941886745,CFD," 0,00 "
15/02/2025 00:47:39,Overnight fee,Daily,"(0,92)",-,"(0,92)"," 3.969,40 "," 2.296,52 ",2942712638,CFD," 0,00 "
15/02/2025 00:47:39,Overnight fee,Weekend Fee,"(2,83)",-,"(2,83)"," 3.966,57 "," 2.293,69 ",2942908291,CFD," 0,00 "
16/02/2025 23:02:59,Position closed,NSDQ100/USD," 200,78 ",0.180823," 0,78 "," 3.967,35 "," 2.494,47 ",2942908291,CFD," 0,00 "
16/02/2025 23:03:55,Open Position,NSDQ100/USD," 149,99 ",0.135575," 0,00 "," 3.967,35 "," 2.344,48 ",2943071669,CFD," 0,00 "
16/02/2025 23:05:14,Open Position,NSDQ100/USD," 74,99 ",0.067788," 0,00 "," 3.967,35 "," 2.269,49 ",2943072114,CFD," 0,00 "
17/02/2025 00:55:04,Position closed,USD/JPY," 210,08 ",6000," 10,08 "," 3.977,43 "," 2.479,57 ",2942712638,CFD," 0,00 "
17/02/2025 03:30:16,Position closed,NSDQ100/USD," 157,50 ",0.135575," 7,51 "," 3.984,94 "," 2.637,07 ",2943071669,CFD," 0,00 "
17/02/2025 03:35:04,Open Position,USD/JPY," 99,99 ",3000," 0,00 "," 3.984,94 "," 2.537,08 ",2943109198,CFD," 0,00 "
17/02/2025 03:37:21,Open Position,NSDQ100/USD," 249,99 ",0.22546," 0,00 "," 3.984,94 "," 2.287,09 ",2943109316,CFD," 0,00 "
17/02/2025 03:48:19,Open Position,NSDQ100/USD," 249,99 ",0.225462," 0,00 "," 3.984,94 "," 2.037,10 ",2943109805,CFD," 0,00 "
17/02/2025 03:48:31,Open Position,NSDQ100/USD," 99,99 ",0.090184," 0,00 "," 3.984,94 "," 1.937,11 ",2943109815,CFD," 0,00 "
17/02/2025 03:50:53,Position closed,NSDQ100/USD," 99,79 ",0.090184,"(0,20)"," 3.984,74 "," 2.036,90 ",2943109815,CFD," 0,00 "
17/02/2025 06:40:37,Position closed,NSDQ100/USD," 251,07 ",0.225462," 1,08 "," 3.985,82 "," 2.287,97 ",2943109805,CFD," 0,00 "
17/02/2025 06:40:50,Open Position,NSDQ100/USD," 270,00 ",0.24341," 0,00 "," 3.985,82 "," 2.017,97 ",2943122797,CFD," 0,00 "
17/02/2025 07:08:46,Position closed,NSDQ100/USD," 251,49 ",0.22546," 1,50 "," 3.987,32 "," 2.269,46 ",2943109316,CFD," 0,00 "
17/02/2025 07:09:16,Open Position,NSDQ100/USD," 299,99 ",0.270438," 0,00 "," 3.987,32 "," 1.969,47 ",2943125521,CFD," 0,00 "
17/02/2025 07:09:29,Open Position,NSDQ100/USD," 249,99 ",0.225369," 0,00 "," 3.987,32 "," 1.719,48 ",2943125543,CFD," 0,00 "
17/02/2025 10:49:44,Open Position,NSDQ100/USD," 99,99 ",0.090207," 0,00 "," 3.987,32 "," 1.619,49 ",2943245056,CFD," 0,00 "
17/02/2025 15:02:52,Position closed,NSDQ100/USD," 103,72 ",0.090207," 3,73 "," 3.991,05 "," 1.723,21 ",2943245056,CFD," 0,00 "
17/02/2025 15:03:05,Position closed,USD/JPY," 103,91 ",3000," 3,92 "," 3.994,97 "," 1.827,12 ",2943109198,CFD," 0,00 "
17/02/2025 15:03:18,Open Position,USD/JPY," 200,00 ",6000," 0,00 "," 3.994,97 "," 1.627,12 ",2943305918,CFD," 0,00 "
17/02/2025 17:25:15,Position closed,USD/JPY," 201,82 ",6000," 1,82 "," 3.996,79 "," 1.828,94 ",2943305918,CFD," 0,00 "
17/02/2025 17:36:57,Open Position,USD/JPY," 150,00 ",4500," 0,00 "," 3.996,79 "," 1.678,94 ",2943425334,CFD," 0,00 "
17/02/2025 18:51:07,Open Position,USD/JPY," 350,00 ",10500," 0,00 "," 3.996,79 "," 1.328,94 ",2943432343,CFD," 0,00 "
17/02/2025 18:51:13,Position closed,USD/JPY," 148,04 ",4500,"(1,96)"," 3.994,83 "," 1.476,98 ",2943425334,CFD," 0,00 "
17/02/2025 23:03:51,Open Position,NSDQ100/USD," 99,99 ",0.090327," 0,00 "," 3.994,83 "," 1.376,99 ",2943446603,CFD," 0,00 "
17/02/2025 23:40:20,Position closed,USD/JPY," 355,00 ",10500," 5,00 "," 3.999,83 "," 1.731,99 ",2943432343,CFD," 0,00 "
17/02/2025 23:51:23,Open Position,USD/JPY," 200,00 ",6000," 0,00 "," 3.999,83 "," 1.531,99 ",2943450179,CFD," 0,00 "
18/02/2025 00:47:54,Overnight refund,Daily," 0,23 ",-," 0,23 "," 4.000,06 "," 1.532,22 ",2941868070,CFD," 0,00 "
18/02/2025 00:47:54,Overnight fee,Daily,"(0,02)",-,"(0,02)"," 4.000,04 "," 1.532,20 ",2943072114,CFD," 0,00 "
18/02/2025 00:47:54,Overnight fee,Daily,"(0,03)",-,"(0,03)"," 4.000,01 "," 1.532,17 ",2940436584,CFD," 0,00 "
18/02/2025 00:47:54,Overnight fee,Daily,"(0,03)",-,"(0,03)"," 3.999,98 "," 1.532,14 ",2941769321,CFD," 0,00 "
18/02/2025 00:47:54,Overnight fee,Daily,"(0,05)",-,"(0,05)"," 3.999,93 "," 1.532,09 ",2942722830,CFD," 0,00 "
18/02/2025 00:47:54,Overnight fee,Daily,"(0,05)",-,"(0,05)"," 3.999,88 "," 1.532,04 ",2941917933,CFD," 0,00 "
18/02/2025 00:47:54,Overnight fee,Daily,"(0,05)",-,"(0,05)"," 3.999,83 "," 1.531,99 ",2942923786,CFD," 0,00 "
18/02/2025 00:47:54,Overnight fee,Daily,"(0,07)",-,"(0,07)"," 3.999,76 "," 1.531,92 ",2941867797,CFD," 0,00 "
18/02/2025 00:47:54,Overnight fee,Daily,"(0,10)",-,"(0,10)"," 3.999,66 "," 1.531,82 ",2941886745,CFD," 0,00 "
18/02/2025 00:47:54,Overnight fee,Daily,"(1,21)",-,"(1,21)"," 3.998,45 "," 1.530,61 ",2943125543,CFD," 0,00 "
18/02/2025 00:47:54,Overnight fee,Daily,"(1,30)",-,"(1,30)"," 3.997,15 "," 1.529,31 ",2943122797,CFD," 0,00 "
18/02/2025 00:47:54,Overnight fee,Daily,"(1,45)",-,"(1,45)"," 3.995,70 "," 1.527,86 ",2943125521,CFD," 0,00 "
18/02/2025 00:47:54,Overnight fee,Daily,"(1,61)",-,"(1,61)"," 3.994,09 "," 1.526,25 ",2943432343,CFD," 0,00 "
18/02/2025 00:53:41,Index price adjustment,NSDQ100/USD,"(0,02)",-,"(0,02)"," 3.994,07 "," 1.526,23 ",2940436584,CFD," 0,00 "
18/02/2025 00:53:41,Index price adjustment,NSDQ100/USD,"(0,02)",-,"(0,02)"," 3.994,05 "," 1.526,21 ",2941769321,CFD," 0,00 "
18/02/2025 00:53:41,Index price adjustment,NSDQ100/USD,"(0,04)",-,"(0,04)"," 3.994,01 "," 1.526,17 ",2941867797,CFD," 0,00 "
18/02/2025 00:53:41,Index price adjustment,NSDQ100/USD,"(0,06)",-,"(0,06)"," 3.993,95 "," 1.526,11 ",2941886745,CFD," 0,00 "
18/02/2025 00:53:41,Index price adjustment,NSDQ100/USD,"(0,03)",-,"(0,03)"," 3.993,92 "," 1.526,08 ",2941917933,CFD," 0,00 "
18/02/2025 00:53:41,Index price adjustment,NSDQ100/USD,"(0,03)",-,"(0,03)"," 3.993,89 "," 1.526,05 ",2942722830,CFD," 0,00 "
18/02/2025 00:53:41,Index price adjustment,NSDQ100/USD,"(0,03)",-,"(0,03)"," 3.993,86 "," 1.526,02 ",2942923786,CFD," 0,00 "
18/02/2025 00:53:41,Index price adjustment,NSDQ100/USD,"(0,01)",-,"(0,01)"," 3.993,85 "," 1.526,01 ",2943072114,CFD," 0,00 "
18/02/2025 00:53:41,Index price adjustment,NSDQ100/USD," 0,05 ",-," 0,05 "," 3.993,90 "," 1.526,06 ",2943122797,CFD," 0,00 "
18/02/2025 00:53:41,Index price adjustment,NSDQ100/USD," 0,06 ",-," 0,06 "," 3.993,96 "," 1.526,12 ",2943125521,CFD," 0,00 "
18/02/2025 00:53:41,Index price adjustment,NSDQ100/USD," 0,05 ",-," 0,05 "," 3.994,01 "," 1.526,17 ",2943125543,CFD," 0,00 "
18/02/2025 02:55:09,Position closed,NSDQ100/USD," 102,64 ",0.090327," 2,65 "," 3.996,66 "," 1.628,81 ",2943446603,CFD," 0,00 "
18/02/2025 06:39:59,Position closed,NSDQ100/USD," 274,70 ",0.24341," 4,70 "," 4.001,36 "," 1.903,51 ",2943122797,CFD," 0,00 "
18/02/2025 06:48:28,Position closed,NSDQ100/USD," 256,20 ",0.225369," 6,21 "," 4.007,57 "," 2.159,71 ",2943125543,CFD," 0,00 "
18/02/2025 06:48:35,Position closed,NSDQ100/USD," 307,42 ",0.270438," 7,43 "," 4.015,00 "," 2.467,13 ",2943125521,CFD," 0,00 "
18/02/2025 07:00:07,Open Position,NSDQ100/USD," 199,98 ",0.179929," 0,00 "," 4.015,00 "," 2.267,15 ",2943492705,CFD," 0,00 "
18/02/2025 07:02:51,Open Position,NSDQ100/USD," 199,99 ",0.179968," 0,00 "," 4.015,00 "," 2.067,16 ",2943493247,CFD," 0,00 "
18/02/2025 07:22:30,Position closed,NSDQ100/USD," 201,20 ",0.179968," 1,21 "," 4.016,21 "," 2.268,36 ",2943493247,CFD," 0,00 "
18/02/2025 07:36:27,Open Position,USD/JPY," 99,99 ",3000," 0,00 "," 4.016,21 "," 2.168,37 ",2943498410,CFD," 0,00 "
18/02/2025 07:36:58,Open Position,NSDQ100/USD," 199,99 ",0.17995," 0,00 "," 4.016,21 "," 1.968,38 ",2943498460,CFD," 0,00 "
18/02/2025 07:41:28,Open Position,NSDQ100/USD," 99,99 ",0.089968," 0,00 "," 4.016,21 "," 1.868,39 ",2943499098,CFD," 0,00 "
18/02/2025 07:48:07,Open Position,USD/JPY," 100,00 ",3000," 0,00 "," 4.016,21 "," 1.768,39 ",2943500189,CFD," 0,00 "
18/02/2025 08:05:21,Position closed,USD/JPY," 102,47 ",3000," 2,47 "," 4.018,68 "," 1.870,86 ",2943500189,CFD," 0,00 "
18/02/2025 08:09:53,Open Position,USD/JPY," 120,00 ",3600," 0,00 "," 4.018,68 "," 1.750,86 ",2943525464,CFD," 0,00 "
18/02/2025 08:15:52,Open Position,NSDQ100/USD," 150,00 ",0.135083," 0,00 "," 4.018,68 "," 1.600,86 ",2943527419,CFD," 0,00 "
18/02/2025 09:17:22,Position closed,NSDQ100/USD," 150,93 ",0.135083," 0,93 "," 4.019,61 "," 1.751,79 ",2943527419,CFD," 0,00 "
18/02/2025 10:45:16,Position closed,USD/JPY," 101,89 ",3000," 1,90 "," 4.021,51 "," 1.853,68 ",2943498410,CFD," 0,00 "
18/02/2025 13:44:42,Open Position,USD/JPY," 99,99 ",3000," 0,00 "," 4.021,51 "," 1.753,69 ",2943736299,CFD," 0,00 "
18/02/2025 13:45:41,Open Position,NSDQ100/USD," 149,99 ",0.135002," 0,00 "," 4.021,51 "," 1.603,70 ",2943736591,CFD," 0,00 "
18/02/2025 14:44:48,Position closed,NSDQ100/USD," 159,64 ",0.135002," 9,65 "," 4.031,16 "," 1.763,34 ",2943736591,CFD," 0,00 "
18/02/2025 14:46:56,Position closed,NSDQ100/USD," 75,68 ",0.067788," 0,69 "," 4.031,85 "," 1.839,02 ",2943072114,CFD," 0,00 "
18/02/2025 14:49:34,Open Position,NSDQ100/USD," 119,99 ",0.108563," 0,00 "," 4.031,85 "," 1.719,03 ",2944218140,CFD," 0,00 "
18/02/2025 15:00:27,Position closed,NSDQ100/USD," 121,31 ",0.108563," 1,32 "," 4.033,17 "," 1.840,34 ",2944218140,CFD," 0,00 "
18/02/2025 15:00:42,Open Position,NSDQ100/USD," 259,98 ",0.235089," 0,00 "," 4.033,17 "," 1.580,36 ",2944641274,CFD," 0,00 "
18/02/2025 15:29:47,Position closed,NSDQ100/USD," 152,76 ",0.135845," 2,77 "," 4.035,94 "," 1.733,12 ",2942923786,CFD," 0,00 "
18/02/2025 15:33:16,Open Position,NSDQ100/USD," 200,00 ",0.181251," 0,00 "," 4.035,94 "," 1.533,12 ",2944727424,CFD," 0,00 "
18/02/2025 15:37:08,Open Position,NSDQ100/USD," 99,98 ",0.090574," 0,00 "," 4.035,94 "," 1.433,14 ",2944736549,CFD," 0,00 "
18/02/2025 15:46:48,Position closed,USD/JPY," 102,15 ",3000," 2,16 "," 4.038,10 "," 1.535,29 ",2943736299,CFD," 0,00 "
18/02/2025 15:47:05,Open Position,USD/JPY," 149,99 ",4500," 0,00 "," 4.038,10 "," 1.385,30 ",2944762450,CFD," 0,00 "
18/02/2025 15:55:49,Position closed,NSDQ100/USD," 205,49 ",0.181251," 5,49 "," 4.043,59 "," 1.590,79 ",2944727424,CFD," 0,00 "
18/02/2025 15:55:54,Position closed,NSDQ100/USD," 102,12 ",0.090574," 2,14 "," 4.045,73 "," 1.692,91 ",2944736549,CFD," 0,00 "
18/02/2025 15:56:03,Open Position,NSDQ100/USD," 270,00 ",0.24429," 0,00 "," 4.045,73 "," 1.422,91 ",2944782034,CFD," 0,00 "
18/02/2025 17:12:52,Position closed,NSDQ100/USD," 269,63 ",0.24429,"(0,37)"," 4.045,36 "," 1.692,54 ",2944782034,CFD," 0,00 "
18/02/2025 17:15:33,Position closed,NSDQ100/USD," 255,88 ",0.235089,"(4,10)"," 4.041,26 "," 1.948,42 ",2944641274,CFD," 0,00 "
18/02/2025 17:15:48,Open Position,NSDQ100/USD," 149,99 ",0.135749," 0,00 "," 4.041,26 "," 1.798,43 ",2945365014,CFD," 0,00 "
18/02/2025 17:18:42,Position closed,NSDQ100/USD," 150,88 ",0.135749," 0,89 "," 4.042,15 "," 1.949,31 ",2945365014,CFD," 0,00 "
18/02/2025 17:19:22,Open Position,NSDQ100/USD," 250,00 ",0.226355," 0,00 "," 4.042,15 "," 1.699,31 ",2945369857,CFD," 0,00 "
18/02/2025 19:10:11,Position closed,NSDQ100/USD," 260,22 ",0.226355," 10,22 "," 4.052,37 "," 1.959,53 ",2945369857,CFD," 0,00 "
18/02/2025 19:14:03,Open Position,NSDQ100/USD," 99,99 ",0.090693," 0,00 "," 4.052,37 "," 1.859,54 ",2945519063,CFD," 0,00 "
18/02/2025 19:15:03,Open Position,NSDQ100/USD," 119,99 ",0.10886," 0,00 "," 4.052,37 "," 1.739,55 ",2945519865,CFD," 0,00 "
18/02/2025 20:13:04,Position closed,NSDQ100/USD," 125,03 ",0.10886," 5,04 "," 4.057,41 "," 1.864,58 ",2945519865,CFD," 0,00 "
18/02/2025 20:18:07,Open Position,NSDQ100/USD," 150,00 ",0.135796," 0,00 "," 4.057,41 "," 1.714,58 ",2945579892,CFD," 0,00 "
18/02/2025 20:18:16,Open Position,NSDQ100/USD," 149,99 ",0.135813," 0,00 "," 4.057,41 "," 1.564,59 ",2945580050,CFD," 0,00 "
18/02/2025 21:23:29,Position closed,NSDQ100/USD," 157,72 ",0.135796," 7,72 "," 4.065,13 "," 1.722,31 ",2945579892,CFD," 0,00 "
18/02/2025 21:24:06,Open Position,NSDQ100/USD," 149,99 ",0.135446," 0,00 "," 4.065,13 "," 1.572,32 ",2945621337,CFD," 0,00 "
18/02/2025 21:24:28,Open Position,NSDQ100/USD," 74,99 ",0.067712," 0,00 "," 4.065,13 "," 1.497,33 ",2945621379,CFD," 0,00 "
18/02/2025 21:24:51,Position closed,USD/JPY," 121,16 ",3600," 1,16 "," 4.066,29 "," 1.618,49 ",2943525464,CFD," 0,00 "
18/02/2025 21:25:28,Open Position,USD/JPY," 75,00 ",2250," 0,00 "," 4.066,29 "," 1.543,49 ",2945621761,CFD," 0,00 "
18/02/2025 21:40:15,Position closed,NSDQ100/USD," 74,23 ",0.067712,"(0,76)"," 4.065,53 "," 1.617,72 ",2945621379,CFD," 0,00 "
18/02/2025 21:40:20,Position closed,NSDQ100/USD," 150,62 ",0.135446," 0,63 "," 4.066,16 "," 1.768,34 ",2945621337,CFD," 0,00 "
18/02/2025 21:40:37,Open Position,NSDQ100/USD," 149,99 ",0.135504," 0,00 "," 4.066,16 "," 1.618,35 ",2945623038,CFD," 0,00 "
18/02/2025 23:08:02,Open Position,NSDQ100/USD," 100,00 ",0.090233," 0,00 "," 4.066,16 "," 1.518,35 ",2945628486,CFD," 0,00 "
18/02/2025 23:31:08,Open Position,NSDQ100/USD," 99,99 ",0.090236," 0,00 "," 4.066,16 "," 1.418,36 ",2945630254,CFD," 0,00 "
19/02/2025 00:47:39,Overnight fee,Daily,"(0,03)",-,"(0,03)"," 4.066,13 "," 1.418,33 ",2940436584,CFD," 0,00 "
19/02/2025 00:47:39,Overnight fee,Daily,"(0,05)",-,"(0,05)"," 4.066,08 "," 1.418,28 ",2945580050,CFD," 0,00 "
19/02/2025 00:47:39,Overnight fee,Daily,"(0,05)",-,"(0,05)"," 4.066,03 "," 1.418,23 ",2942722830,CFD," 0,00 "
19/02/2025 00:47:39,Overnight fee,Daily,"(0,05)",-,"(0,05)"," 4.065,98 "," 1.418,18 ",2941917933,CFD," 0,00 "
19/02/2025 00:47:39,Overnight fee,Daily,"(0,05)",-,"(0,05)"," 4.065,93 "," 1.418,13 ",2945623038,CFD," 0,00 "
19/02/2025 00:47:39,Overnight fee,Daily,"(0,07)",-,"(0,07)"," 4.065,86 "," 1.418,06 ",2941867797,CFD," 0,00 "
19/02/2025 00:47:39,Overnight fee,Daily,"(0,10)",-,"(0,10)"," 4.065,76 "," 1.417,96 ",2941886745,CFD," 0,00 "
19/02/2025 00:47:39,Overnight fee,Daily,"(0,48)",-,"(0,48)"," 4.065,28 "," 1.417,48 ",2943499098,CFD," 0,00 "
19/02/2025 00:47:39,Overnight fee,Daily,"(0,69)",-,"(0,69)"," 4.064,59 "," 1.416,79 ",2944762450,CFD," 0,00 "
19/02/2025 00:47:39,Overnight fee,Daily,"(0,92)",-,"(0,92)"," 4.063,67 "," 1.415,87 ",2943450179,CFD," 0,00 "
19/02/2025 00:47:39,Overnight fee,Daily,"(0,96)",-,"(0,96)"," 4.062,71 "," 1.414,91 ",2943498460,CFD," 0,00 "
19/02/2025 00:47:39,Overnight fee,Daily,"(0,96)",-,"(0,96)"," 4.061,75 "," 1.413,95 ",2943492705,CFD," 0,00 "
19/02/2025 00:47:39,Overnight refund,Daily," 0,23 ",-," 0,23 "," 4.061,98 "," 1.414,18 ",2941868070,CFD," 0,00 "
19/02/2025 00:47:39,Overnight refund,Daily," 0,17 ",-," 0,17 "," 4.062,15 "," 1.414,35 ",2945621761,CFD," 0,00 "
19/02/2025 00:47:39,Overnight fee,Daily,"(0,03)",-,"(0,03)"," 4.062,12 "," 1.414,32 ",2945519063,CFD," 0,00 "
19/02/2025 00:47:39,Overnight fee,Daily,"(0,03)",-,"(0,03)"," 4.062,09 "," 1.414,29 ",2941769321,CFD," 0,00 "
19/02/2025 06:09:42,Position closed,NSDQ100/USD," 102,09 ",0.090236," 2,10 "," 4.064,19 "," 1.516,38 ",2945630254,CFD," 0,00 "
19/02/2025 07:48:46,Open Position,NSDQ100/USD," 150,00 ",0.135232," 0,00 "," 4.064,19 "," 1.366,38 ",2945670258,CFD," 0,00 "
19/02/2025 10:47:17,Position closed,NSDQ100/USD," 102,57 ",0.090233," 2,57 "," 4.066,76 "," 1.468,95 ",2945628486,CFD," 0,00 "
19/02/2025 10:49:27,Open Position,NSDQ100/USD," 99,99 ",0.09033," 0,00 "," 4.066,76 "," 1.368,96 ",2945782405,CFD," 0,00 "
19/02/2025 10:51:33,Open Position,NSDQ100/USD," 149,99 ",0.135525," 0,00 "," 4.066,76 "," 1.218,97 ",2945782897,CFD," 0,00 "
19/02/2025 10:52:18,Open Position,USD/JPY," 100,00 ",3000," 0,00 "," 4.066,76 "," 1.118,97 ",2945783028,CFD," 0,00 "
19/02/2025 12:01:28,Position closed,USD/JPY," 102,13 ",3000," 2,13 "," 4.068,89 "," 1.221,10 ",2945783028,CFD," 0,00 "
19/02/2025 12:01:37,Open Position,USD/JPY," 100,00 ",3000," 0,00 "," 4.068,89 "," 1.121,10 ",2945808894,CFD," 0,00 "
19/02/2025 12:01:51,Position closed,NSDQ100/USD," 101,54 ",0.09033," 1,55 "," 4.070,44 "," 1.222,64 ",2945782405,CFD," 0,00 "
19/02/2025 12:02:11,Open Position,NSDQ100/USD," 149,99 ",0.135352," 0,00 "," 4.070,44 "," 1.072,65 ",2945809076,CFD," 0,00 "
19/02/2025 12:31:34,Position closed,NSDQ100/USD," 150,55 ",0.135352," 0,56 "," 4.071,00 "," 1.223,20 ",2945809076,CFD," 0,00 "
19/02/2025 13:43:01,Position closed,NSDQ100/USD," 152,34 ",0.135525," 2,35 "," 4.073,35 "," 1.375,54 ",2945782897,CFD," 0,00 "
19/02/2025 13:43:05,Position closed,NSDQ100/USD," 152,83 ",0.135504," 2,84 "," 4.076,19 "," 1.528,37 ",2945623038,CFD," 0,00 "
19/02/2025 13:43:15,Open Position,NSDQ100/USD," 249,99 ",0.22607," 0,00 "," 4.076,19 "," 1.278,38 ",2945841398,CFD," 0,00 "
19/02/2025 13:43:30,Open Position,NSDQ100/USD," 100,00 ",0.090423," 0,00 "," 4.076,19 "," 1.178,38 ",2945841492,CFD," 0,00 "
19/02/2025 13:46:58,Position closed,NSDQ100/USD," 99,30 ",0.090423,"(0,70)"," 4.075,49 "," 1.277,68 ",2945841492,CFD," 0,00 "
19/02/2025 14:05:38,Open Position,NSDQ100/USD," 150,00 ",0.135506," 0,00 "," 4.075,49 "," 1.127,68 ",2945848428,CFD," 0,00 "
19/02/2025 15:01:37,Position closed,NSDQ100/USD," 253,42 ",0.22607," 3,43 "," 4.078,92 "," 1.381,10 ",2945841398,CFD," 0,00 "
19/02/2025 15:03:04,Position closed,USD/JPY," 205,00 ",6000," 5,00 "," 4.083,92 "," 1.586,10 ",2943450179,CFD," 0,00 "
19/02/2025 15:03:16,Position closed,USD/JPY," 158,14 ",4500," 8,15 "," 4.092,07 "," 1.744,24 ",2944762450,CFD," 0,00 "
19/02/2025 15:04:40,Position closed,NSDQ100/USD," 152,96 ",0.135813," 2,97 "," 4.095,04 "," 1.897,20 ",2945580050,CFD," 0,00 "
19/02/2025 15:04:52,Open Position,NSDQ100/USD," 199,99 ",0.181318," 0,00 "," 4.095,04 "," 1.697,21 ",2946134162,CFD," 0,00 "
19/02/2025 15:08:02,Open Position,USD/JPY," 100,00 ",3000," 0,00 "," 4.095,04 "," 1.597,21 ",2946149111,CFD," 0,00 "
19/02/2025 15:09:21,Position closed,NSDQ100/USD," 100,29 ",0.090693," 0,30 "," 4.095,34 "," 1.697,50 ",2945519063,CFD," 0,00 "
19/02/2025 15:11:55,Position closed,NSDQ100/USD," 201,37 ",0.181318," 1,38 "," 4.096,72 "," 1.898,87 ",2946134162,CFD," 0,00 "
19/02/2025 15:12:54,Open Position,NSDQ100/USD," 174,99 ",0.158645," 0,00 "," 4.096,72 "," 1.723,88 ",2946197323,CFD," 0,00 "
19/02/2025 15:26:03,Position closed,NSDQ100/USD," 175,72 ",0.158645," 0,73 "," 4.097,45 "," 1.899,60 ",2946197323,CFD," 0,00 "
19/02/2025 15:26:11,Open Position,NSDQ100/USD," 150,00 ",0.135908," 0,00 "," 4.097,45 "," 1.749,60 ",2946335397,CFD," 0,00 "
19/02/2025 15:55:10,Position closed,USD/JPY," 101,70 ",3000," 1,70 "," 4.099,15 "," 1.851,30 ",2946149111,CFD," 0,00 "
19/02/2025 15:55:18,Open Position,USD/JPY," 100,00 ",3000," 0,00 "," 4.099,15 "," 1.751,30 ",2946388316,CFD," 0,00 "
19/02/2025 15:55:24,Position closed,NSDQ100/USD," 153,14 ",0.135908," 3,14 "," 4.102,29 "," 1.904,44 ",2946335397,CFD," 0,00 "
19/02/2025 15:56:11,Open Position,NSDQ100/USD," 149,98 ",0.1358," 0,00 "," 4.102,29 "," 1.754,46 ",2946389459,CFD," 0,00 "
19/02/2025 16:05:15,Position closed,USD/JPY," 101,88 ",3000," 1,88 "," 4.104,17 "," 1.856,34 ",2946388316,CFD," 0,00 "
19/02/2025 17:08:04,Position closed,NSDQ100/USD," 154,00 ",0.135506," 4,00 "," 4.108,17 "," 2.010,34 ",2945848428,CFD," 0,00 "
19/02/2025 17:08:29,Open Position,NSDQ100/USD," 100,00 ",0.090207," 0,00 "," 4.108,17 "," 1.910,34 ",2946474651,CFD," 0,00 "
19/02/2025 18:07:48,Position closed,NSDQ100/USD," 102,16 ",0.090207," 2,16 "," 4.110,33 "," 2.012,50 ",2946474651,CFD," 0,00 "
19/02/2025 18:08:04,Open Position,NSDQ100/USD," 149,99 ",0.135489," 0,00 "," 4.110,33 "," 1.862,51 ",2946527791,CFD," 0,00 "
19/02/2025 18:59:24,Position closed,USD/JPY," 33,34 ",1490.3898,"(16,34)"," 4.093,99 "," 1.895,85 ",2946575948,CFD," 0,00 "
19/02/2025 19:00:05,Open Position,USD/JPY," 99,99 ",3000," 0,00 "," 4.093,99 "," 1.795,86 ",2946576226,CFD," 0,00 "
19/02/2025 19:01:13,Open Position,NSDQ100/USD," 199,99 ",0.180519," 0,00 "," 4.093,99 "," 1.595,87 ",2946576830,CFD," 0,00 "
19/02/2025 19:32:52,Position closed,NSDQ100/USD," 151,06 ",0.135232," 1,06 "," 4.095,05 "," 1.746,93 ",2945670258,CFD," 0,00 "
19/02/2025 19:46:25,Open Position,NSDQ100/USD," 100,00 ",0.09007," 0,00 "," 4.095,05 "," 1.646,93 ",2946607777,CFD," 0,00 "
19/02/2025 21:32:01,Position closed,NSDQ100/USD," 105,28 ",0.09007," 5,28 "," 4.100,33 "," 1.752,21 ",2946607777,CFD," 0,00 "
19/02/2025 21:32:08,Position closed,NSDQ100/USD," 202,11 ",0.180519," 2,12 "," 4.102,45 "," 1.954,32 ",2946576830,CFD," 0,00 "
19/02/2025 21:32:18,Position closed,USD/JPY," 102,41 ",3000," 2,42 "," 4.104,87 "," 2.056,73 ",2946576226,CFD," 0,00 "
19/02/2025 21:32:56,Open Position,NSDQ100/USD," 99,98 ",0.090298," 0,00 "," 4.104,87 "," 1.956,75 ",2946687040,CFD," 0,00 "