Date,Type,Details,Amount,Units / Contracts,Realized Equity Change,Realized Equity,Balance,Position ID,Asset type,NWA
02/02/2025 23:00:51,Position closed,NSDQ100/USD," 107,64 ",0.277176,"(221,18)"," 6.640,81 "," 4.315,75 ",2930506180,CFD," 0,00 "
02/02/2025 23:00:51,Position closed,NSDQ100/USD," 84,88 ",0.223094,"(155,44)"," 6.485,37 "," 4.400,63 ",2930585106,CFD," 0,00 "
02/02/2025 23:00:51,Position closed,NSDQ100/USD," 129,23 ",0.279601,"(170,76)"," 6.314,61 "," 4.529,86 ",2930748903,CFD," 0,00 "
02/02/2025 23:00:51,Position closed,NSDQ100/USD," 102,54 ",0.232747,"(147,44)"," 6.167,17 "," 4.632,40 ",2930740280,CFD," 0,00 "
02/02/2025 23:00:51,Position closed,NSDQ100/USD," 93,23 ",0.232345,"(156,76)"," 6.010,41 "," 4.725,63 ",2930719367,CFD," 0,00 "
02/02/2025 23:05:33,Open Position,NSDQ100/USD," 250,00 ",0.238762," 0,00 "," 6.010,41 "," 4.475,63 ",2931048960,CFD," 0,00 "
02/02/2025 23:05:53,Position closed,NSDQ100/USD," 253,11 ",0.238762," 3,11 "," 6.013,52 "," 4.728,74 ",2931048960,CFD," 0,00 "
02/02/2025 23:06:33,Open Position,NSDQ100/USD," 300,00 ",0.286668," 0,00 "," 6.013,52 "," 4.428,74 ",2931050887,CFD," 0,00 "
02/02/2025 23:07:10,Position closed,NSDQ100/USD," 296,43 ",0.286668,"(3,57)"," 6.009,95 "," 4.725,17 ",2931050887,CFD," 0,00 "
02/02/2025 23:08:23,Open Position,NSDQ100/USD," 250,00 ",0.238514," 0,00 "," 6.009,95 "," 4.475,17 ",2931052443,CFD," 0,00 "
02/02/2025 23:08:59,Position closed,NSDQ100/USD," 251,89 ",0.238514," 1,89 "," 6.011,84 "," 4.727,06 ",2931052443,CFD," 0,00 "
02/02/2025 23:09:14,Open Position,NSDQ100/USD," 343,40 ",0.262073," 0,00 "," 6.011,84 "," 4.452,06 ",2931053491,CFD," 0,00 "
02/02/2025 23:18:56,Edit Stop Loss,-,"(68,40)",-," 0,00 "," 6.011,84 "," 4.383,66 ",2931053491,-," 0,00 "
02/02/2025 23:54:24,Position closed,NSDQ100/USD," 346,92 ",0.262073," 3,52 "," 6.015,36 "," 4.730,58 ",2931053491,CFD," 0,00 "
03/02/2025 00:01:00,Open Position,NSDQ100/USD," 232,55 ",0.190495," 0,00 "," 6.015,36 "," 4.530,60 ",2931075228,CFD," 0,00 "
03/02/2025 00:01:13,Edit Stop Loss,-,"(32,57)",-," 0,00 "," 6.015,36 "," 4.498,03 ",2931075228,-," 0,00 "
03/02/2025 00:04:16,Position closed,NSDQ100/USD," 233,95 ",0.190495," 1,40 "," 6.016,76 "," 4.731,98 ",2931075228,CFD," 0,00 "
03/02/2025 00:04:57,Open Position,NSDQ100/USD," 293,08 ",0.238033," 0,00 "," 6.016,76 "," 4.481,98 ",2931076114,CFD," 0,00 "
03/02/2025 00:05:19,Edit Stop Loss,-,"(43,08)",-," 0,00 "," 6.016,76 "," 4.438,90 ",2931076114,-," 0,00 "
03/02/2025 07:49:10,Position closed,NSDQ100/USD," 294,71 ",0.238033," 1,63 "," 6.018,39 "," 4.733,61 ",2931076114,CFD," 0,00 "
03/02/2025 07:50:50,Open Position,NSDQ100/USD," 300,00 ",0.285399," 0,00 "," 6.018,39 "," 4.433,61 ",2931296868,CFD," 0,00 "
03/02/2025 08:04:16,Position closed,NSDQ100/USD," 300,67 ",0.285399," 0,67 "," 6.019,06 "," 4.734,28 ",2931296868,CFD," 0,00 "
03/02/2025 08:04:40,Open Position,NSDQ100/USD," 249,98 ",0.237601," 0,00 "," 6.019,06 "," 4.484,30 ",2931353856,CFD," 0,00 "
03/02/2025 08:13:55,Position closed,NSDQ100/USD," 253,51 ",0.237601," 3,53 "," 6.022,59 "," 4.737,81 ",2931353856,CFD," 0,00 "
03/02/2025 08:14:15,Open Position,NSDQ100/USD," 349,98 ",0.332361," 0,00 "," 6.022,59 "," 4.387,83 ",2931395963,CFD," 0,00 "
03/02/2025 08:21:53,Position closed,NSDQ100/USD," 368,12 ",0.332361," 18,14 "," 6.040,73 "," 4.755,95 ",2931395963,CFD," 0,00 "
03/02/2025 08:22:14,Open Position,NSDQ100/USD," 300,00 ",0.284041," 0,00 "," 6.040,73 "," 4.455,95 ",2931443107,CFD," 0,00 "
03/02/2025 08:33:24,Open Position,USD/JPY," 199,99 ",6000," 0,00 "," 6.040,73 "," 4.255,96 ",2931462845,CFD," 0,00 "
03/02/2025 08:37:18,Position closed,USD/JPY," 200,45 ",6000," 0,46 "," 6.041,19 "," 4.456,41 ",2931462845,CFD," 0,00 "
03/02/2025 08:37:44,Open Position,USD/JPY," 100,04 ",6000," 0,00 "," 6.041,19 "," 4.256,42 ",2931465816,CFD," 0,00 "
03/02/2025 08:40:17,Open Position,NSDQ100/USD," 250,00 ",0.237054," 0,00 "," 6.041,19 "," 4.006,42 ",2931470561,CFD," 0,00 "
03/02/2025 08:56:49,Position closed,NSDQ100/USD," 250,26 ",0.237054," 0,26 "," 6.041,45 "," 4.256,68 ",2931470561,CFD," 0,00 "
03/02/2025 08:57:33,Open Position,NSDQ100/USD," 250,00 ",0.237073," 0,00 "," 6.041,45 "," 4.006,68 ",2931480771,CFD," 0,00 "
03/02/2025 09:21:09,Open Position,USD/JPY," 100,00 ",3000," 0,00 "," 6.041,45 "," 3.906,68 ",2931494141,CFD," 0,00 "
03/02/2025 09:30:20,Position closed,USD/JPY," 101,14 ",3000," 1,14 "," 6.042,59 "," 4.007,82 ",2931494141,CFD," 0,00 "
03/02/2025 09:35:35,Position closed,NSDQ100/USD," 251,98 ",0.237073," 1,98 "," 6.044,57 "," 4.259,80 ",2931480771,CFD," 0,00 "
03/02/2025 09:36:35,Open Position,USD/JPY," 100,03 ",6000," 0,00 "," 6.044,57 "," 4.059,81 ",2931504151,CFD," 0,00 "
03/02/2025 09:37:49,Open Position,NSDQ100/USD," 250,00 ",0.236864," 0,00 "," 6.044,57 "," 3.809,81 ",2931508010,CFD," 0,00 "
03/02/2025 09:53:29,Open Position,NSDQ100/USD," 149,99 ",0.142372," 0,00 "," 6.044,57 "," 3.659,82 ",2931515740,CFD," 0,00 "
03/02/2025 09:54:26,Position closed,USD/JPY," 96,94 ",2998.884505,"(3,02)"," 6.041,55 "," 3.756,76 ",2931516127,CFD," 0,00 "
03/02/2025 10:18:33,Position closed,NSDQ100/USD," 152,00 ",0.142372," 2,01 "," 6.043,56 "," 3.908,76 ",2931515740,CFD," 0,00 "
03/02/2025 10:18:48,Open Position,NSDQ100/USD," 199,98 ",0.189689," 0,00 "," 6.043,56 "," 3.708,78 ",2931533965,CFD," 0,00 "
03/02/2025 10:30:35,Position closed,NSDQ100/USD," 201,51 ",0.189689," 1,53 "," 6.045,09 "," 3.910,29 ",2931533965,CFD," 0,00 "
03/02/2025 10:30:53,Open Position,NSDQ100/USD," 199,98 ",0.189585," 0,00 "," 6.045,09 "," 3.710,31 ",2931538878,CFD," 0,00 "
03/02/2025 10:38:08,Position closed,NSDQ100/USD," 203,60 ",0.189585," 3,62 "," 6.048,71 "," 3.913,91 ",2931538878,CFD," 0,00 "
03/02/2025 10:38:13,Position closed,NSDQ100/USD," 251,86 ",0.236864," 1,86 "," 6.050,57 "," 4.165,77 ",2931508010,CFD," 0,00 "
03/02/2025 10:40:22,Open Position,NSDQ100/USD," 199,98 ",0.189334," 0,00 "," 6.050,57 "," 3.965,79 ",2931542285,CFD," 0,00 "
03/02/2025 11:06:17,Position closed,NSDQ100/USD," 305,14 ",0.284041," 5,14 "," 6.055,71 "," 4.270,93 ",2931443107,CFD," 0,00 "
03/02/2025 11:06:17,Position closed,NSDQ100/USD," 203,12 ",0.189334," 3,14 "," 6.058,85 "," 4.474,05 ",2931542285,CFD," 0,00 "
03/02/2025 11:06:30,Open Position,NSDQ100/USD," 199,98 ",0.189155," 0,00 "," 6.058,85 "," 4.274,07 ",2931604494,CFD," 0,00 "
03/02/2025 11:07:56,Open Position,NSDQ100/USD," 149,99 ",0.141843," 0,00 "," 6.058,85 "," 4.124,08 ",2931605226,CFD," 0,00 "
03/02/2025 11:37:49,Position closed,NVDA.EXT/USD," 130,12 ",6.239979,"(20,01)"," 6.038,84 "," 4.254,20 ",2931648345,CFD," 0,00 "
03/02/2025 11:37:55,Position closed,NVDA.EXT/USD," 65,61 ",3.122192,"(9,38)"," 6.029,46 "," 4.319,81 ",2931648370,CFD," 0,00 "
03/02/2025 11:38:47,Position closed,USD/JPY," 85,20 ",2998.608402,"(14,75)"," 6.014,71 "," 4.405,01 ",2931648701,CFD," 0,00 "
03/02/2025 11:39:19,Open Position,USD/JPY," 199,99 ",6000," 0,00 "," 6.014,71 "," 4.205,02 ",2931648927,CFD," 0,00 "
03/02/2025 11:53:25,Open Position,NSDQ100/USD," 199,98 ",0.189619," 0,00 "," 6.014,71 "," 4.005,04 ",2931656552,CFD," 0,00 "
03/02/2025 12:13:10,Open Position,NVDA.EXT/USD," 99,99 ",4.311694," 0,00 "," 6.014,71 "," 3.905,05 ",2931688752,CFD," 0,00 "
03/02/2025 12:47:29,Open Position,USD/JPY," 199,99 ",6000," 0,00 "," 6.014,71 "," 3.705,06 ",2931758930,CFD," 0,00 "
03/02/2025 12:53:52,Position closed,NVDA.EXT/USD," 95,26 ",4.311694,"(4,73)"," 6.009,98 "," 3.800,32 ",2931688752,CFD," 0,00 "
03/02/2025 12:54:03,Position closed,USD/JPY," 201,89 ",6000," 1,90 "," 6.011,88 "," 4.002,21 ",2931758930,CFD," 0,00 "
03/02/2025 12:54:18,Open Position,USD/JPY," 249,99 ",7500," 0,00 "," 6.011,88 "," 3.752,22 ",2931765745,CFD," 0,00 "
03/02/2025 13:12:03,Position closed,USD/JPY," 253,92 ",7500," 3,93 "," 6.015,81 "," 4.006,14 ",2931765745,CFD," 0,00 "
03/02/2025 13:12:14,Open Position,USD/JPY," 199,99 ",6000," 0,00 "," 6.015,81 "," 3.806,15 ",2931773171,CFD," 0,00 "
03/02/2025 13:37:44,Position closed,USD/JPY," 205,38 ",6000," 5,39 "," 6.021,20 "," 4.011,53 ",2931773171,CFD," 0,00 "
03/02/2025 13:47:13,Position closed,USD/JPY," 203,90 ",6000," 3,91 "," 6.025,11 "," 4.215,43 ",2931648927,CFD," 0,00 "
03/02/2025 13:47:27,Open Position,USD/JPY," 199,99 ",6000," 0,00 "," 6.025,11 "," 4.015,44 ",2931815749,CFD," 0,00 "
03/02/2025 13:47:45,Position closed,NSDQ100/USD," 198,48 ",0.189619,"(1,50)"," 6.023,61 "," 4.213,92 ",2931656552,CFD," 0,00 "
03/02/2025 14:31:39,Open Position,USD/JPY," 249,99 ",7500," 0,00 "," 6.023,61 "," 3.963,93 ",2931883395,CFD," 0,00 "
03/02/2025 14:35:43,Edit Stop Loss,-,"(29,17)",-," 0,00 "," 6.023,61 "," 3.934,76 ",2927862904,-," 0,00 "
03/02/2025 14:35:49,Edit Stop Loss,-,"(24,86)",-," 0,00 "," 6.023,61 "," 3.909,90 ",2930721811,-," 0,00 "
03/02/2025 14:35:56,Edit Stop Loss,-,"(12,48)",-," 0,00 "," 6.023,61 "," 3.897,42 ",2930724445,-," 0,00 "
03/02/2025 14:42:36,Position closed,NSDQ100/USD," 150,67 ",0.141843," 0,68 "," 6.024,29 "," 4.048,09 ",2931605226,CFD," 0,00 "
03/02/2025 14:42:36,Position closed,NSDQ100/USD," 201,46 ",0.189155," 1,48 "," 6.025,77 "," 4.249,55 ",2931604494,CFD," 0,00 "
03/02/2025 14:43:10,Open Position,NSDQ100/USD," 249,95 ",0.236248," 0,00 "," 6.025,77 "," 3.999,60 ",2932166398,CFD," 0,00 "
03/02/2025 14:43:43,Open Position,NVDA.EXT/USD," 250,00 ",10.861782," 0,00 "," 6.025,77 "," 3.749,60 ",2932171770,CFD," 0,00 "
03/02/2025 14:43:50,Position closed,NSDQ100/USD," 250,85 ",0.236248," 0,90 "," 6.026,67 "," 4.000,45 ",2932166398,CFD," 0,00 "
03/02/2025 14:44:32,Open Position,NSDQ100/USD," 249,99 ",0.236384," 0,00 "," 6.026,67 "," 3.750,46 ",2932177211,CFD," 0,00 "
03/02/2025 14:59:29,Position closed,USD/JPY," 251,20 ",7500," 1,21 "," 6.027,88 "," 4.001,66 ",2931883395,CFD," 0,00 "
03/02/2025 14:59:37,Open Position,USD/JPY," 249,99 ",7500," 0,00 "," 6.027,88 "," 3.751,67 ",2932638995,CFD," 0,00 "
03/02/2025 15:18:21,Open Position,USD/JPY," 249,99 ",7500," 0,00 "," 6.027,88 "," 3.501,68 ",2932756223,CFD," 0,00 "
03/02/2025 15:26:43,Position closed,USD/JPY," 277,01 ",7500," 27,02 "," 6.054,90 "," 3.778,69 ",2932756223,CFD," 0,00 "
03/02/2025 15:26:49,Position closed,USD/JPY," 253,72 ",7500," 3,73 "," 6.058,63 "," 4.032,41 ",2932638995,CFD," 0,00 "
03/02/2025 15:26:58,Open Position,USD/JPY," 299,99 ",9000," 0,00 "," 6.058,63 "," 3.732,42 ",2932801274,CFD," 0,00 "
03/02/2025 15:27:08,Position closed,NSDQ100/USD," 265,94 ",0.236384," 15,95 "," 6.074,58 "," 3.998,36 ",2932177211,CFD," 0,00 "
03/02/2025 15:27:36,Open Position,NSDQ100/USD," 249,61 ",0.235558," 0,00 "," 6.074,58 "," 3.748,75 ",2932804813,CFD," 0,00 "
03/02/2025 15:27:49,Position closed,NSDQ100/USD," 246,80 ",0.235558,"(2,81)"," 6.071,77 "," 3.995,55 ",2932804813,CFD," 0,00 "
03/02/2025 15:28:07,Open Position,NSDQ100/USD," 249,98 ",0.235705," 0,00 "," 6.071,77 "," 3.745,57 ",2932807108,CFD," 0,00 "
03/02/2025 15:28:23,Position closed,USD/JPY," 306,45 ",9000," 6,46 "," 6.078,23 "," 4.052,02 ",2932801274,CFD," 0,00 "
03/02/2025 15:28:31,Open Position,USD/JPY," 350,00 ",10500," 0,00 "," 6.078,23 "," 3.702,02 ",2932808475,CFD," 0,00 "
03/02/2025 15:29:31,Position closed,NSDQ100/USD," 243,99 ",0.235705,"(5,99)"," 6.072,24 "," 3.946,01 ",2932807108,CFD," 0,00 "
03/02/2025 15:29:45,Open Position,NSDQ100/USD," 299,58 ",0.282503," 0,00 "," 6.072,24 "," 3.646,43 ",2932813802,CFD," 0,00 "
03/02/2025 15:29:55,Position closed,NSDQ100/USD," 306,36 ",0.282503," 6,78 "," 6.079,02 "," 3.952,79 ",2932813802,CFD," 0,00 "
03/02/2025 15:30:15,Open Position,NSDQ100/USD," 299,99 ",0.282549," 0,00 "," 6.079,02 "," 3.652,80 ",2932815483,CFD," 0,00 "
03/02/2025 15:30:27,Position closed,NVDA.EXT/USD," 254,93 ",10.861782," 4,93 "," 6.083,95 "," 3.907,73 ",2932171770,CFD," 0,00 "
03/02/2025 15:31:02,Position closed,USD/JPY," 353,93 ",10500," 3,93 "," 6.087,88 "," 4.261,66 ",2932808475,CFD," 0,00 "
03/02/2025 15:31:10,Open Position,USD/JPY," 299,99 ",9000," 0,00 "," 6.087,88 "," 3.961,67 ",2932821568,CFD," 0,00 "
03/02/2025 15:36:05,Position closed,NSDQ100/USD," 308,69 ",0.282549," 8,70 "," 6.096,58 "," 4.270,36 ",2932815483,CFD," 0,00 "
03/02/2025 15:36:26,Open Position,NSDQ100/USD," 249,99 ",0.234983," 0,00 "," 6.096,58 "," 4.020,37 ",2932842259,CFD," 0,00 "
03/02/2025 15:36:55,Open Position,USD/JPY," 199,99 ",6000," 0,00 "," 6.096,58 "," 3.820,38 ",2932843696,CFD," 0,00 "
03/02/2025 15:46:20,Position closed,USD/JPY," 203,40 ",6000," 3,41 "," 6.099,99 "," 4.023,78 ",2932843696,CFD," 0,00 "
03/02/2025 15:46:27,Position closed,NSDQ100/USD," 258,47 ",0.234983," 8,48 "," 6.108,47 "," 4.282,25 ",2932842259,CFD," 0,00 "
03/02/2025 15:46:41,Open Position,NSDQ100/USD," 249,98 ",0.234568," 0,00 "," 6.108,47 "," 4.032,27 ",2932880485,CFD," 0,00 "
03/02/2025 15:46:56,Open Position,USD/JPY," 299,99 ",9000," 0,00 "," 6.108,47 "," 3.732,28 ",2932881409,CFD," 0,00 "
03/02/2025 16:01:49,Position closed,NSDQ100/USD," 252,75 ",0.234568," 2,77 "," 6.111,24 "," 3.985,03 ",2932880485,CFD," 0,00 "
03/02/2025 16:01:58,Position closed,USD/JPY," 302,08 ",9000," 2,09 "," 6.113,33 "," 4.287,11 ",2932881409,CFD," 0,00 "
03/02/2025 16:02:33,Open Position,NSDQ100/USD," 249,99 ",0.234416," 0,00 "," 6.113,33 "," 4.037,12 ",2932933046,CFD," 0,00 "
03/02/2025 16:20:08,Position closed,NSDQ100/USD," 251,76 ",0.234416," 1,77 "," 6.115,10 "," 4.288,88 ",2932933046,CFD," 0,00 "
03/02/2025 16:20:25,Open Position,USD/JPY," 199,99 ",6000," 0,00 "," 6.115,10 "," 4.088,89 ",2932983168,CFD," 0,00 "
03/02/2025 16:20:45,Open Position,NSDQ100/USD," 200,00 ",0.187505," 0,00 "," 6.115,10 "," 3.888,89 ",2932984179,CFD," 0,00 "
03/02/2025 16:49:02,Position closed,NSDQ100/USD," 201,60 ",0.187505," 1,60 "," 6.116,70 "," 4.090,49 ",2932984179,CFD," 0,00 "
03/02/2025 16:49:24,Open Position,NSDQ100/USD," 249,99 ",0.234534," 0,00 "," 6.116,70 "," 3.840,50 ",2933036189,CFD," 0,00 "
03/02/2025 16:52:50,Position closed,NSDQ100/USD," 253,81 ",0.234534," 3,82 "," 6.120,52 "," 4.094,31 ",2933036189,CFD," 0,00 "
03/02/2025 16:53:08,Open Position,NSDQ100/USD," 299,99 ",0.281118," 0,00 "," 6.120,52 "," 3.794,32 ",2933040773,CFD," 0,00 "
03/02/2025 17:00:17,Open Position,NSDQ100/USD," 149,99 ",0.141063," 0,00 "," 6.120,52 "," 3.644,33 ",2933052176,CFD," 0,00 "
03/02/2025 17:10:11,Position closed,NSDQ100/USD," 153,03 ",0.141063," 3,04 "," 6.123,56 "," 3.797,36 ",2933052176,CFD," 0,00 "
03/02/2025 17:10:28,Open Position,NSDQ100/USD," 259,98 ",0.244281," 0,00 "," 6.123,56 "," 3.537,38 ",2933064952,CFD," 0,00 "
03/02/2025 18:39:14,Position closed,NSDQ100/USD," 268,11 ",0.244281," 8,13 "," 6.131,69 "," 3.805,49 ",2933064952,CFD," 0,00 "
03/02/2025 18:39:26,Position closed,USD/JPY," 208,59 ",6000," 8,60 "," 6.140,29 "," 4.014,08 ",2932983168,CFD," 0,00 "
03/02/2025 18:39:33,Position closed,USD/JPY," 305,34 ",9000," 5,35 "," 6.145,64 "," 4.319,42 ",2932821568,CFD," 0,00 "
03/02/2025 18:39:40,Position closed,USD/JPY," 203,24 ",6000," 3,25 "," 6.148,89 "," 4.522,66 ",2931815749,CFD," 0,00 "
03/02/2025 18:39:59,Open Position,NSDQ100/USD," 249,98 ",0.234491," 0,00 "," 6.148,89 "," 4.272,68 ",2933172024,CFD," 0,00 "
03/02/2025 18:40:10,Open Position,USD/JPY," 249,99 ",7500," 0,00 "," 6.148,89 "," 4.022,69 ",2933172336,CFD," 0,00 "
03/02/2025 18:56:11,Position closed,NSDQ100/USD," 258,43 ",0.234491," 8,45 "," 6.157,34 "," 4.281,12 ",2933172024,CFD," 0,00 "
03/02/2025 18:56:11,Position closed,NSDQ100/USD," 304,29 ",0.281118," 4,30 "," 6.161,64 "," 4.585,41 ",2933040773,CFD," 0,00 "
03/02/2025 18:56:23,Position closed,USD/JPY," 252,94 ",7500," 2,95 "," 6.164,59 "," 4.838,35 ",2933172336,CFD," 0,00 "
03/02/2025 18:56:42,Open Position,USD/JPY," 249,99 ",7500," 0,00 "," 6.164,59 "," 4.588,36 ",2933192007,CFD," 0,00 "
03/02/2025 18:57:11,Open Position,NSDQ100/USD," 149,99 ",0.14045," 0,00 "," 6.164,59 "," 4.438,37 ",2933193640,CFD," 0,00 "
03/02/2025 19:20:16,Position closed,NSDQ100/USD," 155,12 ",0.14045," 5,13 "," 6.169,72 "," 4.593,49 ",2933193640,CFD," 0,00 "
03/02/2025 19:20:49,Open Position,NSDQ100/USD," 249,99 ",0.233674," 0,00 "," 6.169,72 "," 4.343,50 ",2933219296,CFD," 0,00 "
03/02/2025 19:22:02,Open Position,NSDQ100/USD," 200,00 ",0.186959," 0,00 "," 6.169,72 "," 4.143,50 ",2933220728,CFD," 0,00 "
03/02/2025 20:59:25,Open Position,USD/JPY," 249,99 ",7500," 0,00 "," 6.169,72 "," 3.893,51 ",2933315915,CFD," 0,00 "
03/02/2025 21:16:19,Position closed,USD/JPY," 251,10 ",7500," 1,11 "," 6.170,83 "," 4.144,61 ",2933315915,CFD," 0,00 "
03/02/2025 21:16:32,Open Position,USD/JPY," 249,99 ",7500," 0,00 "," 6.170,83 "," 3.894,62 ",2933321143,CFD," 0,00 "
03/02/2025 21:48:34,Position closed,NSDQ100/USD," 211,37 ",0.186959," 11,37 "," 6.182,20 "," 4.105,99 ",2933220728,CFD," 0,00 "
03/02/2025 21:48:34,Position closed,NSDQ100/USD," 263,79 ",0.233674," 13,80 "," 6.196,00 "," 4.369,78 ",2933219296,CFD," 0,00 "
03/02/2025 21:53:41,Position closed,USD/JPY," 255,99 ",7500," 6,00 "," 6.202,00 "," 4.625,77 ",2933321143,CFD," 0,00 "
03/02/2025 21:54:24,Open Position,NSDQ100/USD," 199,98 ",0.186489," 0,00 "," 6.202,00 "," 4.425,79 ",2933333376,CFD," 0,00 "
03/02/2025 21:54:32,Open Position,USD/JPY," 249,99 ",7500," 0,00 "," 6.202,00 "," 4.175,80 ",2933333409,CFD," 0,00 "
03/02/2025 21:55:28,Open Position,NSDQ100/USD," 199,98 ",0.186543," 0,00 "," 6.202,00 "," 3.975,82 ",2933333594,CFD," 0,00 "
03/02/2025 23:06:10,Position closed,NSDQ100/USD," 203,78 ",0.186543," 3,80 "," 6.205,80 "," 4.179,60 ",2933333594,CFD," 0,00 "
03/02/2025 23:06:10,Position closed,NSDQ100/USD," 202,62 ",0.186489," 2,64 "," 6.208,44 "," 4.382,22 ",2933333376,CFD," 0,00 "
03/02/2025 23:06:19,Position closed,USD/JPY," 251,93 ",7500," 1,94 "," 6.210,38 "," 4.634,15 ",2933333409,CFD," 0,00 "
03/02/2025 23:06:35,Open Position,USD/JPY," 299,99 ",9000," 0,00 "," 6.210,38 "," 4.334,16 ",2933343919,CFD," 0,00 "
03/02/2025 23:06:59,Open Position,NSDQ100/USD," 250,00 ",0.232909," 0,00 "," 6.210,38 "," 4.084,16 ",2933343986,CFD," 0,00 "
03/02/2025 23:14:16,Position closed,NSDQ100/USD," 249,25 ",0.232909,"(0,75)"," 6.209,63 "," 4.333,41 ",2933343986,CFD," 0,00 "
03/02/2025 23:14:26,Position closed,USD/JPY," 252,36 ",7500," 2,37 "," 6.212,00 "," 4.585,77 ",2933192007,CFD," 0,00 "
03/02/2025 23:14:34,Position closed,USD/JPY," 306,72 ",9000," 6,73 "," 6.218,73 "," 4.892,49 ",2933343919,CFD," 0,00 "
03/02/2025 23:15:03,Open Position,USD/JPY," 199,99 ",6000," 0,00 "," 6.218,73 "," 4.692,50 ",2933345279,CFD," 0,00 "
03/02/2025 23:52:44,Position closed,USD/JPY," 205,71 ",6000," 5,72 "," 6.224,45 "," 4.898,21 ",2933345279,CFD," 0,00 "
03/02/2025 23:53:03,Position closed,USD/JPY," 100,32 ",3001.115495," 0,29 "," 6.224,74 "," 4.998,53 ",2931504151,CFD," 0,00 "
04/02/2025 00:47:47,Overnight refund,Daily," 0,60 ",-," 0,60 "," 6.225,34 "," 4.999,13 ",2933192007,CFD," 0,00 "
04/02/2025 00:47:47,Overnight refund,Daily," 0,60 ",-," 0,60 "," 6.225,94 "," 4.999,73 ",2933333409,CFD," 0,00 "
04/02/2025 00:47:47,Overnight refund,Daily," 0,24 ",-," 0,24 "," 6.226,18 "," 4.999,97 ",2931465816,CFD," 0,00 "
04/02/2025 00:47:47,Overnight refund,Daily," 0,24 ",-," 0,24 "," 6.226,42 "," 5.000,21 ",2931504151,CFD," 0,00 "
04/02/2025 00:47:47,Overnight fee,Daily,"(0,11)",-,"(0,11)"," 6.226,31 "," 5.000,10 ",2930724445,CFD," 0,00 "
04/02/2025 00:47:47,Overnight fee,Daily,"(0,22)",-,"(0,22)"," 6.226,09 "," 4.999,88 ",2930721811,CFD," 0,00 "
04/02/2025 00:47:47,Overnight fee,Daily,"(0,34)",-,"(0,34)"," 6.225,75 "," 4.999,54 ",2927862904,CFD," 0,00 "
04/02/2025 00:47:47,Overnight fee,Daily,"(0,95)",-,"(0,95)"," 6.224,80 "," 4.998,59 ",2933333376,CFD," 0,00 "
04/02/2025 00:47:47,Overnight fee,Daily,"(0,95)",-,"(0,95)"," 6.223,85 "," 4.997,64 ",2933333594,CFD," 0,00 "
04/02/2025 00:49:41,Position closed,USD/JPY," 96,97 ",3001.391598,"(3,07)"," 6.220,78 "," 5.094,61 ",2931465816,CFD," 0,00 "
04/02/2025 06:36:41,Open Position,NSDQ100/USD," 199,98 ",0.188222," 0,00 "," 6.220,78 "," 4.894,63 ",2933403152,CFD," 0,00 "
04/02/2025 07:57:30,Position closed,NSDQ100/USD," 207,71 ",0.188222," 7,73 "," 6.228,51 "," 5.102,34 ",2933403152,CFD," 0,00 "
04/02/2025 07:59:17,Open Position,NSDQ100/USD," 275,00 ",0.258207," 0,00 "," 6.228,51 "," 4.827,34 ",2933422584,CFD," 0,00 "
04/02/2025 08:00:31,Open Position,USD/JPY," 55,00 ",1500," 0,00 "," 6.228,51 "," 4.777,34 ",2933453282,CFD," 0,00 "
04/02/2025 08:13:53,Open Position,NSDQ100/USD," 149,99 ",0.141058," 0,00 "," 6.228,51 "," 4.627,35 ",2933471367,CFD," 0,00 "
04/02/2025 09:09:24,Position closed,NSDQ100/USD," 151,27 ",0.141058," 1,28 "," 6.229,79 "," 4.778,62 ",2933471367,CFD," 0,00 "
04/02/2025 09:09:43,Open Position,NSDQ100/USD," 275,00 ",0.258485," 0,00 "," 6.229,79 "," 4.503,62 ",2933514638,CFD," 0,00 "
04/02/2025 09:12:00,Position closed,NSDQ100/USD," 277,15 ",0.258485," 2,15 "," 6.231,94 "," 4.780,77 ",2933514638,CFD," 0,00 "
04/02/2025 09:12:09,Open Position,NSDQ100/USD," 260,00 ",0.244225," 0,00 "," 6.231,94 "," 4.520,77 ",2933515343,CFD," 0,00 "
04/02/2025 10:28:28,Open Position,USD/JPY," 150,00 ",4500," 0,00 "," 6.231,94 "," 4.370,77 ",2933675115,CFD," 0,00 "
04/02/2025 10:36:23,Position closed,USD/JPY," 151,30 ",4500," 1,30 "," 6.233,24 "," 4.522,07 ",2933675115,CFD," 0,00 "
04/02/2025 10:36:41,Open Position,USD/JPY," 150,00 ",4500," 0,00 "," 6.233,24 "," 4.372,07 ",2933707056,CFD," 0,00 "
04/02/2025 11:31:58,Position closed,NSDQ100/USD," 262,09 ",0.244225," 2,09 "," 6.235,33 "," 4.634,16 ",2933515343,CFD," 0,00 "
04/02/2025 11:32:09,Open Position,NSDQ100/USD," 349,98 ",0.328542," 0,00 "," 6.235,33 "," 4.284,18 ",2933736977,CFD," 0,00 "
04/02/2025 11:49:28,Position closed,NSDQ100/USD," 276,50 ",0.258207," 1,50 "," 6.236,83 "," 4.560,68 ",2933422584,CFD," 0,00 "
04/02/2025 11:49:41,Open Position,NSDQ100/USD," 359,98 ",0.337846," 0,00 "," 6.236,83 "," 4.200,70 ",2933740786,CFD," 0,00 "
04/02/2025 12:12:11,Position closed,NSDQ100/USD," 365,82 ",0.337846," 5,84 "," 6.242,67 "," 4.566,52 ",2933740786,CFD," 0,00 "
04/02/2025 12:12:11,Position closed,NSDQ100/USD," 357,39 ",0.328542," 7,41 "," 6.250,08 "," 4.923,91 ",2933736977,CFD," 0,00 "
04/02/2025 12:12:27,Open Position,NSDQ100/USD," 300,00 ",0.281231," 0,00 "," 6.250,08 "," 4.623,91 ",2933746012,CFD," 0,00 "
04/02/2025 12:12:51,Open Position,NVDA.EXT/USD," 199,99 ",8.499332," 0,00 "," 6.250,08 "," 4.423,92 ",2933746107,CFD," 0,00 "
04/02/2025 12:15:23,Position closed,USD/JPY," 150,98 ",4500," 0,98 "," 6.251,06 "," 4.574,90 ",2933707056,CFD," 0,00 "
04/02/2025 12:43:16,Position closed,NSDQ100/USD," 307,89 ",0.281231," 7,89 "," 6.258,95 "," 4.882,79 ",2933746012,CFD," 0,00 "
04/02/2025 12:43:52,Open Position,NSDQ100/USD," 250,00 ",0.234055," 0,00 "," 6.258,95 "," 4.632,79 ",2933754442,CFD," 0,00 "
04/02/2025 14:33:37,Open Position,NSDQ100/USD," 249,98 ",0.234217," 0,00 "," 6.258,95 "," 4.382,81 ",2933894636,CFD," 0,00 "
04/02/2025 14:38:02,Position closed,NSDQ100/USD," 254,50 ",0.234217," 4,52 "," 6.263,47 "," 4.637,31 ",2933894636,CFD," 0,00 "
04/02/2025 14:38:10,Open Position,NSDQ100/USD," 299,99 ",0.280714," 0,00 "," 6.263,47 "," 4.337,32 ",2933918741,CFD," 0,00 "
04/02/2025 14:38:40,Position closed,NSDQ100/USD," 253,58 ",0.234055," 3,58 "," 6.267,05 "," 4.590,90 ",2933754442,CFD," 0,00 "
04/02/2025 14:38:40,Position closed,NSDQ100/USD," 301,41 ",0.280714," 1,42 "," 6.268,47 "," 4.892,31 ",2933918741,CFD," 0,00 "
04/02/2025 14:38:50,Open Position,NSDQ100/USD," 400,00 ",0.373926," 0,00 "," 6.268,47 "," 4.492,31 ",2933920711,CFD," 0,00 "
04/02/2025 14:39:33,Position closed,NSDQ100/USD," 404,69 ",0.373926," 4,69 "," 6.273,16 "," 4.897,00 ",2933920711,CFD," 0,00 "
04/02/2025 14:39:42,Open Position,NSDQ100/USD," 499,98 ",0.467059," 0,00 "," 6.273,16 "," 4.397,02 ",2933922635,CFD," 0,00 "
04/02/2025 14:40:19,Position closed,NVDA.EXT/USD," 205,91 ",8.499332," 5,92 "," 6.279,08 "," 4.602,93 ",2933746107,CFD," 0,00 "
04/02/2025 14:42:20,Open Position,NSDQ100/USD," 199,99 ",0.187004," 0,00 "," 6.279,08 "," 4.402,94 ",2933930738,CFD," 0,00 "
04/02/2025 14:43:02,Position closed,NSDQ100/USD," 201,31 ",0.187004," 1,32 "," 6.280,40 "," 4.604,25 ",2933930738,CFD," 0,00 "
04/02/2025 14:43:10,Open Position,NSDQ100/USD," 249,99 ",0.233548," 0,00 "," 6.280,40 "," 4.354,26 ",2933935424,CFD," 0,00 "
04/02/2025 15:03:18,Position closed,NSDQ100/USD," 265,53 ",0.233548," 15,54 "," 6.295,94 "," 4.619,79 ",2933935424,CFD," 0,00 "
04/02/2025 15:03:18,Position closed,NSDQ100/USD," 530,35 ",0.467059," 30,37 "," 6.326,31 "," 5.150,14 ",2933922635,CFD," 0,00 "
04/02/2025 15:03:50,Open Position,NSDQ100/USD," 249,97 ",0.232807," 0,00 "," 6.326,31 "," 4.900,17 ",2934078447,CFD," 0,00 "
04/02/2025 15:03:56,Open Position,NSDQ100/USD," 200,00 ",0.186254," 0,00 "," 6.326,31 "," 4.700,17 ",2934078756,CFD," 0,00 "
04/02/2025 15:04:41,Position closed,NSDQ100/USD," 201,26 ",0.186254," 1,26 "," 6.327,57 "," 4.901,43 ",2934078756,CFD," 0,00 "
04/02/2025 15:04:41,Position closed,NSDQ100/USD," 251,90 ",0.232807," 1,93 "," 6.329,50 "," 5.153,33 ",2934078447,CFD," 0,00 "
04/02/2025 15:04:52,Open Position,NSDQ100/USD," 349,99 ",0.325708," 0,00 "," 6.329,50 "," 4.803,34 ",2934081055,CFD," 0,00 "
04/02/2025 15:05:24,Open Position,USD/JPY," 249,99 ",7500," 0,00 "," 6.329,50 "," 4.553,35 ",2934082372,CFD," 0,00 "
04/02/2025 15:05:58,Position closed,NVDA.EXT/USD," 88,14 ",3.122609," 0,65 "," 6.330,15 "," 4.641,49 ",2930724445,CFD," 0,00 "
04/02/2025 15:06:09,Position closed,NSDQ100/USD," 350,98 ",0.325708," 0,99 "," 6.331,14 "," 4.992,47 ",2934081055,CFD," 0,00 "
04/02/2025 15:06:18,Open Position,NSDQ100/USD," 349,99 ",0.325663," 0,00 "," 6.331,14 "," 4.642,48 ",2934084507,CFD," 0,00 "
04/02/2025 15:06:34,Position closed,USD/JPY," 252,99 ",7500," 3,00 "," 6.334,14 "," 4.895,47 ",2934082372,CFD," 0,00 "
04/02/2025 15:06:40,Open Position,USD/JPY," 218,87 ",9000," 0,00 "," 6.334,14 "," 4.595,48 ",2934085495,CFD," 0,00 "
04/02/2025 15:08:33,Position closed,NSDQ100/USD," 355,94 ",0.325663," 5,95 "," 6.340,09 "," 4.951,42 ",2934084507,CFD," 0,00 "
04/02/2025 15:08:50,Open Position,NSDQ100/USD," 369,99 ",0.3438," 0,00 "," 6.340,09 "," 4.581,43 ",2934092506,CFD," 0,00 "
04/02/2025 15:09:22,Position closed,NVDA.EXT/USD," 178,05 ",6.227791," 3,35 "," 6.343,44 "," 4.759,48 ",2930721811,CFD," 0,00 "
04/02/2025 15:09:37,Position closed,NSDQ100/USD," 371,81 ",0.3438," 1,82 "," 6.345,26 "," 5.131,29 ",2934092506,CFD," 0,00 "
04/02/2025 15:09:46,Open Position,NSDQ100/USD," 299,99 ",0.278654," 0,00 "," 6.345,26 "," 4.831,30 ",2934094400,CFD," 0,00 "
04/02/2025 15:10:53,Position closed,NSDQ100/USD," 302,02 ",0.278654," 2,03 "," 6.347,29 "," 5.133,32 ",2934094400,CFD," 0,00 "
04/02/2025 15:11:05,Open Position,NSDQ100/USD," 299,99 ",0.27845," 0,00 "," 6.347,29 "," 4.833,33 ",2934096881,CFD," 0,00 "
04/02/2025 15:28:35,Open Position,USD/JPY," 274,99 ",8250," 0,00 "," 6.347,29 "," 4.558,34 ",2934155026,CFD," 0,00 "
04/02/2025 15:34:03,Position closed,USD/JPY," 276,96 ",8250," 1,97 "," 6.349,26 "," 4.835,30 ",2934155026,CFD," 0,00 "
04/02/2025 15:34:11,Open Position,USD/JPY," 350,00 ",10500," 0,00 "," 6.349,26 "," 4.485,30 ",2934170478,CFD," 0,00 "
04/02/2025 15:34:26,Open Position,NSDQ100/USD," 199,99 ",0.18575," 0,00 "," 6.349,26 "," 4.285,31 ",2934170791,CFD," 0,00 "
04/02/2025 15:34:41,Position closed,USD/JPY," 352,37 ",10500," 2,37 "," 6.351,63 "," 4.637,68 ",2934170478,CFD," 0,00 "
04/02/2025 15:34:49,Open Position,USD/JPY," 254,24 ",10500," 0,00 "," 6.351,63 "," 4.287,68 ",2934171930,CFD," 0,00 "
04/02/2025 15:42:32,Position closed,NSDQ100/USD," 304,73 ",0.27845," 4,74 "," 6.356,37 "," 4.592,41 ",2934096881,CFD," 0,00 "
04/02/2025 15:42:32,Position closed,NSDQ100/USD," 205,57 ",0.18575," 5,58 "," 6.361,95 "," 4.797,98 ",2934170791,CFD," 0,00 "
04/02/2025 15:42:56,Open Position,NSDQ100/USD," 175,31 ",0.324547," 0,00 "," 6.361,95 "," 4.447,99 ",2934188464,CFD," 0,00 "
04/02/2025 15:43:10,Open Position,NSDQ100/USD," 149,95 ",0.278238," 0,00 "," 6.361,95 "," 4.148,00 ",2934188767,CFD," 0,00 "
04/02/2025 16:34:38,Open Position,USD/JPY," 225,38 ",7500," 0,00 "," 6.361,95 "," 3.898,01 ",2934269338,CFD," 0,00 "
04/02/2025 17:24:56,Open Position,NSDQ100/USD," 249,99 ",0.232609," 0,00 "," 6.361,95 "," 3.648,02 ",2934326954,CFD," 0,00 "
04/02/2025 17:25:49,Open Position,USD/JPY," 280,79 ",6000," 0,00 "," 6.361,95 "," 3.448,03 ",2934327676,CFD," 0,00 "
04/02/2025 17:50:28,Open Position,USD/JPY," 199,99 ",6000," 0,00 "," 6.361,95 "," 3.248,04 ",2934355074,CFD," 0,00 "
04/02/2025 18:23:43,Position closed,NSDQ100/USD," 254,88 ",0.232609," 4,89 "," 6.366,84 "," 3.502,92 ",2934326954,CFD," 0,00 "
04/02/2025 19:35:51,Open Position,USD/JPY," 150,00 ",4500," 0,00 "," 6.366,84 "," 3.352,92 ",2934445506,CFD," 0,00 "
04/02/2025 21:11:31,Position closed,NSDQ100/USD," 142,22 ",0.139157,"(7,82)"," 6.359,02 "," 3.495,14 ",2934512509,CFD," 0,00 "
04/02/2025 21:11:49,Position closed,NSDQ100/USD," 164,36 ",0.161983,"(10,32)"," 6.348,70 "," 3.659,50 ",2934512549,CFD," 0,00 "
04/02/2025 22:31:49,Position closed,USD/JPY," 153,09 ",4500," 3,09 "," 6.351,79 "," 3.812,59 ",2934445506,CFD," 0,00 "
04/02/2025 22:32:37,Open Position,USD/JPY," 150,00 ",4500," 0,00 "," 6.351,79 "," 3.662,59 ",2934525801,CFD," 0,00 "
04/02/2025 23:26:19,Position closed,USD/JPY," 204,77 ",6000," 4,78 "," 6.356,57 "," 3.867,36 ",2934355074,CFD," 0,00 "
04/02/2025 23:26:26,Position closed,USD/JPY," 151,57 ",4500," 1,57 "," 6.358,14 "," 4.018,93 ",2934525801,CFD," 0,00 "
04/02/2025 23:26:37,Open Position,USD/JPY," 417,77 ",9000," 0,00 "," 6.358,14 "," 3.718,94 ",2934532777,CFD," 0,00 "
05/02/2025 00:09:35,Open Position,USD/JPY," 272,87 ",6000," 0,00 "," 6.358,14 "," 3.518,95 ",2934536312,CFD," 0,00 "
05/02/2025 00:46:46,Open Position,USD/JPY," 209,47 ",6000," 0,00 "," 6.358,14 "," 3.318,96 ",2934538698,CFD," 0,00 "
05/02/2025 00:47:37,Overnight refund,Daily," 0,84 ",-," 0,84 "," 6.358,98 "," 3.319,80 ",2934171930,CFD," 0,00 "
05/02/2025 00:47:37,Overnight refund,Daily," 0,72 ",-," 0,72 "," 6.359,70 "," 3.320,52 ",2934085495,CFD," 0,00 "
05/02/2025 00:47:37,Overnight refund,Daily," 0,60 ",-," 0,60 "," 6.360,30 "," 3.321,12 ",2934269338,CFD," 0,00 "
05/02/2025 00:47:37,Overnight refund,Daily," 0,48 ",-," 0,48 "," 6.360,78 "," 3.321,60 ",2934355074,CFD," 0,00 "
05/02/2025 00:47:37,Overnight refund,Daily," 0,48 ",-," 0,48 "," 6.361,26 "," 3.322,08 ",2934327676,CFD," 0,00 "
05/02/2025 00:47:37,Overnight refund,Daily," 0,36 ",-," 0,36 "," 6.361,62 "," 3.322,44 ",2934445506,CFD," 0,00 "
05/02/2025 00:47:37,Overnight refund,Daily," 0,12 ",-," 0,12 "," 6.361,74 "," 3.322,56 ",2933453282,CFD," 0,00 "
05/02/2025 00:47:37,Overnight fee,Daily,"(0,34)",-,"(0,34)"," 6.361,40 "," 3.322,22 ",2927862904,CFD," 0,00 "
05/02/2025 00:47:37,Overnight fee,Daily,"(0,71)",-,"(0,71)"," 6.360,69 "," 3.321,51 ",2934188767,CFD," 0,00 "
05/02/2025 00:47:37,Overnight fee,Daily,"(0,83)",-,"(0,83)"," 6.359,86 "," 3.320,68 ",2934188464,CFD," 0,00 "
05/02/2025 05:56:54,Open Position,USD/JPY," 199,99 ",6000," 0,00 "," 6.359,86 "," 3.120,69 ",2934565546,CFD," 0,00 "
05/02/2025 07:38:04,Open Position,USD/JPY," 149,99 ",4500," 0,00 "," 6.359,86 "," 2.970,70 ",2934588073,CFD," 0,00 "
05/02/2025 08:05:16,Open Position,NSDQ100/USD," 199,99 ",0.18675," 0,00 "," 6.359,86 "," 2.770,71 ",2934614363,CFD," 0,00 "
05/02/2025 08:34:49,Open Position,USD/JPY," 200,00 ",6000," 0,00 "," 6.359,86 "," 2.570,71 ",2934649097,CFD," 0,00 "
05/02/2025 08:35:06,Position closed,NSDQ100/USD," 200,84 ",0.18675," 0,85 "," 6.360,71 "," 2.771,55 ",2934614363,CFD," 0,00 "
05/02/2025 08:35:14,Open Position,NSDQ100/USD," 249,99 ",0.233351," 0,00 "," 6.360,71 "," 2.521,56 ",2934649207,CFD," 0,00 "
05/02/2025 08:36:43,Position closed,USD/JPY," 202,98 ",6000," 2,98 "," 6.363,69 "," 2.724,54 ",2934649097,CFD," 0,00 "
05/02/2025 08:36:54,Open Position,USD/JPY," 275,00 ",8250," 0,00 "," 6.363,69 "," 2.449,54 ",2934651088,CFD," 0,00 "
05/02/2025 08:37:02,Position closed,USD/JPY," 151,43 ",4500," 1,44 "," 6.365,13 "," 2.600,97 ",2934588073,CFD," 0,00 "
05/02/2025 08:40:09,Open Position,USD/JPY," 150,00 ",4500," 0,00 "," 6.365,13 "," 2.450,97 ",2934652104,CFD," 0,00 "
05/02/2025 08:44:21,Edit Stop Loss,-,"(5,00)",-," 0,00 "," 6.365,13 "," 2.445,97 ",2933453282,-," 0,00 "
05/02/2025 08:44:29,Position closed,USD/JPY," 283,25 ",8250," 8,25 "," 6.373,38 "," 2.729,22 ",2934651088,CFD," 0,00 "
05/02/2025 08:44:44,Open Position,USD/JPY," 250,00 ",7500," 0,00 "," 6.373,38 "," 2.479,22 ",2934653578,CFD," 0,00 "
05/02/2025 09:16:55,Position closed,USD/JPY," 257,51 ",7500," 7,51 "," 6.380,89 "," 2.736,73 ",2934653578,CFD," 0,00 "
05/02/2025 09:17:08,Open Position,USD/JPY," 300,00 ",9000," 0,00 "," 6.380,89 "," 2.436,73 ",2934665863,CFD," 0,00 "
05/02/2025 09:18:35,Open Position,USD/JPY," 150,00 ",4500," 0,00 "," 6.380,89 "," 2.286,73 ",2934666272,CFD," 0,00 "
05/02/2025 09:24:38,Open Position,NSDQ100/USD," 149,99 ",0.140438," 0,00 "," 6.380,89 "," 2.136,74 ",2934668078,CFD," 0,00 "
05/02/2025 09:30:57,Open Position,USD/JPY," 200,00 ",6000," 0,00 "," 6.380,89 "," 1.936,74 ",2934669748,CFD," 0,00 "
05/02/2025 09:31:17,Position closed,USD/JPY," 301,65 ",9000," 1,65 "," 6.382,54 "," 2.238,39 ",2934665863,CFD," 0,00 "
05/02/2025 09:31:37,Open Position,USD/JPY," 300,00 ",9000," 0,00 "," 6.382,54 "," 1.938,39 ",2934669874,CFD," 0,00 "
05/02/2025 09:32:26,Position closed,USD/JPY," 300,41 ",9000," 0,41 "," 6.382,95 "," 2.238,80 ",2934669874,CFD," 0,00 "
05/02/2025 09:32:36,Open Position,USD/JPY," 300,00 ",9000," 0,00 "," 6.382,95 "," 1.938,80 ",2934670165,CFD," 0,00 "
05/02/2025 09:33:20,Position closed,NSDQ100/USD," 151,54 ",0.140438," 1,55 "," 6.384,50 "," 2.090,34 ",2934668078,CFD," 0,00 "
05/02/2025 09:33:30,Open Position,NSDQ100/USD," 199,99 ",0.187378," 0,00 "," 6.384,50 "," 1.890,35 ",2934673083,CFD," 0,00 "
05/02/2025 09:35:23,Edit Stop Loss,-,"(15,38)",-," 0,00 "," 6.384,50 "," 1.874,97 ",2934085495,-," 0,00 "
05/02/2025 09:35:29,Edit Stop Loss,-,"(14,97)",-," 0,00 "," 6.384,50 "," 1.860,00 ",2934171930,-," 0,00 "
05/02/2025 09:36:19,Open Position,USD/JPY," 149,99 ",4500," 0,00 "," 6.384,50 "," 1.710,01 ",2934673745,CFD," 0,00 "
05/02/2025 09:45:57,Position closed,USD/JPY," 152,49 ",4500," 2,50 "," 6.387,00 "," 1.862,50 ",2934673745,CFD," 0,00 "
05/02/2025 09:46:02,Position closed,USD/JPY," 304,60 ",9000," 4,60 "," 6.391,60 "," 2.167,10 ",2934670165,CFD," 0,00 "
05/02/2025 09:46:10,Position closed,USD/JPY," 202,47 ",6000," 2,47 "," 6.394,07 "," 2.369,57 ",2934669748,CFD," 0,00 "
05/02/2025 09:46:21,Open Position,USD/JPY," 300,00 ",9000," 0,00 "," 6.394,07 "," 2.069,57 ",2934677116,CFD," 0,00 "
05/02/2025 09:47:39,Open Position,USD/JPY," 150,00 ",4500," 0,00 "," 6.394,07 "," 1.919,57 ",2934678350,CFD," 0,00 "
05/02/2025 09:47:52,Open Position,USD/JPY," 250,00 ",7500," 0,00 "," 6.394,07 "," 1.669,57 ",2934678432,CFD," 0,00 "
05/02/2025 09:52:48,Position closed,USD/JPY," 151,44 ",4500," 1,44 "," 6.395,51 "," 1.821,01 ",2934678350,CFD," 0,00 "
05/02/2025 09:52:55,Open Position,USD/JPY," 199,99 ",6000," 0,00 "," 6.395,51 "," 1.621,02 ",2934680370,CFD," 0,00 "
05/02/2025 10:00:16,Position closed,NSDQ100/USD," 202,34 ",0.187378," 2,35 "," 6.397,86 "," 1.823,36 ",2934673083,CFD," 0,00 "
05/02/2025 10:00:56,Open Position,NSDQ100/USD," 99,99 ",0.093725," 0,00 "," 6.397,86 "," 1.723,37 ",2934682275,CFD," 0,00 "
05/02/2025 10:19:30,Position closed,USD/JPY," 254,18 ",7500," 4,18 "," 6.402,04 "," 1.977,55 ",2934678432,CFD," 0,00 "
05/02/2025 10:19:39,Position closed,USD/JPY," 303,42 ",9000," 3,42 "," 6.405,46 "," 2.280,97 ",2934677116,CFD," 0,00 "
05/02/2025 10:19:54,Open Position,USD/JPY," 300,00 ",9000," 0,00 "," 6.405,46 "," 1.980,97 ",2934686698,CFD," 0,00 "
05/02/2025 10:21:00,Position closed,NSDQ100/USD," 101,71 ",0.093725," 1,72 "," 6.407,18 "," 2.082,68 ",2934682275,CFD," 0,00 "
05/02/2025 10:21:15,Open Position,NSDQ100/USD," 199,99 ",0.187231," 0,00 "," 6.407,18 "," 1.882,69 ",2934687166,CFD," 0,00 "
05/02/2025 10:21:29,Position closed,NSDQ100/USD," 199,20 ",0.187231,"(0,79)"," 6.406,39 "," 2.081,89 ",2934687166,CFD," 0,00 "
05/02/2025 10:22:30,Open Position,USD/JPY," 150,00 ",4500," 0,00 "," 6.406,39 "," 1.931,89 ",2934687599,CFD," 0,00 "
05/02/2025 10:34:39,Open Position,NSDQ100/USD," 119,99 ",0.112343," 0,00 "," 6.406,39 "," 1.811,90 ",2934691025,CFD," 0,00 "
05/02/2025 10:34:51,Position closed,USD/JPY," 303,72 ",9000," 3,72 "," 6.410,11 "," 2.115,62 ",2934686698,CFD," 0,00 "
05/02/2025 10:34:56,Position closed,USD/JPY," 147,02 ",4500,"(2,98)"," 6.407,13 "," 2.262,64 ",2934687599,CFD," 0,00 "
05/02/2025 10:35:05,Open Position,USD/JPY," 300,00 ",9000," 0,00 "," 6.407,13 "," 1.962,64 ",2934691177,CFD," 0,00 "
05/02/2025 10:35:14,Open Position,USD/JPY," 119,99 ",3600," 0,00 "," 6.407,13 "," 1.842,65 ",2934691224,CFD," 0,00 "
05/02/2025 10:35:23,Open Position,USD/JPY," 150,00 ",4500," 0,00 "," 6.407,13 "," 1.692,65 ",2934691257,CFD," 0,00 "
05/02/2025 10:38:34,Open Position,USD/JPY," 349,21 ",21000," 0,00 "," 6.407,13 "," 992,65 ",2934692191,CFD," 0,00 "
05/02/2025 10:40:26,Position closed,USD/JPY," 148,61 ",4500,"(1,39)"," 6.405,74 "," 1.141,26 ",2934691257,CFD," 0,00 "
05/02/2025 10:49:28,Position closed,USD/JPY," 119,05 ",3600,"(0,94)"," 6.404,80 "," 1.260,31 ",2934691224,CFD," 0,00 "
05/02/2025 10:51:09,Open Position,USD/JPY," 199,99 ",6000," 0,00 "," 6.404,80 "," 1.060,32 ",2934700265,CFD," 0,00 "
05/02/2025 10:52:22,Position closed,USD/JPY," 294,99 ",9000,"(5,01)"," 6.399,79 "," 1.355,31 ",2934691177,CFD," 0,00 "
05/02/2025 10:53:49,Position closed,USD/JPY," 200,58 ",6000," 0,59 "," 6.400,38 "," 1.555,89 ",2934700265,CFD," 0,00 "
05/02/2025 10:54:06,Open Position,USD/JPY," 254,99 ",7650," 0,00 "," 6.400,38 "," 1.300,90 ",2934701087,CFD," 0,00 "
05/02/2025 11:02:14,Position closed,USD/JPY," 256,14 ",7650," 1,15 "," 6.401,53 "," 1.557,04 ",2934701087,CFD," 0,00 "
05/02/2025 11:02:29,Open Position,USD/JPY," 269,99 ",8100," 0,00 "," 6.401,53 "," 1.287,05 ",2934703278,CFD," 0,00 "
05/02/2025 11:05:40,Open Position,USD/JPY," 119,99 ",3600," 0,00 "," 6.401,53 "," 1.167,06 ",2934704191,CFD," 0,00 "
05/02/2025 11:07:49,Position closed,NSDQ100/USD," 121,15 ",0.112343," 1,16 "," 6.402,69 "," 1.288,21 ",2934691025,CFD," 0,00 "
05/02/2025 11:07:58,Open Position,NSDQ100/USD," 199,99 ",0.187114," 0,00 "," 6.402,69 "," 1.088,22 ",2934704719,CFD," 0,00 "
05/02/2025 11:08:27,Position closed,USD/JPY," 118,36 ",3600,"(1,63)"," 6.401,06 "," 1.206,58 ",2934704191,CFD," 0,00 "
05/02/2025 11:08:33,Position closed,USD/JPY," 271,95 ",8100," 1,96 "," 6.403,02 "," 1.478,53 ",2934703278,CFD," 0,00 "
05/02/2025 11:08:50,Open Position,USD/JPY," 199,99 ",6000," 0,00 "," 6.403,02 "," 1.278,54 ",2934704961,CFD," 0,00 "
05/02/2025 11:28:13,Position closed,NSDQ100/USD," 200,79 ",0.187114," 0,80 "," 6.403,82 "," 1.479,33 ",2934704719,CFD," 0,00 "
05/02/2025 11:28:21,Open Position,NSDQ100/USD," 199,99 ",0.187051," 0,00 "," 6.403,82 "," 1.279,34 ",2934710875,CFD," 0,00 "
05/02/2025 11:37:33,Position closed,USD/JPY," 201,17 ",6000," 1,18 "," 6.405,00 "," 1.480,51 ",2934704961,CFD," 0,00 "
05/02/2025 11:37:40,Open Position,USD/JPY," 274,99 ",8250," 0,00 "," 6.405,00 "," 1.205,52 ",2934713471,CFD," 0,00 "
05/02/2025 11:45:04,Position closed,USD/JPY," 334,74 ",10523.613816,"(16,05)"," 6.388,95 "," 1.540,26 ",2934715045,CFD," 0,00 "
05/02/2025 11:51:00,Position closed,USD/JPY," 200,03 ",6000," 0,04 "," 6.388,99 "," 1.740,29 ",2934680370,CFD," 0,00 "
05/02/2025 11:51:05,Position closed,USD/JPY," 276,39 ",8250," 1,40 "," 6.390,39 "," 2.016,68 ",2934713471,CFD," 0,00 "
05/02/2025 11:51:21,Open Position,USD/JPY," 249,99 ",7500," 0,00 "," 6.390,39 "," 1.766,69 ",2934717285,CFD," 0,00 "
05/02/2025 11:57:12,Position closed,USD/JPY," 251,61 ",7500," 1,62 "," 6.392,01 "," 2.018,30 ",2934717285,CFD," 0,00 "
05/02/2025 11:57:23,Open Position,USD/JPY," 199,99 ",6000," 0,00 "," 6.392,01 "," 1.818,31 ",2934719084,CFD," 0,00 "
05/02/2025 12:44:57,Position closed,USD/JPY," 201,32 ",6000," 1,33 "," 6.393,34 "," 2.019,63 ",2934719084,CFD," 0,00 "
05/02/2025 12:45:12,Position closed,NSDQ100/USD," 201,96 ",0.187051," 1,97 "," 6.395,31 "," 2.221,59 ",2934710875,CFD," 0,00 "
05/02/2025 12:55:07,Open Position,USD/JPY," 200,00 ",6000," 0,00 "," 6.395,31 "," 2.021,59 ",2934769156,CFD," 0,00 "
05/02/2025 12:56:26,Position closed,USD/JPY," 201,49 ",6000," 1,49 "," 6.396,80 "," 2.223,08 ",2934769156,CFD," 0,00 "
05/02/2025 12:56:36,Open Position,USD/JPY," 250,00 ",7500," 0,00 "," 6.396,80 "," 1.973,08 ",2934769458,CFD," 0,00 "
05/02/2025 13:12:27,Position closed,USD/JPY," 251,28 ",7500," 1,28 "," 6.398,08 "," 2.224,36 ",2934769458,CFD," 0,00 "
05/02/2025 13:12:47,Open Position,USD/JPY," 250,00 ",7500," 0,00 "," 6.398,08 "," 1.974,36 ",2934774958,CFD," 0,00 "
05/02/2025 13:14:07,Position closed,USD/JPY," 249,31 ",7500,"(0,69)"," 6.397,39 "," 2.223,67 ",2934774958,CFD," 0,00 "
05/02/2025 13:16:05,Position closed,USD/JPY," 150,71 ",4500," 0,71 "," 6.398,10 "," 2.374,38 ",2934666272,CFD," 0,00 "
05/02/2025 13:22:02,Position closed,USD/JPY," 146,71 ",4500,"(3,29)"," 6.394,81 "," 2.521,09 ",2934652104,CFD," 0,00 "
05/02/2025 13:22:29,Open Position,USD/JPY," 200,00 ",6000," 0,00 "," 6.394,81 "," 2.321,09 ",2934777210,CFD," 0,00 "
05/02/2025 13:23:22,Open Position,USD/JPY," 120,00 ",3600," 0,00 "," 6.394,81 "," 2.201,09 ",2934777375,CFD," 0,00 "
05/02/2025 13:27:23,Position closed,USD/JPY," 117,58 ",3600,"(2,42)"," 6.392,39 "," 2.318,67 ",2934777375,CFD," 0,00 "
05/02/2025 13:27:30,Position closed,USD/JPY," 203,65 ",6000," 3,65 "," 6.396,04 "," 2.522,32 ",2934777210,CFD," 0,00 "
05/02/2025 13:28:11,Open Position,USD/JPY," 250,00 ",7500," 0,00 "," 6.396,04 "," 2.272,32 ",2934779090,CFD," 0,00 "
05/02/2025 13:29:38,Open Position,USD/JPY," 249,99 ",7500," 0,00 "," 6.396,04 "," 2.022,33 ",2934779406,CFD," 0,00 "
05/02/2025 13:40:05,Open Position,USD/JPY," 199,99 ",6000," 0,00 "," 6.396,04 "," 1.822,34 ",2934782775,CFD," 0,00 "
05/02/2025 13:41:34,Position closed,USD/JPY," 246,72 ",7500,"(3,28)"," 6.392,76 "," 2.069,06 ",2934779090,CFD," 0,00 "
05/02/2025 13:41:39,Position closed,USD/JPY," 252,54 ",7500," 2,55 "," 6.395,31 "," 2.321,60 ",2934779406,CFD," 0,00 "
05/02/2025 13:41:43,Position closed,USD/JPY," 201,52 ",6000," 1,53 "," 6.396,84 "," 2.523,12 ",2934782775,CFD," 0,00 "
05/02/2025 13:42:02,Open Position,USD/JPY," 299,99 ",9000," 0,00 "," 6.396,84 "," 2.223,13 ",2934783306,CFD," 0,00 "
05/02/2025 13:53:10,Position closed,USD/JPY," 301,58 ",9000," 1,59 "," 6.398,43 "," 2.524,71 ",2934783306,CFD," 0,00 "
05/02/2025 13:53:20,Open Position,USD/JPY," 249,99 ",7500," 0,00 "," 6.398,43 "," 2.274,72 ",2934787069,CFD," 0,00 "
05/02/2025 14:00:43,Position closed,USD/JPY," 250,87 ",7500," 0,88 "," 6.399,31 "," 2.525,59 ",2934787069,CFD," 0,00 "
05/02/2025 14:00:59,Open Position,USD/JPY," 249,99 ",7500," 0,00 "," 6.399,31 "," 2.275,60 ",2934789065,CFD," 0,00 "
05/02/2025 14:01:14,Position closed,USD/JPY," 250,58 ",7500," 0,59 "," 6.399,90 "," 2.526,18 ",2934789065,CFD," 0,00 "
05/02/2025 14:01:22,Open Position,USD/JPY," 299,99 ",9000," 0,00 "," 6.399,90 "," 2.226,19 ",2934789180,CFD," 0,00 "
05/02/2025 14:25:23,Position closed,NSDQ100/USD," 251,69 ",0.233351," 1,70 "," 6.401,60 "," 2.477,88 ",2934649207,CFD," 0,00 "
05/02/2025 14:25:43,Open Position,NSDQ100/USD," 249,99 ",0.233207," 0,00 "," 6.401,60 "," 2.227,89 ",2934805203,CFD," 0,00 "
05/02/2025 14:28:33,Position closed,NSDQ100/USD," 251,16 ",0.233207," 1,17 "," 6.402,77 "," 2.479,05 ",2934805203,CFD," 0,00 "
05/02/2025 14:28:48,Open Position,NSDQ100/USD," 199,99 ",0.186487," 0,00 "," 6.402,77 "," 2.279,06 ",2934806009,CFD," 0,00 "
05/02/2025 14:29:13,Open Position,USD/JPY," 99,94 ",6000," 0,00 "," 6.402,77 "," 2.079,07 ",2934806166,CFD," 0,00 "
05/02/2025 14:31:57,Position closed,NVDA.EXT/USD," 100,03 ",3.244089,"(21,43)"," 6.381,34 "," 2.179,10 ",2934909667,CFD," 0,00 "
05/02/2025 14:32:19,Position closed,USD/JPY," 97,95 ",3001.654809,"(2,10)"," 6.379,24 "," 2.277,05 ",2934910531,CFD," 0,00 "
05/02/2025 14:38:46,Position closed,NSDQ100/USD," 202,70 ",0.186487," 2,71 "," 6.381,95 "," 2.479,75 ",2934806009,CFD," 0,00 "
05/02/2025 14:38:54,Open Position,NSDQ100/USD," 249,99 ",0.232874," 0,00 "," 6.381,95 "," 2.229,76 ",2934943959,CFD," 0,00 "
05/02/2025 14:55:02,Open Position,USD/JPY," 100,05 ",6000," 0,00 "," 6.381,95 "," 2.029,77 ",2935117046,CFD," 0,00 "
05/02/2025 15:00:51,Edit Stop Loss,-,"(12,07)",-," 0,00 "," 6.381,95 "," 2.017,70 ",2934085495,-," 0,00 "
05/02/2025 15:00:56,Position closed,USD/JPY," 357,46 ",10476.386184," 8,25 "," 6.390,20 "," 2.375,16 ",2934692191,CFD," 0,00 "
05/02/2025 15:01:15,Edit Stop Loss,-,"(14,08)",-," 0,00 "," 6.390,20 "," 2.361,08 ",2934171930,-," 0,00 "
05/02/2025 15:01:23,Edit Stop Loss,-,"(21,20)",-," 0,00 "," 6.390,20 "," 2.339,88 ",2934171930,-," 0,00 "
05/02/2025 15:01:34,Edit Stop Loss,-,"(18,17)",-," 0,00 "," 6.390,20 "," 2.321,71 ",2934085495,-," 0,00 "
05/02/2025 15:01:47,Edit Stop Loss,-,"(27,43)",-," 0,00 "," 6.390,20 "," 2.294,28 ",2934269338,-," 0,00 "
05/02/2025 15:02:01,Edit Stop Loss,-,"(19,60)",-," 0,00 "," 6.390,20 "," 2.274,68 ",2934327676,-," 0,00 "
05/02/2025 15:02:04,Position closed,USD/JPY," 25,00 ",1500,"(30,00)"," 6.360,20 "," 2.299,68 ",2933453282,CFD," 0,00 "
05/02/2025 15:02:20,Edit Stop Loss,-,"(26,02)",-," 0,00 "," 6.360,20 "," 2.273,66 ",2934532777,-," 0,00 "
05/02/2025 15:02:56,Open Position,USD/JPY," 250,00 ",7500," 0,00 "," 6.360,20 "," 2.023,66 ",2935149131,CFD," 0,00 "
05/02/2025 15:03:25,Position closed,USD/JPY," 250,49 ",7500," 0,49 "," 6.360,69 "," 2.274,15 ",2935149131,CFD," 0,00 "
05/02/2025 15:03:31,Open Position,USD/JPY," 245,91 ",14700," 0,00 "," 6.360,69 "," 1.784,16 ",2935151091,CFD," 0,00 "
05/02/2025 15:04:48,Open Position,USD/JPY," 299,99 ",9000," 0,00 "," 6.360,69 "," 1.484,17 ",2935166002,CFD," 0,00 "
05/02/2025 15:05:22,Edit Stop Loss,-,"(18,25)",-," 0,00 "," 6.360,69 "," 1.465,92 ",2934085495,-," 0,00 "
05/02/2025 15:05:27,Edit Stop Loss,-,"(21,28)",-," 0,00 "," 6.360,69 "," 1.444,64 ",2934171930,-," 0,00 "
05/02/2025 15:05:33,Edit Stop Loss,-,"(15,18)",-," 0,00 "," 6.360,69 "," 1.429,46 ",2934269338,-," 0,00 "
05/02/2025 15:05:40,Edit Stop Loss,-,"(12,15)",-," 0,00 "," 6.360,69 "," 1.417,31 ",2934327676,-," 0,00 "
05/02/2025 15:05:46,Edit Stop Loss,-,"(18,21)",-," 0,00 "," 6.360,69 "," 1.399,10 ",2934532777,-," 0,00 "
05/02/2025 15:05:55,Edit Stop Loss,-,"(23,89)",-," 0,00 "," 6.360,69 "," 1.375,21 ",2934536312,-," 0,00 "
05/02/2025 15:05:59,Edit Stop Loss,-,"(9,48)",-," 0,00 "," 6.360,69 "," 1.365,73 ",2934538698,-," 0,00 "
05/02/2025 15:06:30,Position closed,USD/JPY," 302,71 ",9000," 2,72 "," 6.363,41 "," 1.668,44 ",2935166002,CFD," 0,00 "
05/02/2025 15:06:39,Open Position,USD/JPY," 299,99 ",9000," 0,00 "," 6.363,41 "," 1.368,45 ",2935192739,CFD," 0,00 "
05/02/2025 15:07:15,Position closed,USD/JPY," 300,93 ",9000," 0,94 "," 6.364,35 "," 1.669,38 ",2935192739,CFD," 0,00 "
05/02/2025 15:07:24,Open Position,USD/JPY," 249,63 ",15000," 0,00 "," 6.364,35 "," 1.169,39 ",2935194152,CFD," 0,00 "
05/02/2025 15:11:32,Position closed,USD/JPY," 244,37 ",7322.509641," 0,29 "," 6.364,64 "," 1.413,76 ",2935203923,CFD," 0,00 "
05/02/2025 15:11:53,Open Position,USD/JPY," 124,95 ",7500," 0,00 "," 6.364,64 "," 1.163,77 ",2935204501,CFD," 0,00 "
05/02/2025 15:16:37,Position closed,USD/JPY," 251,82 ",7377.490359," 5,91 "," 6.370,55 "," 1.415,59 ",2935151091,CFD," 0,00 "
05/02/2025 15:16:50,Open Position,USD/JPY," 200,00 ",6000," 0,00 "," 6.370,55 "," 1.215,59 ",2935216459,CFD," 0,00 "
05/02/2025 15:17:35,Position closed,USD/JPY," 202,01 ",6000," 2,01 "," 6.372,56 "," 1.417,60 ",2935216459,CFD," 0,00 "
05/02/2025 15:17:44,Open Position,USD/JPY," 250,00 ",7500," 0,00 "," 6.372,56 "," 1.167,60 ",2935220754,CFD," 0,00 "
05/02/2025 15:22:39,Open Position,USD/JPY," 250,00 ",7500," 0,00 "," 6.372,56 "," 917,60 ",2935231028,CFD," 0,00 "
05/02/2025 15:22:58,Position closed,USD/JPY," 123,00 ",3751.377511,"(2,04)"," 6.370,52 "," 1.040,60 ",2935231527,CFD," 0,00 "
05/02/2025 15:25:08,Open Position,USD/JPY," 489,99 ",14700," 0,00 "," 6.370,52 "," 550,61 ",2935235127,CFD," 0,00 "
05/02/2025 15:26:05,Position closed,USD/JPY," 251,92 ",7500," 1,92 "," 6.372,44 "," 802,53 ",2935231028,CFD," 0,00 "
05/02/2025 15:26:18,Open Position,USD/JPY," 260,00 ",7800," 0,00 "," 6.372,44 "," 542,53 ",2935236636,CFD," 0,00 "
05/02/2025 15:26:25,Position closed,USD/JPY," 491,05 ",14700," 1,06 "," 6.373,50 "," 1.033,58 ",2935235127,CFD," 0,00 "
05/02/2025 15:26:48,Open Position,USD/JPY," 299,99 ",9000," 0,00 "," 6.373,50 "," 733,59 ",2935237360,CFD," 0,00 "
05/02/2025 15:27:09,Position closed,USD/JPY," 300,94 ",9000," 0,95 "," 6.374,45 "," 1.034,53 ",2935237360,CFD," 0,00 "
05/02/2025 15:29:18,Position closed,USD/JPY," 262,20 ",7800," 2,20 "," 6.376,65 "," 1.296,73 ",2935236636,CFD," 0,00 "
05/02/2025 15:29:30,Open Position,USD/JPY," 250,00 ",7500," 0,00 "," 6.376,65 "," 1.046,73 ",2935242418,CFD," 0,00 "
05/02/2025 15:30:36,Position closed,USD/JPY," 252,17 ",7500," 2,17 "," 6.378,82 "," 1.298,90 ",2935242418,CFD," 0,00 "
05/02/2025 15:30:47,Open Position,USD/JPY," 479,99 ",14400," 0,00 "," 6.378,82 "," 818,91 ",2935244047,CFD," 0,00 "
05/02/2025 15:36:51,Open Position,USD/JPY," 260,00 ",7800," 0,00 "," 6.378,82 "," 558,91 ",2935253328,CFD," 0,00 "
05/02/2025 15:44:26,Position closed,USD/JPY," 264,51 ",7800," 4,51 "," 6.383,33 "," 823,42 ",2935253328,CFD," 0,00 "
05/02/2025 15:44:47,Open Position,USD/JPY," 300,00 ",9000," 0,00 "," 6.383,33 "," 523,42 ",2935263170,CFD," 0,00 "
05/02/2025 15:45:13,Position closed,NSDQ100/USD," 254,01 ",0.232874," 4,02 "," 6.387,35 "," 777,43 ",2934943959,CFD," 0,00 "
05/02/2025 15:45:29,Open Position,USD/JPY," 200,00 ",6000," 0,00 "," 6.387,35 "," 577,43 ",2935264286,CFD," 0,00 "
05/02/2025 15:46:37,Position closed,USD/JPY," 122,49 ",3748.622489,"(2,46)"," 6.384,89 "," 699,92 ",2935204501,CFD," 0,00 "
05/02/2025 15:46:48,Open Position,USD/JPY," 149,99 ",4500," 0,00 "," 6.384,89 "," 549,93 ",2935265570,CFD," 0,00 "
05/02/2025 15:47:18,Open Position,USD/JPY," 119,99 ",3600," 0,00 "," 6.384,89 "," 429,94 ",2935266487,CFD," 0,00 "
05/02/2025 15:49:47,Open Position,USD/JPY," 200,00 ",6000," 0,00 "," 6.384,89 "," 229,94 ",2935269015,CFD," 0,00 "
05/02/2025 15:53:34,Position closed,USD/JPY," 201,46 ",6000," 1,46 "," 6.386,35 "," 431,40 ",2935269015,CFD," 0,00 "
05/02/2025 15:54:23,Position closed,USD/JPY," 237,63 ",7511.030837,"(12,73)"," 6.373,62 "," 669,03 ",2935276284,CFD," 0,00 "
05/02/2025 15:54:32,Open Position,USD/JPY," 489,99 ",14700," 0,00 "," 6.373,62 "," 179,04 ",2935276528,CFD," 0,00 "
05/02/2025 15:54:36,Position closed,USD/JPY," 121,29 ",3600," 1,30 "," 6.374,92 "," 300,33 ",2935266487,CFD," 0,00 "
05/02/2025 15:55:16,Position closed,USD/JPY," 490,86 ",14700," 0,87 "," 6.375,79 "," 791,19 ",2935276528,CFD," 0,00 "
05/02/2025 15:55:32,Open Position,USD/JPY," 300,00 ",9000," 0,00 "," 6.375,79 "," 491,19 ",2935277697,CFD," 0,00 "
05/02/2025 15:55:37,Position closed,USD/JPY," 151,05 ",4500," 1,06 "," 6.376,85 "," 642,24 ",2935265570,CFD," 0,00 "
05/02/2025 15:57:41,Position closed,USD/JPY," 303,96 ",9000," 3,96 "," 6.380,81 "," 946,20 ",2935277697,CFD," 0,00 "
05/02/2025 15:57:47,Position closed,USD/JPY," 203,15 ",6000," 3,15 "," 6.383,96 "," 1.149,35 ",2935264286,CFD," 0,00 "
05/02/2025 15:57:59,Open Position,USD/JPY," 300,00 ",9000," 0,00 "," 6.383,96 "," 849,35 ",2935281041,CFD," 0,00 "
05/02/2025 15:58:03,Position closed,USD/JPY," 303,85 ",9000," 3,85 "," 6.387,81 "," 1.153,20 ",2935263170,CFD," 0,00 "
05/02/2025 15:58:10,Position closed,USD/JPY," 483,02 ",14400," 3,03 "," 6.390,84 "," 1.636,22 ",2935244047,CFD," 0,00 "
05/02/2025 15:58:16,Position closed,USD/JPY," 251,18 ",7500," 1,18 "," 6.392,02 "," 1.887,40 ",2935220754,CFD," 0,00 "
05/02/2025 15:58:26,Open Position,USD/JPY," 350,00 ",10500," 0,00 "," 6.392,02 "," 1.537,40 ",2935281468,CFD," 0,00 "
05/02/2025 15:59:15,Open Position,USD/JPY," 499,99 ",15000," 0,00 "," 6.392,02 "," 1.037,41 ",2935284820,CFD," 0,00 "
05/02/2025 15:59:46,Position closed,USD/JPY," 501,57 ",15000," 1,58 "," 6.393,60 "," 1.538,98 ",2935284820,CFD," 0,00 "
05/02/2025 15:59:57,Open Position,USD/JPY," 300,00 ",9000," 0,00 "," 6.393,60 "," 1.238,98 ",2935286037,CFD," 0,00 "
05/02/2025 16:01:08,Open Position,USD/JPY," 499,99 ",15000," 0,00 "," 6.393,60 "," 738,99 ",2935287399,CFD," 0,00 "
05/02/2025 16:03:13,Position closed,USD/JPY," 233,04 ",7488.969163,"(16,59)"," 6.377,01 "," 972,03 ",2935194152,CFD," 0,00 "
05/02/2025 16:03:31,Open Position,USD/JPY," 350,00 ",10500," 0,00 "," 6.377,01 "," 622,03 ",2935293281,CFD," 0,00 "
05/02/2025 16:10:17,Open Position,USD/JPY," 489,99 ",14700," 0,00 "," 6.377,01 "," 132,04 ",2935304235,CFD," 0,00 "
05/02/2025 16:21:37,Position closed,USD/JPY," 490,47 ",14700," 0,48 "," 6.377,49 "," 622,51 ",2935304235,CFD," 0,00 "
05/02/2025 16:23:15,Open Position,USD/JPY," 200,00 ",6000," 0,00 "," 6.377,49 "," 422,51 ",2935322932,CFD," 0,00 "
05/02/2025 16:31:26,Position closed,USD/JPY," 201,14 ",6000," 1,14 "," 6.378,63 "," 623,65 ",2935322932,CFD," 0,00 "
05/02/2025 16:32:28,Open Position,USD/JPY," 250,00 ",7500," 0,00 "," 6.378,63 "," 373,65 ",2935334796,CFD," 0,00 "
05/02/2025 16:35:53,Position closed,USD/JPY," 251,82 ",7500," 1,82 "," 6.380,45 "," 625,47 ",2935334796,CFD," 0,00 "
05/02/2025 16:36:48,Open Position,USD/JPY," 300,00 ",9000," 0,00 "," 6.380,45 "," 325,47 ",2935341892,CFD," 0,00 "
05/02/2025 16:38:24,Position closed,USD/JPY," 300,06 ",9000," 0,06 "," 6.380,51 "," 625,53 ",2935341892,CFD," 0,00 "
05/02/2025 16:42:46,Open Position,USD/JPY," 350,00 ",10500," 0,00 "," 6.380,51 "," 275,53 ",2935349074,CFD," 0,00 "
05/02/2025 16:49:59,Position closed,NSDQ100/USD," 175,72 ",0.162564," 0,41 "," 6.380,92 "," 451,25 ",2934188464,CFD," 0,00 "
05/02/2025 16:50:12,Position closed,NSDQ100/USD," 151,83 ",0.139081," 1,88 "," 6.382,80 "," 603,08 ",2934188767,CFD," 0,00 "
05/02/2025 16:53:05,Open Position,NSDQ100/USD," 99,99 ",0.092605," 0,00 "," 6.382,80 "," 503,09 ",2935362783,CFD," 0,00 "
05/02/2025 16:54:25,Open Position,USD/JPY," 300,00 ",9000," 0,00 "," 6.382,80 "," 203,09 ",2935366307,CFD," 0,00 "
05/02/2025 17:00:57,Position closed,NSDQ100/USD," 101,96 ",0.092605," 1,97 "," 6.384,77 "," 305,05 ",2935362783,CFD," 0,00 "
05/02/2025 17:01:40,Open Position,NSDQ100/USD," 99,99 ",0.092505," 0,00 "," 6.384,77 "," 205,06 ",2935373463,CFD," 0,00 "
05/02/2025 17:02:02,Position closed,USD/JPY," 302,78 ",9000," 2,78 "," 6.387,55 "," 507,84 ",2935366307,CFD," 0,00 "
05/02/2025 17:02:18,Position closed,USD/JPY," 351,24 ",10500," 1,24 "," 6.388,79 "," 859,08 ",2935349074,CFD," 0,00 "
05/02/2025 17:02:30,Open Position,USD/JPY," 499,99 ",15000," 0,00 "," 6.388,79 "," 359,09 ",2935374424,CFD," 0,00 "
05/02/2025 17:12:40,Position closed,NSDQ100/USD," 100,04 ",0.092505," 0,05 "," 6.388,84 "," 459,13 ",2935373463,CFD," 0,00 "
05/02/2025 17:23:58,Position closed,USD/JPY," 91,26 ",2998.215225,"(8,68)"," 6.380,16 "," 550,39 ",2935434440,CFD," 0,00 "
05/02/2025 17:24:07,Open Position,USD/JPY," 250,00 ",7500," 0,00 "," 6.380,16 "," 300,39 ",2935434598,CFD," 0,00 "
05/02/2025 17:37:54,Position closed,USD/JPY," 251,28 ",7500," 1,28 "," 6.381,44 "," 551,67 ",2935434598,CFD," 0,00 "
05/02/2025 17:38:26,Open Position,USD/JPY," 300,00 ",9000," 0,00 "," 6.381,44 "," 251,67 ",2935448212,CFD," 0,00 "
05/02/2025 17:48:17,Position closed,USD/JPY," 301,42 ",9000," 1,42 "," 6.382,86 "," 553,09 ",2935448212,CFD," 0,00 "
05/02/2025 17:54:28,Position closed,USD/JPY," 501,57 ",15000," 1,58 "," 6.384,44 "," 1.054,66 ",2935374424,CFD," 0,00 "
05/02/2025 17:54:45,Open Position,USD/JPY," 499,99 ",15000," 0,00 "," 6.384,44 "," 554,67 ",2935461138,CFD," 0,00 "
05/02/2025 19:06:14,Position closed,USD/JPY," 489,16 ",15000,"(10,83)"," 6.373,61 "," 1.043,83 ",2935461138,CFD," 0,00 "
05/02/2025 19:25:32,Open Position,USD/JPY," 250,00 ",7500," 0,00 "," 6.373,61 "," 793,83 ",2935534827,CFD," 0,00 "
05/02/2025 19:50:39,Position closed,USD/JPY," 244,64 ",7500,"(5,36)"," 6.368,25 "," 1.038,47 ",2935534827,CFD," 0,00 "
05/02/2025 20:52:11,Position closed,USD/JPY," 97,85 ",3001.784775,"(2,20)"," 6.366,05 "," 1.136,32 ",2935117046,CFD," 0,00 "
05/02/2025 21:21:54,Position closed,USD/JPY," 92,22 ",2998.345191,"(7,72)"," 6.358,33 "," 1.228,54 ",2934806166,CFD," 0,00 "
05/02/2025 21:22:20,Open Position,USD/JPY," 220,00 ",6600," 0,00 "," 6.358,33 "," 1.008,54 ",2935626818,CFD," 0,00 "
05/02/2025 22:45:59,Position closed,USD/JPY," 222,55 ",6600," 2,55 "," 6.360,88 "," 1.231,09 ",2935626818,CFD," 0,00 "
06/02/2025 00:33:23,Open Position,USD/JPY," 149,99 ",4500," 0,00 "," 6.360,88 "," 1.081,10 ",2935642401,CFD," 0,00 "
06/02/2025 00:47:58,Weekend refund,Weekend Fee," 2,52 ",-," 2,52 "," 6.363,40 "," 1.083,62 ",2934171930,CFD," 0,00 "
06/02/2025 00:47:58,Weekend refund,Weekend Fee," 2,16 ",-," 2,16 "," 6.365,56 "," 1.085,78 ",2934532777,CFD," 0,00 "
06/02/2025 00:47:58,Weekend refund,Weekend Fee," 2,16 ",-," 2,16 "," 6.367,72 "," 1.087,94 ",2934085495,CFD," 0,00 "
06/02/2025 00:47:58,Weekend refund,Weekend Fee," 2,16 ",-," 2,16 "," 6.369,88 "," 1.090,10 ",2934789180,CFD," 0,00 "
06/02/2025 00:47:58,Weekend refund,Weekend Fee," 1,80 ",-," 1,80 "," 6.371,68 "," 1.091,90 ",2934269338,CFD," 0,00 "
06/02/2025 00:47:58,Weekend refund,Weekend Fee," 1,44 ",-," 1,44 "," 6.373,12 "," 1.093,34 ",2934327676,CFD," 0,00 "
06/02/2025 00:47:58,Weekend refund,Weekend Fee," 1,44 ",-," 1,44 "," 6.374,56 "," 1.094,78 ",2934565546,CFD," 0,00 "
06/02/2025 00:47:58,Weekend refund,Weekend Fee," 1,44 ",-," 1,44 "," 6.376,00 "," 1.096,22 ",2934536312,CFD," 0,00 "
06/02/2025 00:47:58,Weekend refund,Weekend Fee," 1,44 ",-," 1,44 "," 6.377,44 "," 1.097,66 ",2934538698,CFD," 0,00 "
06/02/2025 00:47:58,Overnight fee,Daily,"(0,22)",-,"(0,22)"," 6.377,22 "," 1.097,44 ",2927862904,CFD," 0,00 "
06/02/2025 00:47:58,Overnight fee,Weekend Fee,"(3,12)",-,"(3,12)"," 6.374,10 "," 1.094,32 ",2935626818,CFD," 0,00 "
06/02/2025 00:47:58,Overnight fee,Weekend Fee,"(4,26)",-,"(4,26)"," 6.369,84 "," 1.090,06 ",2935286037,CFD," 0,00 "
06/02/2025 00:47:58,Overnight fee,Weekend Fee,"(4,26)",-,"(4,26)"," 6.365,58 "," 1.085,80 ",2935281041,CFD," 0,00 "
06/02/2025 00:47:58,Overnight fee,Weekend Fee,"(4,97)",-,"(4,97)"," 6.360,61 "," 1.080,83 ",2935293281,CFD," 0,00 "
06/02/2025 00:47:58,Overnight fee,Weekend Fee,"(4,97)",-,"(4,97)"," 6.355,64 "," 1.075,86 ",2935281468,CFD," 0,00 "
06/02/2025 00:47:58,Overnight fee,Weekend Fee,"(7,10)",-,"(7,10)"," 6.348,54 "," 1.068,76 ",2935287399,CFD," 0,00 "
06/02/2025 08:05:20,Open Position,USD/JPY," 300,00 ",9000," 0,00 "," 6.348,54 "," 768,76 ",2935701018,CFD," 0,00 "
06/02/2025 08:05:42,Position closed,USD/JPY," 162,57 ",6000,"(37,42)"," 6.311,12 "," 931,33 ",2934565546,CFD," 0,00 "
06/02/2025 08:05:57,Open Position,USD/JPY," 250,00 ",7500," 0,00 "," 6.311,12 "," 681,33 ",2935701174,CFD," 0,00 "
06/02/2025 08:14:18,Position closed,USD/JPY," 264,18 ",9000,"(35,81)"," 6.275,31 "," 945,51 ",2934789180,CFD," 0,00 "
06/02/2025 08:17:06,Open Position,USD/JPY," 499,99 ",15000," 0,00 "," 6.275,31 "," 445,52 ",2935714989,CFD," 0,00 "
06/02/2025 08:25:04,Open Position,USD/JPY," 249,99 ",7500," 0,00 "," 6.275,31 "," 195,53 ",2935729170,CFD," 0,00 "
06/02/2025 08:29:43,Position closed,USD/JPY," 253,23 ",7500," 3,24 "," 6.278,55 "," 448,76 ",2935729170,CFD," 0,00 "
06/02/2025 08:29:57,Open Position,USD/JPY," 149,97 ",9000," 0,00 "," 6.278,55 "," 148,77 ",2935731244,CFD," 0,00 "
06/02/2025 08:41:13,Position closed,USD/JPY," 148,96 ",4500.795508,"(1,06)"," 6.277,49 "," 297,73 ",2935737200,CFD," 0,00 "
06/02/2025 09:10:27,Open Position,NSDQ100/USD," 99,99 ",0.092072," 0,00 "," 6.277,49 "," 197,74 ",2935745541,CFD," 0,00 "
06/02/2025 09:14:38,Position closed,USD/JPY," 152,15 ",4499.204492," 2,18 "," 6.279,67 "," 349,89 ",2935731244,CFD," 0,00 "
06/02/2025 09:15:03,Open Position,USD/JPY," 199,99 ",6000," 0,00 "," 6.279,67 "," 149,90 ",2935746727,CFD," 0,00 "
06/02/2025 09:17:47,Position closed,USD/JPY," 202,31 ",6000," 2,32 "," 6.281,99 "," 352,21 ",2935746727,CFD," 0,00 "
06/02/2025 09:18:01,Open Position,USD/JPY," 249,99 ",7500," 0,00 "," 6.281,99 "," 102,22 ",2935747520,CFD," 0,00 "
06/02/2025 09:18:08,Position closed,NSDQ100/USD," 99,46 ",0.092072,"(0,53)"," 6.281,46 "," 201,68 ",2935745541,CFD," 0,00 "
06/02/2025 09:21:29,Position closed,USD/JPY," 250,97 ",7500," 0,98 "," 6.282,44 "," 452,65 ",2935747520,CFD," 0,00 "
06/02/2025 09:21:39,Open Position,USD/JPY," 99,94 ",6000," 0,00 "," 6.282,44 "," 252,66 ",2935748452,CFD," 0,00 "
06/02/2025 09:28:52,Position closed,USD/JPY," 98,52 ",3001.733844,"(1,53)"," 6.280,91 "," 351,18 ",2935749990,CFD," 0,00 "
06/02/2025 09:29:01,Open Position,USD/JPY," 99,99 ",3000," 0,00 "," 6.280,91 "," 251,19 ",2935750030,CFD," 0,00 "
06/02/2025 09:34:21,Position closed,USD/JPY," 100,91 ",3000," 0,92 "," 6.281,83 "," 352,10 ",2935750030,CFD," 0,00 "
06/02/2025 09:34:32,Open Position,USD/JPY," 99,99 ",3000," 0,00 "," 6.281,83 "," 252,11 ",2935751055,CFD," 0,00 "
06/02/2025 09:53:44,Position closed,USD/JPY," 101,54 ",3000," 1,55 "," 6.283,38 "," 353,65 ",2935751055,CFD," 0,00 "
06/02/2025 09:53:56,Open Position,USD/JPY," 200,00 ",6000," 0,00 "," 6.283,38 "," 153,65 ",2935759572,CFD," 0,00 "
06/02/2025 10:04:49,Position closed,USD/JPY," 201,45 ",6000," 1,45 "," 6.284,83 "," 355,10 ",2935759572,CFD," 0,00 "
06/02/2025 10:04:57,Open Position,USD/JPY," 149,99 ",4500," 0,00 "," 6.284,83 "," 205,11 ",2935762607,CFD," 0,00 "
06/02/2025 10:54:48,Position closed,USD/JPY," 503,53 ",15000," 3,54 "," 6.288,37 "," 708,64 ",2935714989,CFD," 0,00 "
06/02/2025 10:55:03,Position closed,USD/JPY," 151,70 ",4500," 1,71 "," 6.290,08 "," 860,34 ",2935762607,CFD," 0,00 "
06/02/2025 10:55:26,Open Position,USD/JPY," 300,00 ",9000," 0,00 "," 6.290,08 "," 560,34 ",2935779622,CFD," 0,00 "
06/02/2025 11:03:32,Position closed,USD/JPY," 152,74 ",6000,"(56,73)"," 6.233,35 "," 713,08 ",2934538698,CFD," 0,00 "
06/02/2025 11:03:41,Open Position,USD/JPY," 200,00 ",6000," 0,00 "," 6.233,35 "," 513,08 ",2935781962,CFD," 0,00 "
06/02/2025 11:05:26,Position closed,USD/JPY," 200,90 ",6000," 0,90 "," 6.234,25 "," 713,98 ",2935781962,CFD," 0,00 "
06/02/2025 11:07:13,Position closed,USD/JPY," 302,77 ",9000," 2,77 "," 6.237,02 "," 1.016,75 ",2935779622,CFD," 0,00 "
06/02/2025 11:07:23,Position closed,USD/JPY," 151,02 ",4500," 1,03 "," 6.238,05 "," 1.167,77 ",2935642401,CFD," 0,00 "
06/02/2025 11:07:28,Position closed,USD/JPY," 301,48 ",9000," 1,48 "," 6.239,53 "," 1.469,25 ",2935701018,CFD," 0,00 "
06/02/2025 11:07:34,Open Position,USD/JPY," 499,99 ",15000," 0,00 "," 6.239,53 "," 969,26 ",2935782690,CFD," 0,00 "
06/02/2025 11:08:02,Open Position,USD/JPY," 200,00 ",6000," 0,00 "," 6.239,53 "," 769,26 ",2935782776,CFD," 0,00 "
06/02/2025 11:16:12,Open Position,NSDQ100/USD," 249,99 ",0.230927," 0,00 "," 6.239,53 "," 519,27 ",2935784493,CFD," 0,00 "
06/02/2025 11:26:26,Position closed,USD/JPY," 501,86 ",15000," 1,87 "," 6.241,40 "," 1.021,13 ",2935782690,CFD," 0,00 "
06/02/2025 11:27:16,Open Position,USD/JPY," 300,00 ",9000," 0,00 "," 6.241,40 "," 721,13 ",2935786602,CFD," 0,00 "
06/02/2025 11:29:55,Position closed,USD/JPY," 251,87 ",7500," 1,87 "," 6.243,27 "," 973,00 ",2935701174,CFD," 0,00 "
06/02/2025 11:30:00,Position closed,USD/JPY," 201,50 ",6000," 1,50 "," 6.244,77 "," 1.174,50 ",2935782776,CFD," 0,00 "
06/02/2025 11:30:58,Open Position,USD/JPY," 300,00 ",9000," 0,00 "," 6.244,77 "," 874,50 ",2935787803,CFD," 0,00 "
06/02/2025 11:33:37,Position closed,USD/JPY," 300,18 ",9000," 0,18 "," 6.244,95 "," 1.174,68 ",2935786602,CFD," 0,00 "
06/02/2025 11:44:47,Position closed,USD/JPY," 301,77 ",9000," 1,77 "," 6.246,72 "," 1.476,45 ",2935787803,CFD," 0,00 "
06/02/2025 11:44:57,Open Position,USD/JPY," 499,99 ",15000," 0,00 "," 6.246,72 "," 976,46 ",2935799540,CFD," 0,00 "
06/02/2025 11:46:03,Position closed,USD/JPY," 500,38 ",15000," 0,39 "," 6.247,11 "," 1.476,84 ",2935799540,CFD," 0,00 "
06/02/2025 11:46:09,Open Position,USD/JPY," 499,99 ",15000," 0,00 "," 6.247,11 "," 976,85 ",2935799839,CFD," 0,00 "
06/02/2025 11:52:59,Position closed,NVDA.EXT/USD," 111,31 ",3.238543,"(9,95)"," 6.237,16 "," 1.088,16 ",2935805170,CFD," 0,00 "
06/02/2025 12:04:11,Position closed,USD/JPY," 503,04 ",15000," 3,05 "," 6.240,21 "," 1.591,20 ",2935799839,CFD," 0,00 "
06/02/2025 12:04:18,Open Position,USD/JPY," 499,99 ",15000," 0,00 "," 6.240,21 "," 1.091,21 ",2935807930,CFD," 0,00 "
06/02/2025 12:21:10,Open Position,USD/JPY," 200,00 ",6000," 0,00 "," 6.240,21 "," 891,21 ",2935811955,CFD," 0,00 "
06/02/2025 12:32:28,Position closed,USD/JPY," 202,09 ",6000," 2,09 "," 6.242,30 "," 1.093,30 ",2935811955,CFD," 0,00 "
06/02/2025 12:54:39,Open Position,USD/JPY," 300,00 ",9000," 0,00 "," 6.242,30 "," 793,30 ",2935823025,CFD," 0,00 "
06/02/2025 12:55:21,Position closed,NSDQ100/USD," 251,09 ",0.230927," 1,10 "," 6.243,40 "," 1.044,39 ",2935784493,CFD," 0,00 "
06/02/2025 13:18:57,Position closed,NVDA.EXT/USD," 114,19 ",3.238745,"(7,07)"," 6.236,33 "," 1.158,58 ",2927862904,CFD," 0,00 "
06/02/2025 13:30:01,Position closed,USD/JPY," 303,60 ",9000," 3,60 "," 6.239,93 "," 1.462,18 ",2935823025,CFD," 0,00 "
06/02/2025 13:31:04,Position closed,USD/JPY," 499,79 ",15000,"(0,20)"," 6.239,73 "," 1.961,97 ",2935807930,CFD," 0,00 "
06/02/2025 13:31:16,Open Position,USD/JPY," 250,00 ",7500," 0,00 "," 6.239,73 "," 1.711,97 ",2935831317,CFD," 0,00 "
06/02/2025 13:38:01,Position closed,USD/JPY," 252,61 ",7500," 2,61 "," 6.242,34 "," 1.964,58 ",2935831317,CFD," 0,00 "
06/02/2025 13:38:14,Open Position,USD/JPY," 250,00 ",7500," 0,00 "," 6.242,34 "," 1.714,58 ",2935837127,CFD," 0,00 "
06/02/2025 13:40:25,Position closed,USD/JPY," 250,59 ",7500," 0,59 "," 6.242,93 "," 1.965,17 ",2935837127,CFD," 0,00 "
06/02/2025 13:42:04,Open Position,NSDQ100/USD," 199,98 ",0.184702," 0,00 "," 6.242,93 "," 1.765,19 ",2935838843,CFD," 0,00 "
06/02/2025 13:44:48,Open Position,USD/JPY," 299,99 ",9000," 0,00 "," 6.242,93 "," 1.465,20 ",2935839497,CFD," 0,00 "
06/02/2025 13:45:22,Open Position,USD/JPY," 249,99 ",7500," 0,00 "," 6.242,93 "," 1.215,21 ",2935839778,CFD," 0,00 "
06/02/2025 13:46:08,Open Position,USD/JPY," 499,99 ",15000," 0,00 "," 6.242,93 "," 715,22 ",2935840042,CFD," 0,00 "
06/02/2025 13:47:21,Position closed,USD/JPY," 507,19 ",15000," 7,20 "," 6.250,13 "," 1.222,41 ",2935840042,CFD," 0,00 "
06/02/2025 13:48:20,Open Position,USD/JPY," 299,99 ",9000," 0,00 "," 6.250,13 "," 922,42 ",2935843428,CFD," 0,00 "
06/02/2025 13:49:21,Open Position,USD/JPY," 249,99 ",7500," 0,00 "," 6.250,13 "," 672,43 ",2935843614,CFD," 0,00 "
06/02/2025 13:52:45,Position closed,USD/JPY," 501,37 ",15000," 1,38 "," 6.251,51 "," 1.173,80 ",2935287399,CFD," 0,00 "
06/02/2025 13:53:21,Position closed,USD/JPY," 353,31 ",10500," 3,31 "," 6.254,82 "," 1.527,11 ",2935293281,CFD," 0,00 "
06/02/2025 13:53:35,Position closed,USD/JPY," 303,02 ",9000," 3,02 "," 6.257,84 "," 1.830,13 ",2935286037,CFD," 0,00 "
06/02/2025 13:53:50,Position closed,USD/JPY," 302,72 ",9000," 2,72 "," 6.260,56 "," 2.132,85 ",2935281041,CFD," 0,00 "
06/02/2025 13:54:06,Position closed,USD/JPY," 354,42 ",10500," 4,42 "," 6.264,98 "," 2.487,27 ",2935281468,CFD," 0,00 "
06/02/2025 13:54:21,Open Position,USD/JPY," 299,99 ",9000," 0,00 "," 6.264,98 "," 2.187,28 ",2935849361,CFD," 0,00 "
06/02/2025 13:54:36,Open Position,USD/JPY," 250,00 ",7500," 0,00 "," 6.264,98 "," 1.937,28 ",2935849415,CFD," 0,00 "
06/02/2025 13:55:55,Position closed,USD/JPY," 301,29 ",9000," 1,30 "," 6.266,28 "," 2.238,57 ",2935849361,CFD," 0,00 "
06/02/2025 13:56:07,Open Position,USD/JPY," 250,00 ",7500," 0,00 "," 6.266,28 "," 1.988,57 ",2935849696,CFD," 0,00 "
06/02/2025 13:56:18,Open Position,USD/JPY," 249,99 ",7500," 0,00 "," 6.266,28 "," 1.738,58 ",2935849729,CFD," 0,00 "
06/02/2025 13:57:27,Position closed,NSDQ100/USD," 202,10 ",0.184702," 2,12 "," 6.268,40 "," 1.940,68 ",2935838843,CFD," 0,00 "
06/02/2025 13:57:44,Open Position,NSDQ100/USD," 249,99 ",0.23073," 0,00 "," 6.268,40 "," 1.690,69 ",2935850049,CFD," 0,00 "
06/02/2025 13:58:18,Position closed,USD/JPY," 251,38 ",7500," 1,38 "," 6.269,78 "," 1.942,07 ",2935849696,CFD," 0,00 "
06/02/2025 13:58:35,Open Position,USD/JPY," 200,00 ",6000," 0,00 "," 6.269,78 "," 1.742,07 ",2935850314,CFD," 0,00 "
06/02/2025 13:59:13,Open Position,USD/JPY," 249,99 ",7500," 0,00 "," 6.269,78 "," 1.492,08 ",2935850505,CFD," 0,00 "
06/02/2025 14:00:42,Position closed,USD/JPY," 250,39 ",7500," 0,39 "," 6.270,17 "," 1.742,47 ",2935849415,CFD," 0,00 "
06/02/2025 14:02:55,Position closed,USD/JPY," 252,31 ",7500," 2,32 "," 6.272,49 "," 1.994,78 ",2935850505,CFD," 0,00 "
06/02/2025 14:03:09,Open Position,USD/JPY," 199,99 ",6000," 0,00 "," 6.272,49 "," 1.794,79 ",2935851760,CFD," 0,00 "
06/02/2025 14:14:14,Position closed,USD/JPY," 300,76 ",9000," 0,77 "," 6.273,26 "," 2.095,55 ",2935843428,CFD," 0,00 "
06/02/2025 14:16:05,Position closed,USD/JPY," 251,81 ",7500," 1,82 "," 6.275,08 "," 2.347,36 ",2935849729,CFD," 0,00 "
06/02/2025 14:16:21,Position closed,USD/JPY," 202,12 ",6000," 2,13 "," 6.277,21 "," 2.549,48 ",2935851760,CFD," 0,00 "
06/02/2025 14:18:27,Open Position,USD/JPY," 299,99 ",9000," 0,00 "," 6.277,21 "," 2.249,49 ",2935858554,CFD," 0,00 "
06/02/2025 14:24:26,Position closed,USD/JPY," 304,48 ",9000," 4,49 "," 6.281,70 "," 2.553,97 ",2935858554,CFD," 0,00 "
06/02/2025 14:26:59,Open Position,USD/JPY," 249,99 ",7500," 0,00 "," 6.281,70 "," 2.303,98 ",2935864198,CFD," 0,00 "
06/02/2025 14:30:01,Position closed,USD/JPY," 202,09 ",6000," 2,09 "," 6.283,79 "," 2.506,07 ",2935850314,CFD," 0,00 "
06/02/2025 14:31:10,Open Position,USD/JPY," 299,99 ",9000," 0,00 "," 6.283,79 "," 2.206,08 ",2935946549,CFD," 0,00 "
06/02/2025 14:31:37,Open Position,USD/JPY," 200,00 ",6000," 0,00 "," 6.283,79 "," 2.006,08 ",2935958738,CFD," 0,00 "
06/02/2025 14:36:12,Position closed,USD/JPY," 201,11 ",6000," 1,11 "," 6.284,90 "," 2.207,19 ",2935958738,CFD," 0,00 "
06/02/2025 14:36:22,Open Position,USD/JPY," 200,00 ",6000," 0,00 "," 6.284,90 "," 2.007,19 ",2935976287,CFD," 0,00 "
06/02/2025 14:36:35,Open Position,USD/JPY," 199,99 ",6000," 0,00 "," 6.284,90 "," 1.807,20 ",2935976744,CFD," 0,00 "
06/02/2025 14:43:46,Position closed,USD/JPY," 201,86 ",6000," 1,86 "," 6.286,76 "," 2.009,06 ",2935976287,CFD," 0,00 "
06/02/2025 14:43:59,Open Position,USD/JPY," 200,00 ",6000," 0,00 "," 6.286,76 "," 1.809,06 ",2936003439,CFD," 0,00 "
06/02/2025 14:45:49,Position closed,NSDQ100/USD," 256,62 ",0.23073," 6,63 "," 6.293,39 "," 2.065,68 ",2935850049,CFD," 0,00 "
06/02/2025 14:46:06,Open Position,NSDQ100/USD," 200,00 ",0.184357," 0,00 "," 6.293,39 "," 1.865,68 ",2936007444,CFD," 0,00 "
06/02/2025 14:47:09,Position closed,USD/JPY," 202,08 ",6000," 2,09 "," 6.295,48 "," 2.067,76 ",2935976744,CFD," 0,00 "
06/02/2025 14:54:24,Position closed,NSDQ100/USD," 201,47 ",0.184357," 1,47 "," 6.296,95 "," 2.269,23 ",2936007444,CFD," 0,00 "
06/02/2025 14:54:33,Position closed,USD/JPY," 303,54 ",9000," 3,55 "," 6.300,50 "," 2.572,77 ",2935946549,CFD," 0,00 "
06/02/2025 14:54:54,Open Position,USD/JPY," 199,99 ",6000," 0,00 "," 6.300,50 "," 2.372,78 ",2936099794,CFD," 0,00 "
06/02/2025 14:55:29,Open Position,NSDQ100/USD," 249,99 ",0.230496," 0,00 "," 6.300,50 "," 2.122,79 ",2936101255,CFD," 0,00 "
06/02/2025 15:11:20,Position closed,NSDQ100/USD," 254,54 ",0.230496," 4,55 "," 6.305,05 "," 2.377,33 ",2936101255,CFD," 0,00 "
06/02/2025 15:11:54,Open Position,NSDQ100/USD," 259,99 ",0.239358," 0,00 "," 6.305,05 "," 2.117,34 ",2936158179,CFD," 0,00 "
06/02/2025 15:14:13,Position closed,NSDQ100/USD," 261,36 ",0.239358," 1,37 "," 6.306,42 "," 2.378,70 ",2936158179,CFD," 0,00 "
06/02/2025 15:14:28,Open Position,NSDQ100/USD," 125,07 ",0.230041," 0,00 "," 6.306,42 "," 2.128,72 ",2936163257,CFD," 0,00 "
06/02/2025 15:28:00,Open Position,USD/JPY," 199,99 ",6000," 0,00 "," 6.306,42 "," 1.928,73 ",2936197478,CFD," 0,00 "
06/02/2025 15:36:41,Position closed,USD/JPY," 203,23 ",6000," 3,24 "," 6.309,66 "," 2.131,96 ",2936197478,CFD," 0,00 "
06/02/2025 15:37:14,Open Position,USD/JPY," 200,00 ",6000," 0,00 "," 6.309,66 "," 1.931,96 ",2936213646,CFD," 0,00 "
06/02/2025 15:40:01,Position closed,USD/JPY," 200,36 ",6000," 0,36 "," 6.310,02 "," 2.132,32 ",2936003439,CFD," 0,00 "
06/02/2025 15:40:15,Position closed,USD/JPY," 209,40 ",6000," 9,40 "," 6.319,42 "," 2.341,72 ",2936213646,CFD," 0,00 "
06/02/2025 15:41:08,Open Position,USD/JPY," 489,99 ",14700," 0,00 "," 6.319,42 "," 1.851,73 ",2936221191,CFD," 0,00 "
06/02/2025 15:42:31,Open Position,USD/JPY," 200,00 ",6000," 0,00 "," 6.319,42 "," 1.651,73 ",2936223353,CFD," 0,00 "
06/02/2025 15:42:52,Edit Stop Loss,-,"(12,20)",-," 0,00 "," 6.319,42 "," 1.639,53 ",2934085495,-," 0,00 "
06/02/2025 15:43:00,Edit Stop Loss,-,"(14,23)",-," 0,00 "," 6.319,42 "," 1.625,30 ",2934171930,-," 0,00 "
06/02/2025 15:43:06,Edit Stop Loss,-,"(10,15)",-," 0,00 "," 6.319,42 "," 1.615,15 ",2934269338,-," 0,00 "
06/02/2025 15:43:12,Edit Stop Loss,-,"(8,12)",-," 0,00 "," 6.319,42 "," 1.607,03 ",2934327676,-," 0,00 "
06/02/2025 15:43:25,Edit Stop Loss,-,"(12,17)",-," 0,00 "," 6.319,42 "," 1.594,86 ",2934532777,-," 0,00 "
06/02/2025 15:43:31,Edit Stop Loss,-,"(8,11)",-," 0,00 "," 6.319,42 "," 1.586,75 ",2934536312,-," 0,00 "
06/02/2025 15:45:30,Position closed,USD/JPY," 493,47 ",14700," 3,48 "," 6.322,90 "," 2.080,22 ",2936221191,CFD," 0,00 "
06/02/2025 15:46:26,Open Position,USD/JPY," 175,00 ",10500," 0,00 "," 6.322,90 "," 1.730,22 ",2936239133,CFD," 0,00 "
06/02/2025 15:47:27,Edit Stop Loss,-,"(18,37)",-," 0,00 "," 6.322,90 "," 1.711,85 ",2934085495,-," 0,00 "
06/02/2025 15:47:40,Edit Stop Loss,-,"(21,42)",-," 0,00 "," 6.322,90 "," 1.690,43 ",2934171930,-," 0,00 "
06/02/2025 15:47:48,Edit Stop Loss,-,"(15,29)",-," 0,00 "," 6.322,90 "," 1.675,14 ",2934269338,-," 0,00 "
06/02/2025 15:47:56,Edit Stop Loss,-,"(12,22)",-," 0,00 "," 6.322,90 "," 1.662,92 ",2934327676,-," 0,00 "
06/02/2025 15:48:07,Edit Stop Loss,-,"(18,33)",-," 0,00 "," 6.322,90 "," 1.644,59 ",2934532777,-," 0,00 "
06/02/2025 15:48:24,Edit Stop Loss,-,"(12,21)",-," 0,00 "," 6.322,90 "," 1.632,38 ",2934536312,-," 0,00 "
06/02/2025 15:49:00,Position closed,USD/JPY," 202,37 ",6000," 2,37 "," 6.325,27 "," 1.834,75 ",2936223353,CFD," 0,00 "
06/02/2025 15:49:14,Open Position,USD/JPY," 200,00 ",6000," 0,00 "," 6.325,27 "," 1.634,75 ",2936243289,CFD," 0,00 "
06/02/2025 15:55:12,Position closed,USD/JPY," 201,27 ",6000," 1,27 "," 6.326,54 "," 1.836,02 ",2936243289,CFD," 0,00 "
06/02/2025 15:55:32,Open Position,USD/JPY," 250,00 ",7500," 0,00 "," 6.326,54 "," 1.586,02 ",2936254257,CFD," 0,00 "
06/02/2025 15:57:51,Position closed,USD/JPY," 250,79 ",7500," 0,79 "," 6.327,33 "," 1.836,81 ",2936254257,CFD," 0,00 "
06/02/2025 15:58:12,Open Position,USD/JPY," 350,00 ",10500," 0,00 "," 6.327,33 "," 1.486,81 ",2936257588,CFD," 0,00 "
06/02/2025 16:04:09,Open Position,USD/JPY," 300,00 ",9000," 0,00 "," 6.327,33 "," 1.186,81 ",2936265450,CFD," 0,00 "
06/02/2025 16:07:07,Open Position,USD/JPY," 250,00 ",7500," 0,00 "," 6.327,33 "," 936,81 ",2936272618,CFD," 0,00 "
06/02/2025 16:08:14,Open Position,USD/JPY," 200,00 ",6000," 0,00 "," 6.327,33 "," 736,81 ",2936274232,CFD," 0,00 "
06/02/2025 16:09:50,Position closed,USD/JPY," 172,96 ",5250.003324,"(2,04)"," 6.325,29 "," 909,77 ",2936276514,CFD," 0,00 "
06/02/2025 16:10:27,Open Position,USD/JPY," 200,00 ",6000," 0,00 "," 6.325,29 "," 709,77 ",2936279967,CFD," 0,00 "
06/02/2025 16:17:21,Position closed,USD/JPY," 174,14 ",5249.996676,"(0,86)"," 6.324,43 "," 883,91 ",2936239133,CFD," 0,00 "
06/02/2025 16:17:29,Open Position,USD/JPY," 200,00 ",6000," 0,00 "," 6.324,43 "," 683,91 ",2936287487,CFD," 0,00 "
06/02/2025 16:21:22,Position closed,USD/JPY," 201,74 ",6000," 1,74 "," 6.326,17 "," 885,65 ",2936287487,CFD," 0,00 "
06/02/2025 16:21:41,Open Position,USD/JPY," 200,00 ",6000," 0,00 "," 6.326,17 "," 685,65 ",2936293320,CFD," 0,00 "
06/02/2025 16:23:30,Open Position,USD/JPY," 200,00 ",6000," 0,00 "," 6.326,17 "," 485,65 ",2936295234,CFD," 0,00 "
06/02/2025 16:30:21,Position closed,USD/JPY," 201,30 ",6000," 1,30 "," 6.327,47 "," 686,95 ",2936295234,CFD," 0,00 "
06/02/2025 16:30:29,Open Position,USD/JPY," 300,00 ",9000," 0,00 "," 6.327,47 "," 386,95 ",2936303171,CFD," 0,00 "
06/02/2025 17:09:30,Open Position,USD/JPY," 149,99 ",4500," 0,00 "," 6.327,47 "," 236,96 ",2936464526,CFD," 0,00 "
06/02/2025 18:06:51,Position closed,USD/JPY," 153,10 ",4500," 3,11 "," 6.330,58 "," 390,06 ",2936464526,CFD," 0,00 "
06/02/2025 18:07:04,Position closed,USD/JPY," 299,94 ",9000,"(0,06)"," 6.330,52 "," 690,00 ",2936303171,CFD," 0,00 "
06/02/2025 18:21:02,Position closed,USD/JPY," 353,39 ",10500," 3,39 "," 6.333,91 "," 1.043,39 ",2936257588,CFD," 0,00 "
06/02/2025 18:21:11,Position closed,USD/JPY," 304,27 ",9000," 4,27 "," 6.338,18 "," 1.347,66 ",2936265450,CFD," 0,00 "
06/02/2025 18:21:18,Position closed,USD/JPY," 253,31 ",7500," 3,31 "," 6.341,49 "," 1.600,97 ",2936272618,CFD," 0,00 "
06/02/2025 18:21:25,Position closed,USD/JPY," 204,19 ",6000," 4,19 "," 6.345,68 "," 1.805,16 ",2936274232,CFD," 0,00 "
06/02/2025 18:21:45,Position closed,USD/JPY," 206,61 ",6000," 6,61 "," 6.352,29 "," 2.011,77 ",2936279967,CFD," 0,00 "
06/02/2025 18:21:54,Position closed,USD/JPY," 205,86 ",6000," 5,86 "," 6.358,15 "," 2.217,63 ",2936293320,CFD," 0,00 "
06/02/2025 18:23:10,Open Position,USD/JPY," 250,00 ",7500," 0,00 "," 6.358,15 "," 1.967,63 ",2936528657,CFD," 0,00 "
06/02/2025 18:26:12,Position closed,USD/JPY," 252,23 ",7500," 2,23 "," 6.360,38 "," 2.219,86 ",2936528657,CFD," 0,00 "
06/02/2025 18:26:24,Open Position,USD/JPY," 200,00 ",6000," 0,00 "," 6.360,38 "," 2.019,86 ",2936531404,CFD," 0,00 "
06/02/2025 18:31:24,Position closed,USD/JPY," 202,65 ",6000," 2,65 "," 6.363,03 "," 2.222,51 ",2936531404,CFD," 0,00 "
06/02/2025 18:32:44,Open Position,USD/JPY," 200,00 ",6000," 0,00 "," 6.363,03 "," 2.022,51 ",2936535399,CFD," 0,00 "
06/02/2025 18:38:13,Position closed,NSDQ100/USD," 122,61 ",0.11495,"(2,30)"," 6.360,73 "," 2.145,12 ",2936541034,CFD," 0,00 "
06/02/2025 18:38:54,Position closed,USD/JPY," 203,84 ",6000," 3,84 "," 6.364,57 "," 2.348,96 ",2936535399,CFD," 0,00 "
06/02/2025 18:39:53,Open Position,USD/JPY," 250,00 ",7500," 0,00 "," 6.364,57 "," 2.098,96 ",2936542002,CFD," 0,00 "
06/02/2025 18:40:11,Edit Stop Loss,-,"(12,28)",-," 0,00 "," 6.364,57 "," 2.086,68 ",2934085495,-," 0,00 "
06/02/2025 18:40:27,Edit Stop Loss,-,"(14,33)",-," 0,00 "," 6.364,57 "," 2.072,35 ",2934171930,-," 0,00 "
06/02/2025 18:40:36,Edit Stop Loss,-,"(10,22)",-," 0,00 "," 6.364,57 "," 2.062,13 ",2934269338,-," 0,00 "
06/02/2025 18:40:42,Edit Stop Loss,-,"(8,18)",-," 0,00 "," 6.364,57 "," 2.053,95 ",2934327676,-," 0,00 "
06/02/2025 18:40:53,Edit Stop Loss,-,"(12,26)",-," 0,00 "," 6.364,57 "," 2.041,69 ",2934532777,-," 0,00 "
06/02/2025 18:41:04,Edit Stop Loss,-,"(8,16)",-," 0,00 "," 6.364,57 "," 2.033,53 ",2934536312,-," 0,00 "
06/02/2025 18:42:53,Open Position,USD/JPY," 200,00 ",6000," 0,00 "," 6.364,57 "," 1.833,53 ",2936545319,CFD," 0,00 "
06/02/2025 18:45:23,Position closed,USD/JPY," 202,93 ",6000," 2,93 "," 6.367,50 "," 2.036,46 ",2936545319,CFD," 0,00 "
06/02/2025 18:45:30,Position closed,USD/JPY," 252,68 ",7500," 2,68 "," 6.370,18 "," 2.289,14 ",2936542002,CFD," 0,00 "
06/02/2025 18:45:51,Open Position,USD/JPY," 459,99 ",13800," 0,00 "," 6.370,18 "," 1.829,15 ",2936547353,CFD," 0,00 "
06/02/2025 18:56:48,Open Position,USD/JPY," 300,00 ",9000," 0,00 "," 6.370,18 "," 1.529,15 ",2936558322,CFD," 0,00 "
06/02/2025 18:58:55,Position closed,USD/JPY," 304,22 ",9000," 4,22 "," 6.374,40 "," 1.833,37 ",2936558322,CFD," 0,00 "
06/02/2025 18:59:13,Open Position,USD/JPY," 1.000,00 ",30000," 0,00 "," 6.374,40 "," 833,37 ",2936559778,CFD," 0,00 "
06/02/2025 18:59:51,Position closed,USD/JPY," 1.007,73 ",30000," 7,73 "," 6.382,13 "," 1.841,10 ",2936559778,CFD," 0,00 "
06/02/2025 19:00:04,Open Position,USD/JPY," 200,00 ",6000," 0,00 "," 6.382,13 "," 1.641,10 ",2936560297,CFD," 0,00 "
06/02/2025 19:00:50,Position closed,USD/JPY," 461,27 ",13800," 1,28 "," 6.383,41 "," 2.102,37 ",2936547353,CFD," 0,00 "
06/02/2025 19:02:56,Open Position,USD/JPY," 1.500,00 ",45000," 0,00 "," 6.383,41 "," 602,37 ",2936562387,CFD," 0,00 "
06/02/2025 19:04:33,Position closed,USD/JPY," 1.500,89 ",45000," 0,89 "," 6.384,30 "," 2.103,26 ",2936562387,CFD," 0,00 "
06/02/2025 19:06:16,Open Position,USD/JPY," 1.000,00 ",30000," 0,00 "," 6.384,30 "," 1.103,26 ",2936568228,CFD," 0,00 "
06/02/2025 19:06:53,Position closed,USD/JPY," 1.005,35 ",30000," 5,35 "," 6.389,65 "," 2.108,61 ",2936568228,CFD," 0,00 "
06/02/2025 19:08:08,Position closed,USD/JPY," 200,91 ",6000," 0,91 "," 6.390,56 "," 2.309,52 ",2936560297,CFD," 0,00 "
06/02/2025 19:08:19,Open Position,USD/JPY," 300,00 ",9000," 0,00 "," 6.390,56 "," 2.009,52 ",2936569365,CFD," 0,00 "
06/02/2025 19:08:58,Open Position,USD/JPY," 500,00 ",30000," 0,00 "," 6.390,56 "," 1.009,52 ",2936569823,CFD," 0,00 "
06/02/2025 19:11:34,Position closed,USD/JPY," 493,76 ",15000.027517,"(6,24)"," 6.384,32 "," 1.503,28 ",2936572035,CFD," 0,00 "
06/02/2025 19:24:28,Open Position,USD/JPY," 499,99 ",15000," 0,00 "," 6.384,32 "," 1.003,29 ",2936581245,CFD," 0,00 "
06/02/2025 19:27:59,Position closed,USD/JPY," 503,66 ",15000," 3,67 "," 6.387,99 "," 1.506,95 ",2936581245,CFD," 0,00 "
06/02/2025 19:32:17,Position closed,USD/JPY," 501,88 ",14999.972483," 1,88 "," 6.389,87 "," 2.008,83 ",2936569823,CFD," 0,00 "
06/02/2025 19:33:24,Position closed,USD/JPY," 302,44 ",9000," 2,44 "," 6.392,31 "," 2.311,27 ",2936569365,CFD," 0,00 "
06/02/2025 19:33:28,Position closed,USD/JPY," 167,11 ",6000,"(32,88)"," 6.359,43 "," 2.478,38 ",2936099794,CFD," 0,00 "
06/02/2025 19:34:34,Open Position,USD/JPY," 300,00 ",9000," 0,00 "," 6.359,43 "," 2.178,38 ",2936597670,CFD," 0,00 "
06/02/2025 19:37:13,Open Position,USD/JPY," 1.000,00 ",30000," 0,00 "," 6.359,43 "," 1.178,38 ",2936600605,CFD," 0,00 "
06/02/2025 19:40:34,Position closed,USD/JPY," 212,53 ",7500,"(37,46)"," 6.321,97 "," 1.390,91 ",2935864198,CFD," 0,00 "
06/02/2025 19:40:49,Position closed,USD/JPY," 248,79 ",9000,"(51,20)"," 6.270,77 "," 1.639,70 ",2935839497,CFD," 0,00 "
06/02/2025 19:41:13,Open Position,USD/JPY," 499,99 ",15000," 0,00 "," 6.270,77 "," 1.139,71 ",2936603777,CFD," 0,00 "
06/02/2025 19:46:15,Position closed,USD/JPY," 1.004,36 ",30000," 4,36 "," 6.275,13 "," 2.144,07 ",2936600605,CFD," 0,00 "
06/02/2025 19:46:58,Position closed,USD/JPY," 502,47 ",15000," 2,48 "," 6.277,61 "," 2.646,54 ",2936603777,CFD," 0,00 "
06/02/2025 19:52:22,Open Position,USD/JPY," 1.549,99 ",46500," 0,00 "," 6.277,61 "," 1.096,55 ",2936612842,CFD," 0,00 "
06/02/2025 20:02:27,Open Position,USD/JPY," 1.000,00 ",30000," 0,00 "," 6.277,61 "," 96,55 ",2936618755,CFD," 0,00 "
06/02/2025 20:07:00,Position closed,USD/JPY," 1.003,57 ",30000," 3,57 "," 6.281,18 "," 1.100,12 ",2936618755,CFD," 0,00 "
06/02/2025 20:07:52,Open Position,USD/JPY," 499,99 ",15000," 0,00 "," 6.281,18 "," 600,13 ",2936621505,CFD," 0,00 "
06/02/2025 20:09:44,Position closed,USD/JPY," 502,07 ",15000," 2,08 "," 6.283,26 "," 1.102,20 ",2936621505,CFD," 0,00 "
06/02/2025 20:13:08,Open Position,USD/JPY," 499,99 ",15000," 0,00 "," 6.283,26 "," 602,21 ",2936624665,CFD," 0,00 "
06/02/2025 20:21:15,Open Position,USD/JPY," 300,00 ",9000," 0,00 "," 6.283,26 "," 302,21 ",2936631252,CFD," 0,00 "
06/02/2025 20:33:56,Open Position,USD/JPY," 200,00 ",6000," 0,00 "," 6.283,26 "," 102,21 ",2936645589,CFD," 0,00 "
06/02/2025 20:50:28,Position closed,NSDQ100/USD," 125,67 ",0.115091," 0,60 "," 6.283,86 "," 227,88 ",2936163257,CFD," 0,00 "
06/02/2025 21:30:07,Position closed,USD/JPY," 201,58 ",6000," 1,58 "," 6.285,44 "," 429,46 ",2936645589,CFD," 0,00 "
06/02/2025 23:00:48,Position closed,USD/JPY," 300,71 ",9000," 0,71 "," 6.286,15 "," 730,17 ",2936631252,CFD," 0,00 "
06/02/2025 23:05:46,Position closed,USD/JPY," 500,09 ",15000," 0,10 "," 6.286,25 "," 1.230,26 ",2936624665,CFD," 0,00 "
06/02/2025 23:06:31,Position closed,USD/JPY," 1.555,83 ",46500," 5,84 "," 6.292,09 "," 2.786,09 ",2936612842,CFD," 0,00 "
06/02/2025 23:07:39,Open Position,USD/JPY," 300,00 ",9000," 0,00 "," 6.292,09 "," 2.486,09 ",2936685308,CFD," 0,00 "
06/02/2025 23:09:41,Position closed,USD/JPY," 301,49 ",9000," 1,49 "," 6.293,58 "," 2.787,58 ",2936685308,CFD," 0,00 "
06/02/2025 23:10:03,Open Position,USD/JPY," 1.000,00 ",30000," 0,00 "," 6.293,58 "," 1.787,58 ",2936685561,CFD," 0,00 "
06/02/2025 23:12:05,Position closed,USD/JPY," 301,49 ",9000," 1,49 "," 6.295,07 "," 2.089,07 ",2936597670,CFD," 0,00 "
06/02/2025 23:12:49,Position closed,USD/JPY," 1.015,47 ",30000," 15,47 "," 6.310,54 "," 3.104,54 ",2936685561,CFD," 0,00 "
06/02/2025 23:13:13,Open Position,USD/JPY," 500,00 ",30000," 0,00 "," 6.310,54 "," 2.104,54 ",2936685784,CFD," 0,00 "
06/02/2025 23:15:10,Open Position,USD/JPY," 1.000,00 ",30000," 0,00 "," 6.310,54 "," 1.104,54 ",2936685919,CFD," 0,00 "
06/02/2025 23:43:35,Position closed,USD/JPY," 496,13 ",14999.891498,"(3,87)"," 6.306,67 "," 1.600,67 ",2936687859,CFD," 0,00 "
06/02/2025 23:50:14,Position closed,USD/JPY," 500,20 ",15000.108502," 0,20 "," 6.306,87 "," 2.100,87 ",2936685784,CFD," 0,00 "
06/02/2025 23:57:10,Position closed,USD/JPY," 1.003,77 ",30000," 3,77 "," 6.310,64 "," 3.104,64 ",2936685919,CFD," 0,00 "
06/02/2025 23:57:37,Open Position,USD/JPY," 300,00 ",9000," 0,00 "," 6.310,64 "," 2.804,64 ",2936688610,CFD," 0,00 "
07/02/2025 00:13:30,Position closed,USD/JPY," 301,43 ",9000," 1,43 "," 6.312,07 "," 3.106,07 ",2936688610,CFD," 0,00 "
07/02/2025 00:16:52,Open Position,USD/JPY," 499,99 ",15000," 0,00 "," 6.312,07 "," 2.606,08 ",2936689673,CFD," 0,00 "
07/02/2025 00:17:13,Open Position,USD/JPY," 499,99 ",15000," 0,00 "," 6.312,07 "," 2.106,09 ",2936689690,CFD," 0,00 "
07/02/2025 00:18:06,Open Position,USD/JPY," 300,00 ",9000," 0,00 "," 6.312,07 "," 1.806,09 ",2936689716,CFD," 0,00 "
07/02/2025 00:20:07,Position closed,USD/JPY," 510,22 ",15000," 10,23 "," 6.322,30 "," 2.316,31 ",2936689673,CFD," 0,00 "
07/02/2025 00:20:14,Position closed,USD/JPY," 511,11 ",15000," 11,12 "," 6.333,42 "," 2.827,42 ",2936689690,CFD," 0,00 "
07/02/2025 00:20:27,Position closed,USD/JPY," 308,10 ",9000," 8,10 "," 6.341,52 "," 3.135,52 ",2936689716,CFD," 0,00 "
07/02/2025 00:25:53,Position closed,USD/JPY," 190,88 ",7500,"(59,11)"," 6.282,41 "," 3.326,40 ",2935843614,CFD," 0,00 "
07/02/2025 00:25:59,Position closed,USD/JPY," 189,44 ",7500,"(60,55)"," 6.221,86 "," 3.515,84 ",2935839778,CFD," 0,00 "
07/02/2025 00:26:09,Position closed,USD/JPY," 62,87 ",2998.266156,"(37,07)"," 6.184,79 "," 3.578,71 ",2935748452,CFD," 0,00 "
07/02/2025 00:26:31,Edit Stop Loss,-,"(30,86)",-," 0,00 "," 6.184,79 "," 3.547,85 ",2934085495,-," 0,00 "
07/02/2025 00:26:37,Edit Stop Loss,-,"(35,99)",-," 0,00 "," 6.184,79 "," 3.511,86 ",2934171930,-," 0,00 "
07/02/2025 00:26:48,Edit Stop Loss,-,"(25,68)",-," 0,00 "," 6.184,79 "," 3.486,18 ",2934269338,-," 0,00 "
07/02/2025 00:26:54,Edit Stop Loss,-,"(20,53)",-," 0,00 "," 6.184,79 "," 3.465,65 ",2934327676,-," 0,00 "
07/02/2025 00:27:06,Edit Stop Loss,-,"(30,79)",-," 0,00 "," 6.184,79 "," 3.434,86 ",2934532777,-," 0,00 "
07/02/2025 00:27:17,Edit Stop Loss,-,"(20,51)",-," 0,00 "," 6.184,79 "," 3.414,35 ",2934536312,-," 0,00 "
07/02/2025 00:27:58,Open Position,USD/JPY," 659,30 ",15000," 0,00 "," 6.184,79 "," 2.914,36 ",2936693236,CFD," 0,00 "
07/02/2025 00:41:27,Open Position,USD/JPY," 1.000,00 ",30000," 0,00 "," 6.184,79 "," 1.914,36 ",2936694004,CFD," 0,00 "
07/02/2025 00:47:38,Overnight refund,Daily," 0,84 ",-," 0,84 "," 6.185,63 "," 1.915,20 ",2934171930,CFD," 0,00 "
07/02/2025 00:47:38,Overnight refund,Daily," 0,72 ",-," 0,72 "," 6.186,35 "," 1.915,92 ",2934085495,CFD," 0,00 "
07/02/2025 00:47:38,Overnight refund,Daily," 0,72 ",-," 0,72 "," 6.187,07 "," 1.916,64 ",2934532777,CFD," 0,00 "
07/02/2025 00:47:38,Overnight refund,Daily," 0,60 ",-," 0,60 "," 6.187,67 "," 1.917,24 ",2935843614,CFD," 0,00 "
07/02/2025 00:47:38,Overnight refund,Daily," 0,60 ",-," 0,60 "," 6.188,27 "," 1.917,84 ",2935839778,CFD," 0,00 "
07/02/2025 00:47:38,Overnight refund,Daily," 0,60 ",-," 0,60 "," 6.188,87 "," 1.918,44 ",2934269338,CFD," 0,00 "
07/02/2025 00:47:38,Overnight refund,Daily," 0,48 ",-," 0,48 "," 6.189,35 "," 1.918,92 ",2934327676,CFD," 0,00 "
07/02/2025 00:47:38,Overnight refund,Daily," 0,48 ",-," 0,48 "," 6.189,83 "," 1.919,40 ",2934536312,CFD," 0,00 "
07/02/2025 00:47:38,Overnight refund,Daily," 0,24 ",-," 0,24 "," 6.190,07 "," 1.919,64 ",2935748452,CFD," 0,00 "
07/02/2025 00:47:38,Overnight fee,Daily,"(1,42)",-,"(1,42)"," 6.188,65 "," 1.918,22 ",2936597670,CFD," 0,00 "
07/02/2025 00:47:38,Overnight fee,Daily,"(1,42)",-,"(1,42)"," 6.187,23 "," 1.916,80 ",2936631252,CFD," 0,00 "
07/02/2025 00:47:38,Overnight fee,Daily,"(2,37)",-,"(2,37)"," 6.184,86 "," 1.914,43 ",2936624665,CFD," 0,00 "
07/02/2025 00:47:38,Overnight fee,Daily,"(7,34)",-,"(7,34)"," 6.177,52 "," 1.907,09 ",2936612842,CFD," 0,00 "
07/02/2025 00:49:12,Open Position,USD/JPY," 750,60 ",45000," 0,00 "," 6.177,52 "," 407,09 ",2936694391,CFD," 0,00 "
07/02/2025 00:51:50,Position closed,USD/JPY," 745,53 ",22482.139182,"(3,87)"," 6.173,65 "," 1.152,62 ",2936694471,CFD," 0,00 "
07/02/2025 00:53:00,Position closed,USD/JPY," 746,73 ",22517.860818,"(3,87)"," 6.169,78 "," 1.899,35 ",2936694391,CFD," 0,00 "
07/02/2025 00:58:54,Open Position,USD/JPY," 250,00 ",7500," 0,00 "," 6.169,78 "," 1.649,35 ",2936696732,CFD," 0,00 "
07/02/2025 07:27:12,Open Position,USD/JPY," 300,00 ",9000," 0,00 "," 6.169,78 "," 1.349,35 ",2936729458,CFD," 0,00 "
07/02/2025 07:45:58,Position closed,USD/JPY," 257,29 ",9000,"(160,48)"," 6.009,30 "," 1.606,64 ",2934532777,CFD," 0,00 "
07/02/2025 07:46:09,Position closed,USD/JPY," 302,19 ",9000," 2,19 "," 6.011,49 "," 1.908,83 ",2936729458,CFD," 0,00 "
07/02/2025 07:52:48,Open Position,USD/JPY," 350,00 ",10500," 0,00 "," 6.011,49 "," 1.558,83 ",2936733998,CFD," 0,00 "
07/02/2025 08:05:20,Position closed,USD/JPY," 350,90 ",10500," 0,90 "," 6.012,39 "," 1.909,73 ",2936733998,CFD," 0,00 "
07/02/2025 08:06:02,Open Position,USD/JPY," 350,00 ",10500," 0,00 "," 6.012,39 "," 1.559,73 ",2936761294,CFD," 0,00 "
07/02/2025 08:22:36,Position closed,USD/JPY," 357,20 ",10500," 7,20 "," 6.019,59 "," 1.916,93 ",2936761294,CFD," 0,00 "
07/02/2025 08:23:35,Open Position,USD/JPY," 300,00 ",9000," 0,00 "," 6.019,59 "," 1.616,93 ",2936787040,CFD," 0,00 "
07/02/2025 08:58:58,Open Position,USD/JPY," 99,87 ",6000," 0,00 "," 6.019,59 "," 1.416,93 ",2936798258,CFD," 0,00 "
07/02/2025 10:57:11,Open Position,USD/JPY," 99,99 ",3000," 0,00 "," 6.019,59 "," 1.316,94 ",2936827462,CFD," 0,00 "
07/02/2025 11:40:02,Position closed,USD/JPY," 100,21 ",3000," 0,22 "," 6.019,81 "," 1.417,15 ",2936827462,CFD," 0,00 "
07/02/2025 13:31:10,Open Position,USD/JPY," 199,99 ",6000," 0,00 "," 6.019,81 "," 1.217,16 ",2936879896,CFD," 0,00 "
07/02/2025 13:32:14,Position closed,USD/JPY," 88,95 ",3003.808748,"(11,18)"," 6.008,63 "," 1.306,11 ",2936880653,CFD," 0,00 "
07/02/2025 13:51:52,Position closed,USD/JPY," 94,74 ",2996.191252,"(5,13)"," 6.003,50 "," 1.400,85 ",2936798258,CFD," 0,00 "
07/02/2025 14:02:05,Position closed,USD/JPY," 174,39 ",6000,"(98,48)"," 5.905,02 "," 1.575,24 ",2934536312,CFD," 0,00 "
07/02/2025 14:02:32,Open Position,USD/JPY," 200,00 ",6000," 0,00 "," 5.905,02 "," 1.375,24 ",2936893325,CFD," 0,00 "
07/02/2025 14:38:20,Position closed,USD/JPY," 208,63 ",6000," 8,63 "," 5.913,65 "," 1.583,87 ",2936893325,CFD," 0,00 "
07/02/2025 14:51:08,Position closed,USD/JPY," 307,72 ",9000," 7,72 "," 5.921,37 "," 1.891,59 ",2936787040,CFD," 0,00 "
07/02/2025 14:51:26,Open Position,USD/JPY," 350,00 ",10500," 0,00 "," 5.921,37 "," 1.541,59 ",2937123521,CFD," 0,00 "
07/02/2025 15:52:44,Position closed,USD/JPY," 352,84 ",10500," 2,84 "," 5.924,21 "," 1.894,43 ",2937123521,CFD," 0,00 "
07/02/2025 15:52:58,Open Position,USD/JPY," 250,00 ",7500," 0,00 "," 5.924,21 "," 1.644,43 ",2937407523,CFD," 0,00 "
07/02/2025 16:26:29,Open Position,NSDQ100/USD," 199,99 ",0.185329," 0,00 "," 5.924,21 "," 1.444,44 ",2937505304,CFD," 0,00 "
07/02/2025 16:26:49,Position closed,USD/JPY," 259,87 ",7500," 9,87 "," 5.934,08 "," 1.704,31 ",2937407523,CFD," 0,00 "
07/02/2025 16:34:15,Position closed,USD/JPY," 252,83 ",7500," 2,83 "," 5.936,91 "," 1.957,14 ",2936696732,CFD," 0,00 "
07/02/2025 16:45:16,Position closed,USD/JPY," 1.019,87 ",30000," 19,87 "," 5.956,78 "," 2.977,01 ",2936694004,CFD," 0,00 "
07/02/2025 16:49:40,Open Position,USD/JPY," 300,00 ",9000," 0,00 "," 5.956,78 "," 2.677,01 ",2937531096,CFD," 0,00 "
07/02/2025 16:52:42,Position closed,USD/JPY," 302,20 ",9000," 2,20 "," 5.958,98 "," 2.979,21 ",2937531096,CFD," 0,00 "
07/02/2025 16:53:02,Open Position,USD/JPY," 96,07 ",4500," 0,00 "," 5.958,98 "," 2.829,22 ",2937534559,CFD," 0,00 "
07/02/2025 18:12:53,Open Position,USD/JPY," 200,00 ",6000," 0,00 "," 5.958,98 "," 2.629,22 ",2937603941,CFD," 0,00 "
07/02/2025 18:57:30,Position closed,USD/JPY," 207,53 ",6000," 7,53 "," 5.966,51 "," 2.836,75 ",2937603941,CFD," 0,00 "
07/02/2025 18:57:42,Open Position,USD/JPY," 200,00 ",6000," 0,00 "," 5.966,51 "," 2.636,75 ",2937640162,CFD," 0,00 "
07/02/2025 20:18:53,Position closed,USD/JPY," 203,97 ",6000," 3,97 "," 5.970,48 "," 2.840,72 ",2937640162,CFD," 0,00 "
07/02/2025 20:19:24,Open Position,NSDQ100/USD," 199,98 ",0.186203," 0,00 "," 5.970,48 "," 2.640,74 ",2937706335,CFD," 0,00 "
07/02/2025 20:23:21,Position closed,NSDQ100/USD," 199,19 ",0.186203,"(0,79)"," 5.969,69 "," 2.839,93 ",2937706335,CFD," 0,00 "
07/02/2025 20:23:36,Open Position,USD/JPY," 150,00 ",4500," 0,00 "," 5.969,69 "," 2.689,93 ",2937708456,CFD," 0,00 "
07/02/2025 20:23:43,Position closed,USD/JPY," 149,61 ",4500,"(0,39)"," 5.969,30 "," 2.839,54 ",2937708456,CFD," 0,00 "
07/02/2025 20:23:59,Open Position,USD/JPY," 149,99 ",4500," 0,00 "," 5.969,30 "," 2.689,55 ",2937708728,CFD," 0,00 "
07/02/2025 21:08:19,Position closed,USD/JPY," 151,12 ",4500," 1,13 "," 5.970,43 "," 2.840,67 ",2937708728,CFD," 0,00 "
08/02/2025 00:12:55,Index price adjustment,NSDQ100/USD," 0,50 ",-," 0,50 "," 5.970,93 "," 2.841,17 ",2937505304,CFD," 0,00 "
08/02/2025 00:47:58,Overnight refund,Daily," 0,82 ",-," 0,82 "," 5.971,75 "," 2.841,99 ",2934171930,CFD," 0,00 "
08/02/2025 00:47:58,Overnight refund,Daily," 0,70 ",-," 0,70 "," 5.972,45 "," 2.842,69 ",2934085495,CFD," 0,00 "
08/02/2025 00:47:58,Overnight refund,Daily," 0,58 ",-," 0,58 "," 5.973,03 "," 2.843,27 ",2934269338,CFD," 0,00 "
08/02/2025 00:47:58,Overnight refund,Daily," 0,47 ",-," 0,47 "," 5.973,50 "," 2.843,74 ",2936879896,CFD," 0,00 "
08/02/2025 00:47:58,Overnight refund,Daily," 0,47 ",-," 0,47 "," 5.973,97 "," 2.844,21 ",2934327676,CFD," 0,00 "
08/02/2025 00:47:58,Overnight fee,Daily,"(0,69)",-,"(0,69)"," 5.973,28 "," 2.843,52 ",2937534559,CFD," 0,00 "
08/02/2025 00:47:58,Overnight fee,Daily,"(2,30)",-,"(2,30)"," 5.970,98 "," 2.841,22 ",2936693236,CFD," 0,00 "
08/02/2025 00:47:58,Overnight fee,Weekend Fee,"(2,84)",-,"(2,84)"," 5.968,14 "," 2.838,38 ",2937505304,CFD," 0,00 "
09/02/2025 22:35:10,Open Position,USD/JPY," 250,00 ",7500," 0,00 "," 5.968,14 "," 2.588,38 ",2937845684,CFD," 0,00 "
09/02/2025 22:59:46,Open Position,USD/JPY," 299,99 ",9000," 0,00 "," 5.968,14 "," 2.288,39 ",2937846803,CFD," 0,00 "
09/02/2025 23:13:00,Open Position,NSDQ100/USD," 249,99 ",0.233164," 0,00 "," 5.968,14 "," 2.038,40 ",2937855033,CFD," 0,00 "
09/02/2025 23:13:34,Open Position,USD/JPY," 150,00 ",4500," 0,00 "," 5.968,14 "," 1.888,40 ",2937855091,CFD," 0,00 "
09/02/2025 23:16:34,Position closed,USD/JPY," 250,40 ",7500," 0,40 "," 5.968,54 "," 2.138,80 ",2937845684,CFD," 0,00 "
09/02/2025 23:23:59,Position closed,USD/JPY," 151,81 ",4500," 1,81 "," 5.970,35 "," 2.290,61 ",2937855091,CFD," 0,00 "
09/02/2025 23:24:07,Position closed,USD/JPY," 301,24 ",9000," 1,25 "," 5.971,60 "," 2.591,85 ",2937846803,CFD," 0,00 "
09/02/2025 23:24:19,Open Position,USD/JPY," 249,99 ",7500," 0,00 "," 5.971,60 "," 2.341,86 ",2937856663,CFD," 0,00 "
10/02/2025 00:01:18,Position closed,NSDQ100/USD," 280,07 ",0.233164," 30,08 "," 6.001,68 "," 2.621,93 ",2937855033,CFD," 0,00 "
10/02/2025 00:01:31,Open Position,NSDQ100/USD," 199,99 ",0.185373," 0,00 "," 6.001,68 "," 2.421,94 ",2937860400,CFD," 0,00 "
10/02/2025 00:01:49,Position closed,USD/JPY," 259,38 ",7500," 9,39 "," 6.011,07 "," 2.681,32 ",2937856663,CFD," 0,00 "
10/02/2025 00:02:32,Open Position,USD/JPY," 150,00 ",4500," 0,00 "," 6.011,07 "," 2.531,32 ",2937860504,CFD," 0,00 "
10/02/2025 06:28:15,Position closed,NSDQ100/USD," 203,93 ",0.185373," 3,94 "," 6.015,01 "," 2.735,25 ",2937860400,CFD," 0,00 "
10/02/2025 06:28:22,Position closed,NSDQ100/USD," 202,82 ",0.185329," 2,83 "," 6.017,84 "," 2.938,07 ",2937505304,CFD," 0,00 "
10/02/2025 06:29:25,Open Position,NSDQ100/USD," 299,99 ",0.277751," 0,00 "," 6.017,84 "," 2.638,08 ",2937893223,CFD," 0,00 "
10/02/2025 06:29:39,Position closed,USD/JPY," 151,16 ",4500," 1,16 "," 6.019,00 "," 2.789,24 ",2937860504,CFD," 0,00 "
10/02/2025 06:30:08,Open Position,USD/JPY," 249,99 ",7500," 0,00 "," 6.019,00 "," 2.539,25 ",2937893278,CFD," 0,00 "
10/02/2025 07:41:30,Position closed,USD/JPY," 257,29 ",7500," 7,30 "," 6.026,30 "," 2.796,54 ",2937893278,CFD," 0,00 "
10/02/2025 07:42:12,Open Position,USD/JPY," 150,00 ",4500," 0,00 "," 6.026,30 "," 2.646,54 ",2937902809,CFD," 0,00 "
10/02/2025 08:24:44,Position closed,USD/JPY," 162,75 ",4500," 12,75 "," 6.039,05 "," 2.809,29 ",2937902809,CFD," 0,00 "
10/02/2025 08:25:30,Position closed,NSDQ100/USD," 302,28 ",0.277751," 2,29 "," 6.041,34 "," 3.111,57 ",2937893223,CFD," 0,00 "
10/02/2025 08:25:47,Position closed,USD/JPY," 203,18 ",6000," 3,19 "," 6.044,53 "," 3.314,75 ",2936879896,CFD," 0,00 "
10/02/2025 08:26:08,Open Position,NSDQ100/USD," 249,99 ",0.231334," 0,00 "," 6.044,53 "," 3.064,76 ",2937971656,CFD," 0,00 "
10/02/2025 08:27:43,Open Position,NSDQ100/USD," 249,99 ",0.231371," 0,00 "," 6.044,53 "," 2.814,77 ",2937971956,CFD," 0,00 "
10/02/2025 08:28:20,Position closed,USD/JPY," 196,13 ",6000,"(84,66)"," 5.959,87 "," 3.010,90 ",2934327676,CFD," 0,00 "
10/02/2025 09:16:16,Open Position,USD/JPY," 249,99 ",7500," 0,00 "," 5.959,87 "," 2.760,91 ",2937985967,CFD," 0,00 "
10/02/2025 09:16:32,Open Position,USD/JPY," 250,00 ",7500," 0,00 "," 5.959,87 "," 2.510,91 ",2937986047,CFD," 0,00 "
10/02/2025 09:48:59,Position closed,USD/JPY," 252,96 ",7500," 2,96 "," 5.962,83 "," 2.763,87 ",2937986047,CFD," 0,00 "
10/02/2025 09:49:04,Position closed,USD/JPY," 245,95 ",7500,"(4,04)"," 5.958,79 "," 3.009,82 ",2937985967,CFD," 0,00 "
10/02/2025 09:49:33,Open Position,USD/JPY," 1.500,00 ",45000," 0,00 "," 5.958,79 "," 1.509,82 ",2937995180,CFD," 0,00 "
10/02/2025 09:53:33,Position closed,USD/JPY," 1.502,66 ",45000," 2,66 "," 5.961,45 "," 3.012,48 ",2937995180,CFD," 0,00 "
10/02/2025 09:54:15,Open Position,USD/JPY," 1.199,99 ",36000," 0,00 "," 5.961,45 "," 1.812,49 ",2937996218,CFD," 0,00 "
10/02/2025 10:07:40,Position closed,NSDQ100/USD," 250,51 ",0.231371," 0,52 "," 5.961,97 "," 2.063,00 ",2937971956,CFD," 0,00 "
10/02/2025 10:09:34,Open Position,USD/JPY," 300,00 ",9000," 0,00 "," 5.961,97 "," 1.763,00 ",2937999870,CFD," 0,00 "
10/02/2025 10:14:19,Open Position,NSDQ100/USD," 199,99 ",0.185029," 0,00 "," 5.961,97 "," 1.563,01 ",2938001244,CFD," 0,00 "
10/02/2025 10:15:00,Open Position,USD/JPY," 199,99 ",6000," 0,00 "," 5.961,97 "," 1.363,02 ",2938001452,CFD," 0,00 "
10/02/2025 10:25:47,Position closed,NSDQ100/USD," 252,31 ",0.231334," 2,32 "," 5.964,29 "," 1.615,33 ",2937971656,CFD," 0,00 "
10/02/2025 10:25:52,Position closed,NSDQ100/USD," 201,10 ",0.185029," 1,11 "," 5.965,40 "," 1.816,43 ",2938001244,CFD," 0,00 "
10/02/2025 10:26:21,Open Position,NSDQ100/USD," 299,99 ",0.277406," 0,00 "," 5.965,40 "," 1.516,44 ",2938003872,CFD," 0,00 "
10/02/2025 10:38:20,Position closed,USD/JPY," 304,85 ",9000," 4,85 "," 5.970,25 "," 1.821,29 ",2937999870,CFD," 0,00 "
10/02/2025 10:39:02,Position closed,USD/JPY," 141,49 ",4498.153458,"(77,21)"," 5.893,04 "," 1.962,78 ",2938007447,CFD," 0,00 "
10/02/2025 11:00:43,Position closed,USD/JPY," 1.230,29 ",36000," 30,30 "," 5.923,34 "," 3.193,07 ",2937996218,CFD," 0,00 "
10/02/2025 11:01:06,Position closed,USD/JPY," 190,99 ",6000,"(9,00)"," 5.914,34 "," 3.384,06 ",2938001452,CFD," 0,00 "
10/02/2025 11:01:17,Open Position,USD/JPY," 200,00 ",6000," 0,00 "," 5.914,34 "," 3.184,06 ",2938012314,CFD," 0,00 "
10/02/2025 11:04:24,Open Position,USD/JPY," 249,99 ",7500," 0,00 "," 5.914,34 "," 2.934,07 ",2938012946,CFD," 0,00 "
10/02/2025 11:14:18,Position closed,USD/JPY," 251,52 ",7500," 1,53 "," 5.915,87 "," 3.185,59 ",2938012946,CFD," 0,00 "
10/02/2025 11:14:24,Position closed,NSDQ100/USD," 300,96 ",0.277406," 0,97 "," 5.916,84 "," 3.486,55 ",2938003872,CFD," 0,00 "
10/02/2025 11:14:34,Open Position,NSDQ100/USD," 349,99 ",0.323516," 0,00 "," 5.916,84 "," 3.136,56 ",2938014958,CFD," 0,00 "
10/02/2025 11:16:42,Open Position,USD/JPY," 199,99 ",6000," 0,00 "," 5.916,84 "," 2.936,57 ",2938015739,CFD," 0,00 "
10/02/2025 11:27:17,Position closed,NSDQ100/USD," 352,18 ",0.323516," 2,19 "," 5.919,03 "," 3.288,75 ",2938014958,CFD," 0,00 "
10/02/2025 11:27:28,Open Position,NSDQ100/USD," 399,98 ",0.369548," 0,00 "," 5.919,03 "," 2.888,77 ",2938018079,CFD," 0,00 "
10/02/2025 12:10:04,Open Position,NSDQ100/USD," 199,99 ",0.184872," 0,00 "," 5.919,03 "," 2.688,78 ",2938044477,CFD," 0,00 "
10/02/2025 12:10:24,Position closed,USD/JPY," 203,38 ",6000," 3,39 "," 5.922,42 "," 2.892,16 ",2938015739,CFD," 0,00 "
10/02/2025 12:11:14,Open Position,USD/JPY," 200,00 ",6000," 0,00 "," 5.922,42 "," 2.692,16 ",2938044668,CFD," 0,00 "
10/02/2025 12:16:25,Open Position,USD/JPY," 199,99 ",6000," 0,00 "," 5.922,42 "," 2.492,17 ",2938050369,CFD," 0,00 "
10/02/2025 12:53:42,Position closed,USD/JPY," 204,30 ",6000," 4,30 "," 5.926,72 "," 2.696,47 ",2938044668,CFD," 0,00 "
10/02/2025 12:54:34,Open Position,USD/JPY," 200,00 ",6000," 0,00 "," 5.926,72 "," 2.496,47 ",2938072658,CFD," 0,00 "
10/02/2025 13:07:26,Position closed,NSDQ100/USD," 200,82 ",0.184872," 0,83 "," 5.927,55 "," 2.697,29 ",2938044477,CFD," 0,00 "
10/02/2025 13:07:56,Position closed,USD/JPY," 202,37 ",6000," 2,37 "," 5.929,92 "," 2.899,66 ",2938072658,CFD," 0,00 "
10/02/2025 13:08:01,Position closed,USD/JPY," 201,26 ",6000," 1,26 "," 5.931,18 "," 3.100,92 ",2938012314,CFD," 0,00 "
10/02/2025 13:08:09,Open Position,USD/JPY," 300,00 ",9000," 0,00 "," 5.931,18 "," 2.800,92 ",2938079755,CFD," 0,00 "
10/02/2025 13:13:28,Position closed,USD/JPY," 301,89 ",9000," 1,89 "," 5.933,07 "," 3.102,81 ",2938079755,CFD," 0,00 "
10/02/2025 13:13:35,Open Position,USD/JPY," 300,00 ",9000," 0,00 "," 5.933,07 "," 2.802,81 ",2938080846,CFD," 0,00 "
10/02/2025 13:35:13,Position closed,USD/JPY," 304,09 ",9000," 4,09 "," 5.937,16 "," 3.106,90 ",2938080846,CFD," 0,00 "
10/02/2025 13:35:21,Open Position,USD/JPY," 250,00 ",7500," 0,00 "," 5.937,16 "," 2.856,90 ",2938091165,CFD," 0,00 "
10/02/2025 13:59:19,Position closed,NSDQ100/USD," 411,62 ",0.369548," 11,64 "," 5.948,80 "," 3.268,52 ",2938018079,CFD," 0,00 "
10/02/2025 13:59:47,Open Position,NSDQ100/USD," 299,99 ",0.276708," 0,00 "," 5.948,80 "," 2.968,53 ",2938098080,CFD," 0,00 "
10/02/2025 14:00:48,Position closed,NSDQ100/USD," 301,23 ",0.276708," 1,24 "," 5.950,04 "," 3.269,76 ",2938098080,CFD," 0,00 "
10/02/2025 14:01:04,Open Position,NSDQ100/USD," 299,99 ",0.276581," 0,00 "," 5.950,04 "," 2.969,77 ",2938098354,CFD," 0,00 "
10/02/2025 14:04:03,Position closed,USD/JPY," 251,48 ",7500," 1,48 "," 5.951,52 "," 3.221,25 ",2938091165,CFD," 0,00 "
10/02/2025 14:04:12,Open Position,USD/JPY," 250,00 ",7500," 0,00 "," 5.951,52 "," 2.971,25 ",2938099306,CFD," 0,00 "
10/02/2025 14:06:41,Position closed,USD/JPY," 251,14 ",7500," 1,14 "," 5.952,66 "," 3.222,39 ",2938099306,CFD," 0,00 "
10/02/2025 14:06:52,Open Position,USD/JPY," 250,00 ",7500," 0,00 "," 5.952,66 "," 2.972,39 ",2938100262,CFD," 0,00 "
10/02/2025 14:17:39,Position closed,USD/JPY," 252,27 ",7500," 2,27 "," 5.954,93 "," 3.224,66 ",2938100262,CFD," 0,00 "
10/02/2025 14:18:10,Open Position,USD/JPY," 199,99 ",6000," 0,00 "," 5.954,93 "," 3.024,67 ",2938104002,CFD," 0,00 "
10/02/2025 14:18:24,Open Position,USD/JPY," 200,00 ",6000," 0,00 "," 5.954,93 "," 2.824,67 ",2938104201,CFD," 0,00 "
10/02/2025 14:26:07,Position closed,USD/JPY," 201,10 ",6000," 1,11 "," 5.956,04 "," 3.025,77 ",2938104002,CFD," 0,00 "
10/02/2025 14:26:14,Open Position,USD/JPY," 199,99 ",6000," 0,00 "," 5.956,04 "," 2.825,78 ",2938106058,CFD," 0,00 "
10/02/2025 14:37:09,Position closed,USD/JPY," 202,29 ",6000," 2,29 "," 5.958,33 "," 3.028,07 ",2938104201,CFD," 0,00 "
10/02/2025 14:37:23,Open Position,USD/JPY," 250,00 ",7500," 0,00 "," 5.958,33 "," 2.778,07 ",2938293381,CFD," 0,00 "
10/02/2025 14:37:51,Open Position,USD/JPY," 199,99 ",6000," 0,00 "," 5.958,33 "," 2.578,08 ",2938294683,CFD," 0,00 "
10/02/2025 14:56:36,Position closed,USD/JPY," 251,68 ",7500," 1,68 "," 5.960,01 "," 2.829,76 ",2938293381,CFD," 0,00 "
10/02/2025 14:56:46,Open Position,USD/JPY," 298,82 ",7500," 0,00 "," 5.960,01 "," 2.579,76 ",2938476606,CFD," 0,00 "
10/02/2025 15:11:38,Position closed,NSDQ100/USD," 313,30 ",0.276581," 13,31 "," 5.973,32 "," 2.893,06 ",2938098354,CFD," 0,00 "
10/02/2025 15:12:00,Open Position,NSDQ100/USD," 249,98 ",0.229936," 0,00 "," 5.973,32 "," 2.643,08 ",2938511603,CFD," 0,00 "
10/02/2025 15:20:01,Position closed,NSDQ100/USD," 250,69 ",0.229936," 0,71 "," 5.974,03 "," 2.893,77 ",2938511603,CFD," 0,00 "
10/02/2025 15:20:17,Open Position,NSDQ100/USD," 199,98 ",0.18387," 0,00 "," 5.974,03 "," 2.693,79 ",2938529584,CFD," 0,00 "
10/02/2025 15:24:13,Position closed,NSDQ100/USD," 202,82 ",0.18387," 2,84 "," 5.976,87 "," 2.896,61 ",2938529584,CFD," 0,00 "
10/02/2025 15:24:24,Open Position,NSDQ100/USD," 300,00 ",0.2756," 0,00 "," 5.976,87 "," 2.596,61 ",2938542640,CFD," 0,00 "
10/02/2025 15:36:51,Position closed,NSDQ100/USD," 301,01 ",0.2756," 1,01 "," 5.977,88 "," 2.897,62 ",2938542640,CFD," 0,00 "
10/02/2025 15:37:06,Open Position,NSDQ100/USD," 259,98 ",0.238794," 0,00 "," 5.977,88 "," 2.637,64 ",2938566001,CFD," 0,00 "
10/02/2025 15:47:58,Position closed,NSDQ100/USD," 263,01 ",0.238794," 3,03 "," 5.980,91 "," 2.900,65 ",2938566001,CFD," 0,00 "
10/02/2025 15:48:16,Open Position,NSDQ100/USD," 306,61 ",0.229433," 0,00 "," 5.980,91 "," 2.650,67 ",2938586783,CFD," 0,00 "
10/02/2025 16:13:19,Open Position,USD/JPY," 199,99 ",6000," 0,00 "," 5.980,91 "," 2.450,68 ",2938639501,CFD," 0,00 "
10/02/2025 16:52:30,Position closed,USD/JPY," 203,03 ",6000," 3,04 "," 5.983,95 "," 2.653,71 ",2938294683,CFD," 0,00 "
10/02/2025 16:52:36,Position closed,USD/JPY," 203,75 ",6000," 3,76 "," 5.987,71 "," 2.857,46 ",2938639501,CFD," 0,00 "
10/02/2025 16:53:03,Open Position,USD/JPY," 299,99 ",9000," 0,00 "," 5.987,71 "," 2.557,47 ",2938687250,CFD," 0,00 "
10/02/2025 17:18:15,Open Position,NSDQ100/USD," 199,99 ",0.184009," 0,00 "," 5.987,71 "," 2.357,48 ",2938718070,CFD," 0,00 "
10/02/2025 17:18:55,Position closed,USD/JPY," 301,77 ",9000," 1,78 "," 5.989,49 "," 2.659,25 ",2938687250,CFD," 0,00 "
10/02/2025 17:19:16,Open Position,USD/JPY," 199,99 ",6000," 0,00 "," 5.989,49 "," 2.459,26 ",2938719093,CFD," 0,00 "
10/02/2025 17:40:00,Position closed,USD/JPY," 201,02 ",6000," 1,03 "," 5.990,52 "," 2.660,28 ",2938106058,CFD," 0,00 "
10/02/2025 17:45:26,Position closed,USD/JPY," 202,60 ",6000," 2,61 "," 5.993,13 "," 2.862,88 ",2938719093,CFD," 0,00 "
10/02/2025 17:45:47,Open Position,USD/JPY," 200,00 ",6000," 0,00 "," 5.993,13 "," 2.662,88 ",2938742412,CFD," 0,00 "
10/02/2025 17:45:53,Open Position,USD/JPY," 199,99 ",6000," 0,00 "," 5.993,13 "," 2.462,89 ",2938742453,CFD," 0,00 "
10/02/2025 18:06:04,Position closed,USD/JPY," 202,71 ",6000," 2,72 "," 5.995,85 "," 2.665,60 ",2938742453,CFD," 0,00 "
10/02/2025 18:06:17,Open Position,USD/JPY," 199,99 ",6000," 0,00 "," 5.995,85 "," 2.465,61 ",2938761630,CFD," 0,00 "
10/02/2025 18:06:27,Open Position,USD/JPY," 300,00 ",9000," 0,00 "," 5.995,85 "," 2.165,61 ",2938761725,CFD," 0,00 "
10/02/2025 18:06:48,Position closed,NSDQ100/USD," 206,01 ",0.184009," 6,02 "," 6.001,87 "," 2.371,62 ",2938718070,CFD," 0,00 "
10/02/2025 18:11:00,Open Position,NSDQ100/USD," 230,00 ",0.211326," 0,00 "," 6.001,87 "," 2.141,62 ",2938764911,CFD," 0,00 "
10/02/2025 18:45:33,Position closed,USD/JPY," 201,61 ",6000," 1,62 "," 6.003,49 "," 2.343,23 ",2938761630,CFD," 0,00 "
10/02/2025 18:45:55,Open Position,USD/JPY," 249,99 ",7500," 0,00 "," 6.003,49 "," 2.093,24 ",2938792867,CFD," 0,00 "
10/02/2025 18:54:59,Position closed,USD/JPY," 251,47 ",7500," 1,48 "," 6.004,97 "," 2.344,71 ",2938792867,CFD," 0,00 "
10/02/2025 18:55:08,Open Position,USD/JPY," 62,49 ",7500," 0,00 "," 6.004,97 "," 2.094,72 ",2938799658,CFD," 0,00 "
10/02/2025 19:56:18,Open Position,USD/JPY," 149,99 ",4500," 0,00 "," 6.004,97 "," 1.944,73 ",2938866323,CFD," 0,00 "
10/02/2025 20:04:16,Position closed,USD/JPY," 148,72 ",4500,"(1,27)"," 6.003,70 "," 2.093,45 ",2938866323,CFD," 0,00 "
10/02/2025 21:04:49,Position closed,NSDQ100/USD," 235,42 ",0.211326," 5,42 "," 6.009,12 "," 2.328,87 ",2938764911,CFD," 0,00 "
10/02/2025 21:05:06,Open Position,NSDQ100/USD," 199,98 ",0.183984," 0,00 "," 6.009,12 "," 2.128,89 ",2938927423,CFD," 0,00 "
10/02/2025 22:13:28,Open Position,USD/JPY," 149,99 ",4500," 0,00 "," 6.009,12 "," 1.978,90 ",2938932192,CFD," 0,00 "
10/02/2025 23:08:27,Position closed,NSDQ100/USD," 205,96 ",0.183984," 5,98 "," 6.015,10 "," 2.184,86 ",2938927423,CFD," 0,00 "
10/02/2025 23:09:01,Open Position,NSDQ100/USD," 199,99 ",0.18432," 0,00 "," 6.015,10 "," 1.984,87 ",2938937532,CFD," 0,00 "
11/02/2025 00:07:22,Position closed,USD/JPY," 312,81 ",9000," 12,81 "," 6.027,91 "," 2.297,68 ",2938761725,CFD," 0,00 "
11/02/2025 00:09:41,Position closed,USD/JPY," 206,33 ",6000," 6,33 "," 6.034,24 "," 2.504,01 ",2938742412,CFD," 0,00 "
11/02/2025 00:09:52,Position closed,USD/JPY," 156,43 ",4500," 6,44 "," 6.040,68 "," 2.660,44 ",2938932192,CFD," 0,00 "
11/02/2025 00:10:25,Position closed,NSDQ100/USD," 201,86 ",0.18432," 1,87 "," 6.042,55 "," 2.862,30 ",2938937532,CFD," 0,00 "
11/02/2025 00:12:37,Open Position,USD/JPY," 199,99 ",6000," 0,00 "," 6.042,55 "," 2.662,31 ",2938942480,CFD," 0,00 "
11/02/2025 00:13:42,Index price adjustment,NSDQ100/USD," 0,11 ",-," 0,11 "," 6.042,66 "," 2.662,42 ",2938586783,CFD," 0,00 "
11/02/2025 00:13:42,Index price adjustment,NSDQ100/USD,"(0,10)",-,"(0,10)"," 6.042,56 "," 2.662,32 ",2938764911,CFD," 0,00 "
11/02/2025 00:26:22,Position closed,USD/JPY," 205,72 ",6000," 5,73 "," 6.048,29 "," 2.868,04 ",2938942480,CFD," 0,00 "
11/02/2025 00:26:38,Open Position,USD/JPY," 199,99 ",6000," 0,00 "," 6.048,29 "," 2.668,05 ",2938943077,CFD," 0,00 "
11/02/2025 00:47:44,Overnight refund,Daily," 0,82 ",-," 0,82 "," 6.049,11 "," 2.668,87 ",2934171930,CFD," 0,00 "
11/02/2025 00:47:44,Overnight refund,Daily," 0,58 ",-," 0,58 "," 6.049,69 "," 2.669,45 ",2938799658,CFD," 0,00 "
11/02/2025 00:47:44,Overnight refund,Daily," 0,58 ",-," 0,58 "," 6.050,27 "," 2.670,03 ",2934269338,CFD," 0,00 "
11/02/2025 00:47:44,Overnight refund,Daily," 0,47 ",-," 0,47 "," 6.050,74 "," 2.670,50 ",2938050369,CFD," 0,00 "
11/02/2025 00:47:44,Overnight refund,Daily," 0,35 ",-," 0,35 "," 6.051,09 "," 2.670,85 ",2934085495,CFD," 0,00 "
11/02/2025 00:47:44,Overnight fee,Daily,"(0,06)",-,"(0,06)"," 6.051,03 "," 2.670,79 ",2938927423,CFD," 0,00 "
11/02/2025 00:47:44,Overnight fee,Daily,"(0,69)",-,"(0,69)"," 6.050,34 "," 2.670,10 ",2937534559,CFD," 0,00 "
11/02/2025 00:47:44,Overnight fee,Daily,"(0,92)",-,"(0,92)"," 6.049,42 "," 2.669,18 ",2938742412,CFD," 0,00 "
11/02/2025 00:47:44,Overnight fee,Daily,"(1,15)",-,"(1,15)"," 6.048,27 "," 2.668,03 ",2938476606,CFD," 0,00 "
11/02/2025 00:47:44,Overnight fee,Daily,"(1,20)",-,"(1,20)"," 6.047,07 "," 2.666,83 ",2938586783,CFD," 0,00 "
11/02/2025 00:47:44,Overnight fee,Daily,"(1,38)",-,"(1,38)"," 6.045,69 "," 2.665,45 ",2938761725,CFD," 0,00 "
11/02/2025 00:47:44,Overnight fee,Daily,"(2,30)",-,"(2,30)"," 6.043,39 "," 2.663,15 ",2936693236,CFD," 0,00 "
11/02/2025 01:28:58,Position closed,USD/JPY," 205,79 ",6000," 5,80 "," 6.049,19 "," 2.868,94 ",2938943077,CFD," 0,00 "
11/02/2025 06:15:42,Open Position,USD/JPY," 199,99 ",6000," 0,00 "," 6.049,19 "," 2.668,95 ",2938980296,CFD," 0,00 "
11/02/2025 06:16:13,Position closed,USD/JPY," 199,56 ",6000,"(0,43)"," 6.048,76 "," 2.868,51 ",2938980296,CFD," 0,00 "
11/02/2025 06:17:08,Open Position,USD/JPY," 149,99 ",4500," 0,00 "," 6.048,76 "," 2.718,52 ",2938980481,CFD," 0,00 "
11/02/2025 07:33:19,Position closed,USD/JPY," 121,22 ",3750.086681,"(3,78)"," 6.044,98 "," 2.839,74 ",2938994692,CFD," 0,00 "
11/02/2025 07:37:44,Position closed,USD/JPY," 133,92 ",4501.846542,"(84,95)"," 5.960,03 "," 2.973,66 ",2934085495,CFD," 0,00 "
11/02/2025 08:35:40,Position closed,USD/JPY," 156,13 ",4500," 6,14 "," 5.966,17 "," 3.129,79 ",2938980481,CFD," 0,00 "
11/02/2025 08:36:39,Open Position,NSDQ100/USD," 249,99 ",0.230757," 0,00 "," 5.966,17 "," 2.879,80 ",2939081516,CFD," 0,00 "
11/02/2025 08:38:49,Open Position,USD/JPY," 199,99 ",6000," 0,00 "," 5.966,17 "," 2.679,81 ",2939081978,CFD," 0,00 "
11/02/2025 08:41:40,Position closed,USD/JPY," 201,81 ",6000," 1,82 "," 5.967,99 "," 2.881,62 ",2939081978,CFD," 0,00 "
11/02/2025 08:41:53,Position closed,NSDQ100/USD," 252,47 ",0.230757," 2,48 "," 5.970,47 "," 3.134,09 ",2939081516,CFD," 0,00 "
11/02/2025 08:43:09,Open Position,USD/JPY," 199,99 ",6000," 0,00 "," 5.970,47 "," 2.934,10 ",2939082962,CFD," 0,00 "
11/02/2025 09:00:36,Position closed,USD/JPY," 201,77 ",6000," 1,78 "," 5.972,25 "," 3.135,87 ",2939082962,CFD," 0,00 "
11/02/2025 09:00:47,Open Position,USD/JPY," 199,99 ",6000," 0,00 "," 5.972,25 "," 2.935,88 ",2939086651,CFD," 0,00 "
11/02/2025 09:18:16,Position closed,USD/JPY," 202,16 ",6000," 2,17 "," 5.974,42 "," 3.138,04 ",2939086651,CFD," 0,00 "
11/02/2025 09:19:24,Open Position,USD/JPY," 282,44 ",7500," 0,00 "," 5.974,42 "," 2.888,04 ",2939094941,CFD," 0,00 "
11/02/2025 09:20:57,Position closed,USD/JPY," 60,62 ",1874.985136,"(1,88)"," 5.972,54 "," 2.948,66 ",2939095226,CFD," 0,00 "
11/02/2025 09:22:43,Open Position,USD/JPY," 199,99 ",6000," 0,00 "," 5.972,54 "," 2.748,67 ",2939095588,CFD," 0,00 "
11/02/2025 10:05:16,Position closed,USD/JPY," 200,98 ",6000," 0,99 "," 5.973,53 "," 2.949,65 ",2939095588,CFD," 0,00 "
11/02/2025 10:40:00,Position closed,USD/JPY," 62,85 ",1874.928183," 0,36 "," 5.973,89 "," 3.012,50 ",2938799658,CFD," 0,00 "
11/02/2025 10:57:49,Open Position,USD/JPY," 199,99 ",6000," 0,00 "," 5.973,89 "," 2.812,51 ",2939122021,CFD," 0,00 "
11/02/2025 10:59:41,Open Position,USD/JPY," 437,44 ",12000," 0,00 "," 5.973,89 "," 2.412,52 ",2939122280,CFD," 0,00 "
11/02/2025 11:10:05,Position closed,USD/JPY," 201,13 ",6000," 1,14 "," 5.975,03 "," 2.613,65 ",2939122021,CFD," 0,00 "
11/02/2025 11:10:33,Open Position,USD/JPY," 150,00 ",4500," 0,00 "," 5.975,03 "," 2.463,65 ",2939124075,CFD," 0,00 "
11/02/2025 11:26:40,Position closed,USD/JPY," 150,92 ",4500," 0,92 "," 5.975,95 "," 2.614,57 ",2939124075,CFD," 0,00 "
11/02/2025 11:27:48,Position closed,USD/JPY," 200,70 ",6000," 0,71 "," 5.976,66 "," 2.815,27 ",2938050369,CFD," 0,00 "
11/02/2025 11:30:15,Position closed,USD/JPY," 54,00 ",1684.264595,"(25,48)"," 5.951,18 "," 2.869,27 ",2939127443,CFD," 0,00 "
11/02/2025 11:30:54,Position closed,USD/JPY," 33,34 ",1040.072185,"(15,74)"," 5.935,44 "," 2.902,61 ",2939127513,CFD," 0,00 "
11/02/2025 11:31:52,Open Position,USD/JPY," 1.000,00 ",30000," 0,00 "," 5.935,44 "," 1.902,61 ",2939127638,CFD," 0,00 "
11/02/2025 11:32:01,Open Position,USD/JPY," 199,99 ",6000," 0,00 "," 5.935,44 "," 1.702,62 ",2939127655,CFD," 0,00 "
11/02/2025 11:38:53,Position closed,USD/JPY," 200,62 ",6000," 0,63 "," 5.936,07 "," 1.903,24 ",2939127655,CFD," 0,00 "
11/02/2025 11:47:01,Open Position,USD/JPY," 199,99 ",6000," 0,00 "," 5.936,07 "," 1.703,25 ",2939132287,CFD," 0,00 "
11/02/2025 12:17:36,Position closed,USD/JPY," 1.006,50 ",30000," 6,50 "," 5.942,57 "," 2.709,75 ",2939127638,CFD," 0,00 "
11/02/2025 12:17:48,Open Position,USD/JPY," 753,09 ",21000," 0,00 "," 5.942,57 "," 2.009,75 ",2939138544,CFD," 0,00 "
11/02/2025 12:52:26,Position closed,USD/JPY," 203,73 ",6000," 3,74 "," 5.946,31 "," 2.213,48 ",2939132287,CFD," 0,00 "
11/02/2025 12:52:49,Position closed,USD/JPY," 157,16 ",4775.66322,"(68,22)"," 5.878,09 "," 2.370,64 ",2934269338,CFD," 0,00 "
11/02/2025 12:53:18,Open Position,USD/JPY," 300,00 ",9000," 0,00 "," 5.878,09 "," 2.070,64 ",2939147063,CFD," 0,00 "
11/02/2025 12:53:30,Open Position,USD/JPY," 199,99 ",6000," 0,00 "," 5.878,09 "," 1.870,65 ",2939147125,CFD," 0,00 "
11/02/2025 13:00:21,Open Position,USD/JPY," 250,00 ",7500," 0,00 "," 5.878,09 "," 1.620,65 ",2939149203,CFD," 0,00 "
11/02/2025 13:03:56,Position closed,USD/JPY," 198,49 ",6000,"(1,50)"," 5.876,59 "," 1.819,14 ",2939147125,CFD," 0,00 "
11/02/2025 13:03:59,Position closed,USD/JPY," 301,48 ",9000," 1,48 "," 5.878,07 "," 2.120,62 ",2939147063,CFD," 0,00 "
11/02/2025 13:04:11,Open Position,USD/JPY," 350,00 ",10500," 0,00 "," 5.878,07 "," 1.770,62 ",2939150987,CFD," 0,00 "
11/02/2025 13:06:22,Position closed,USD/JPY," 251,53 ",7500," 1,53 "," 5.879,60 "," 2.022,15 ",2939149203,CFD," 0,00 "
11/02/2025 13:06:30,Open Position,USD/JPY," 300,00 ",9000," 0,00 "," 5.879,60 "," 1.722,15 ",2939151775,CFD," 0,00 "
11/02/2025 14:00:59,Position closed,USD/JPY," 303,31 ",9000," 3,31 "," 5.882,91 "," 2.025,46 ",2939151775,CFD," 0,00 "
11/02/2025 14:01:33,Position closed,USD/JPY," 354,41 ",10500," 4,41 "," 5.887,32 "," 2.379,87 ",2939150987,CFD," 0,00 "
11/02/2025 14:01:43,Open Position,USD/JPY," 319,21 ",9000," 0,00 "," 5.887,32 "," 2.079,87 ",2939176899,CFD," 0,00 "
11/02/2025 15:01:25,Open Position,USD/JPY," 199,99 ",6000," 0,00 "," 5.887,32 "," 1.879,88 ",2939479263,CFD," 0,00 "
11/02/2025 15:16:03,Position closed,USD/JPY," 203,45 ",6000," 3,46 "," 5.890,78 "," 2.083,33 ",2939479263,CFD," 0,00 "
11/02/2025 15:16:12,Open Position,USD/JPY," 219,99 ",6600," 0,00 "," 5.890,78 "," 1.863,34 ",2939528360,CFD," 0,00 "
11/02/2025 15:21:27,Position closed,USD/JPY," 221,16 ",6600," 1,17 "," 5.891,95 "," 2.084,50 ",2939528360,CFD," 0,00 "
11/02/2025 15:21:41,Open Position,USD/JPY," 150,00 ",4500," 0,00 "," 5.891,95 "," 1.934,50 ",2939538569,CFD," 0,00 "
11/02/2025 15:24:16,Position closed,USD/JPY," 152,57 ",4500," 2,57 "," 5.894,52 "," 2.087,07 ",2939538569,CFD," 0,00 "
11/02/2025 15:24:34,Open Position,USD/JPY," 75,15 ",4500," 0,00 "," 5.894,52 "," 1.937,07 ",2939547138,CFD," 0,00 "
11/02/2025 15:31:26,Open Position,USD/JPY," 250,00 ",7500," 0,00 "," 5.894,52 "," 1.687,07 ",2939566015,CFD," 0,00 "
11/02/2025 16:02:54,Position closed,USD/JPY," 251,03 ",7500," 1,03 "," 5.895,55 "," 1.938,10 ",2939566015,CFD," 0,00 "
11/02/2025 16:03:04,Open Position,USD/JPY," 200,00 ",6000," 0,00 "," 5.895,55 "," 1.738,10 ",2939622981,CFD," 0,00 "
11/02/2025 16:07:22,Position closed,USD/JPY," 203,07 ",6000," 3,07 "," 5.898,62 "," 1.941,17 ",2939622981,CFD," 0,00 "
11/02/2025 16:07:38,Open Position,USD/JPY," 200,00 ",6000," 0,00 "," 5.898,62 "," 1.741,17 ",2939635537,CFD," 0,00 "
11/02/2025 16:25:29,Position closed,USD/JPY," 203,59 ",6000," 3,59 "," 5.902,21 "," 1.944,76 ",2939635537,CFD," 0,00 "
11/02/2025 16:26:14,Open Position,USD/JPY," 212,46 ",6000," 0,00 "," 5.902,21 "," 1.744,76 ",2939684671,CFD," 0,00 "
11/02/2025 16:30:51,Position closed,USD/JPY," 70,23 ",2245.359624,"(4,62)"," 5.897,59 "," 1.814,99 ",2939691891,CFD," 0,00 "
11/02/2025 17:16:53,Open Position,USD/JPY," 150,00 ",4500," 0,00 "," 5.897,59 "," 1.664,99 ",2939759662,CFD," 0,00 "
11/02/2025 17:34:26,Position closed,USD/JPY," 151,06 ",4500," 1,06 "," 5.898,65 "," 1.816,05 ",2939759662,CFD," 0,00 "
11/02/2025 18:16:10,Open Position,USD/JPY," 199,99 ",6000," 0,00 "," 5.898,65 "," 1.616,06 ",2939805071,CFD," 0,00 "
11/02/2025 18:39:27,Position closed,USD/JPY," 201,76 ",6000," 1,77 "," 5.900,42 "," 1.817,82 ",2939805071,CFD," 0,00 "
11/02/2025 18:39:43,Open Position,USD/JPY," 249,99 ",7500," 0,00 "," 5.900,42 "," 1.567,83 ",2939822007,CFD," 0,00 "
11/02/2025 19:13:40,Position closed,USD/JPY," 251,17 ",7500," 1,18 "," 5.901,60 "," 1.819,00 ",2939822007,CFD," 0,00 "
11/02/2025 19:13:49,Open Position,USD/JPY," 249,99 ",7500," 0,00 "," 5.901,60 "," 1.569,01 ",2939857015,CFD," 0,00 "
11/02/2025 19:24:39,Position closed,USD/JPY," 251,22 ",7500," 1,23 "," 5.902,83 "," 1.820,23 ",2939857015,CFD," 0,00 "
11/02/2025 20:09:17,Open Position,USD/JPY," 154,73 ",4500," 0,00 "," 5.902,83 "," 1.670,24 ",2939910134,CFD," 0,00 "
11/02/2025 20:17:42,Open Position,USD/JPY," 199,99 ",6000," 0,00 "," 5.902,83 "," 1.470,25 ",2939915050,CFD," 0,00 "
11/02/2025 20:30:21,Position closed,USD/JPY," 200,89 ",6000," 0,90 "," 5.903,73 "," 1.671,14 ",2939915050,CFD," 0,00 "
11/02/2025 20:30:30,Open Position,USD/JPY," 199,99 ",6000," 0,00 "," 5.903,73 "," 1.471,15 ",2939926029,CFD," 0,00 "
11/02/2025 20:35:26,Position closed,USD/JPY," 201,64 ",6000," 1,65 "," 5.905,38 "," 1.672,79 ",2939926029,CFD," 0,00 "
11/02/2025 20:35:42,Position closed,USD/JPY," 75,03 ",2254.640376,"(0,12)"," 5.905,26 "," 1.747,82 ",2939547138,CFD," 0,00 "
11/02/2025 20:35:59,Open Position,USD/JPY," 199,99 ",6000," 0,00 "," 5.905,26 "," 1.547,83 ",2939929044,CFD," 0,00 "
11/02/2025 20:36:14,Open Position,USD/JPY," 200,00 ",6000," 0,00 "," 5.905,26 "," 1.347,83 ",2939929345,CFD," 0,00 "
11/02/2025 20:46:38,Open Position,NSDQ100/USD," 199,99 ",0.184421," 0,00 "," 5.905,26 "," 1.147,84 ",2939936884,CFD," 0,00 "
11/02/2025 20:51:31,Position closed,USD/JPY," 201,57 ",6000," 1,57 "," 5.906,83 "," 1.349,41 ",2939929345,CFD," 0,00 "
11/02/2025 20:51:45,Open Position,USD/JPY," 149,99 ",4500," 0,00 "," 5.906,83 "," 1.199,42 ",2939942495,CFD," 0,00 "
11/02/2025 21:22:27,Position closed,USD/JPY," 151,32 ",4500," 1,33 "," 5.908,16 "," 1.350,74 ",2939942495,CFD," 0,00 "
11/02/2025 21:22:45,Position closed,NSDQ100/USD," 201,63 ",0.184421," 1,64 "," 5.909,80 "," 1.552,37 ",2939936884,CFD," 0,00 "
11/02/2025 23:06:44,Open Position,USD/JPY," 199,99 ",6000," 0,00 "," 5.909,80 "," 1.352,38 ",2939959774,CFD," 0,00 "
11/02/2025 23:27:44,Position closed,USD/JPY," 204,31 ",6000," 4,32 "," 5.914,12 "," 1.556,69 ",2939929044,CFD," 0,00 "
11/02/2025 23:27:51,Position closed,USD/JPY," 204,86 ",6000," 4,87 "," 5.918,99 "," 1.761,55 ",2939959774,CFD," 0,00 "
11/02/2025 23:28:09,Open Position,USD/JPY," 249,99 ",7500," 0,00 "," 5.918,99 "," 1.511,56 ",2939961386,CFD," 0,00 "
11/02/2025 23:29:55,Edit Stop Loss,-,"(26,50)",-," 0,00 "," 5.918,99 "," 1.485,06 ",2936693236,-," 0,00 "
11/02/2025 23:30:17,Edit Stop Loss,-,"(8,25)",-," 0,00 "," 5.918,99 "," 1.476,81 ",2937534559,-," 0,00 "
11/02/2025 23:30:36,Edit Stop Loss,-,"(19,12)",-," 0,00 "," 5.918,99 "," 1.457,69 ",2936693236,-," 0,00 "
11/02/2025 23:31:16,Edit Stop Loss,-,"(15,63)",-," 0,00 "," 5.918,99 "," 1.442,06 ",2938476606,-," 0,00 "
11/02/2025 23:31:23,Edit Stop Loss,-,"(14,29)",-," 0,00 "," 5.918,99 "," 1.427,77 ",2937534559,-," 0,00 "
11/02/2025 23:31:35,Edit Stop Loss,-,"(28,59)",-," 0,00 "," 5.918,99 "," 1.399,18 ",2936693236,-," 0,00 "
11/02/2025 23:32:05,Open Position,USD/JPY," 200,00 ",6000," 0,00 "," 5.918,99 "," 1.199,18 ",2939961593,CFD," 0,00 "
11/02/2025 23:35:58,Open Position,USD/JPY," 150,00 ",4500," 0,00 "," 5.918,99 "," 1.049,18 ",2939961766,CFD," 0,00 "
12/02/2025 00:09:31,Index price adjustment,NSDQ100/USD," 0,05 ",-," 0,05 "," 5.919,04 "," 1.049,23 ",2938586783,CFD," 0,00 "
12/02/2025 00:09:31,Index price adjustment,NSDQ100/USD," 0,04 ",-," 0,04 "," 5.919,08 "," 1.049,27 ",2939936884,CFD," 0,00 "
12/02/2025 00:35:27,Position closed,USD/JPY," 159,17 ",4500," 9,17 "," 5.928,25 "," 1.208,44 ",2939961766,CFD," 0,00 "
12/02/2025 00:35:54,Position closed,USD/JPY," 264,55 ",7500," 14,56 "," 5.942,81 "," 1.472,99 ",2939961386,CFD," 0,00 "
12/02/2025 00:37:10,Open Position,USD/JPY," 199,99 ",6000," 0,00 "," 5.942,81 "," 1.273,00 ",2939964334,CFD," 0,00 "
12/02/2025 00:47:49,Overnight refund,Daily," 0,82 ",-," 0,82 "," 5.943,63 "," 1.273,82 ",2934171930,CFD," 0,00 "
12/02/2025 00:47:49,Overnight refund,Daily," 0,47 ",-," 0,47 "," 5.944,10 "," 1.274,29 ",2939929044,CFD," 0,00 "
12/02/2025 00:47:49,Overnight fee,Daily,"(0,69)",-,"(0,69)"," 5.943,41 "," 1.273,60 ",2937534559,CFD," 0,00 "
12/02/2025 00:47:49,Overnight fee,Daily,"(0,69)",-,"(0,69)"," 5.942,72 "," 1.272,91 ",2939910134,CFD," 0,00 "
12/02/2025 00:47:49,Overnight fee,Daily,"(0,92)",-,"(0,92)"," 5.941,80 "," 1.271,99 ",2939684671,CFD," 0,00 "
12/02/2025 00:47:49,Overnight fee,Daily,"(1,15)",-,"(1,15)"," 5.940,65 "," 1.270,84 ",2939094941,CFD," 0,00 "
12/02/2025 00:47:49,Overnight fee,Daily,"(1,15)",-,"(1,15)"," 5.939,50 "," 1.269,69 ",2938476606,CFD," 0,00 "
12/02/2025 00:47:49,Overnight fee,Daily,"(1,20)",-,"(1,20)"," 5.938,30 "," 1.268,49 ",2938586783,CFD," 0,00 "
12/02/2025 00:47:49,Overnight fee,Daily,"(1,38)",-,"(1,38)"," 5.936,92 "," 1.267,11 ",2939176899,CFD," 0,00 "
12/02/2025 00:47:49,Overnight fee,Daily,"(1,84)",-,"(1,84)"," 5.935,08 "," 1.265,27 ",2939122280,CFD," 0,00 "
12/02/2025 00:47:49,Overnight fee,Daily,"(2,30)",-,"(2,30)"," 5.932,78 "," 1.262,97 ",2936693236,CFD," 0,00 "
12/02/2025 00:47:49,Overnight fee,Daily,"(3,22)",-,"(3,22)"," 5.929,56 "," 1.259,75 ",2939138544,CFD," 0,00 "
12/02/2025 05:40:17,Position closed,USD/JPY," 222,68 ",6000," 22,69 "," 5.952,25 "," 1.482,43 ",2939964334,CFD," 0,00 "
12/02/2025 05:42:31,Open Position,USD/JPY," 199,99 ",6000," 0,00 "," 5.952,25 "," 1.282,44 ",2940011132,CFD," 0,00 "
12/02/2025 05:51:36,Open Position,USD/JPY," 199,99 ",6000," 0,00 "," 5.952,25 "," 1.082,45 ",2940011546,CFD," 0,00 "
12/02/2025 05:53:39,Position closed,USD/JPY," 212,24 ",5239.825705,"(41,02)"," 5.911,23 "," 1.294,69 ",2940011657,CFD," 0,00 "
12/02/2025 05:54:10,Edit Stop Loss,-,"(18,99)",-," 0,00 "," 5.911,23 "," 1.275,70 ",2936693236,-," 0,00 "
12/02/2025 05:54:45,Edit Stop Loss,-,"(3,95)",-," 0,00 "," 5.911,23 "," 1.271,75 ",2939094941,-," 0,00 "
12/02/2025 05:59:32,Open Position,USD/JPY," 99,99 ",3000," 0,00 "," 5.911,23 "," 1.171,76 ",2940012077,CFD," 0,00 "
12/02/2025 06:06:48,Edit Stop Loss,-,"(47,28)",-," 0,00 "," 5.911,23 "," 1.124,48 ",2936693236,-," 0,00 "
12/02/2025 06:07:00,Edit Stop Loss,-,"(14,21)",-," 0,00 "," 5.911,23 "," 1.110,27 ",2937534559,-," 0,00 "
12/02/2025 06:07:12,Edit Stop Loss,-,"(23,74)",-," 0,00 "," 5.911,23 "," 1.086,53 ",2938476606,-," 0,00 "
12/02/2025 06:07:26,Edit Stop Loss,-,"(19,02)",-," 0,00 "," 5.911,23 "," 1.067,51 ",2939094941,-," 0,00 "
12/02/2025 06:07:43,Edit Stop Loss,-,"(22,27)",-," 0,00 "," 5.911,23 "," 1.045,24 ",2939122280,-," 0,00 "
12/02/2025 06:08:08,Edit Stop Loss,-,"(26,51)",-," 0,00 "," 5.911,23 "," 1.018,73 ",2939138544,-," 0,00 "
12/02/2025 06:08:17,Edit Stop Loss,-,"(4,86)",-," 0,00 "," 5.911,23 "," 1.013,87 ",2939684671,-," 0,00 "
12/02/2025 06:09:07,Open Position,NSDQ100/USD," 199,98 ",0.184425," 0,00 "," 5.911,23 "," 813,89 ",2940012669,CFD," 0,00 "
12/02/2025 06:12:29,Open Position,USD/JPY," 100,00 ",3000," 0,00 "," 5.911,23 "," 713,89 ",2940012915,CFD," 0,00 "
12/02/2025 06:23:42,Position closed,USD/JPY," 202,41 ",6000," 2,42 "," 5.913,65 "," 916,30 ",2940011132,CFD," 0,00 "
12/02/2025 06:23:49,Position closed,USD/JPY," 202,61 ",6000," 2,62 "," 5.916,27 "," 1.118,91 ",2940011546,CFD," 0,00 "
12/02/2025 06:23:56,Position closed,USD/JPY," 101,41 ",3000," 1,41 "," 5.917,68 "," 1.220,32 ",2940012915,CFD," 0,00 "
12/02/2025 06:24:03,Position closed,USD/JPY," 97,73 ",3000,"(2,26)"," 5.915,42 "," 1.318,05 ",2940012077,CFD," 0,00 "
12/02/2025 06:24:23,Open Position,USD/JPY," 350,00 ",10500," 0,00 "," 5.915,42 "," 968,05 ",2940014070,CFD," 0,00 "
12/02/2025 06:40:47,Position closed,USD/JPY," 352,94 ",10500," 2,94 "," 5.918,36 "," 1.320,99 ",2940014070,CFD," 0,00 "
12/02/2025 06:41:09,Position closed,NSDQ100/USD," 201,37 ",0.184425," 1,39 "," 5.919,75 "," 1.522,36 ",2940012669,CFD," 0,00 "
12/02/2025 06:41:25,Open Position,NSDQ100/USD," 199,99 ",0.184319," 0,00 "," 5.919,75 "," 1.322,37 ",2940015126,CFD," 0,00 "
12/02/2025 06:41:51,Open Position,USD/JPY," 400,00 ",12000," 0,00 "," 5.919,75 "," 922,37 ",2940015163,CFD," 0,00 "
12/02/2025 07:31:23,Open Position,USD/JPY," 199,99 ",6000," 0,00 "," 5.919,75 "," 722,38 ",2940021146,CFD," 0,00 "
12/02/2025 07:34:35,Position closed,USD/JPY," 202,80 ",6000," 2,81 "," 5.922,56 "," 925,18 ",2940021146,CFD," 0,00 "
12/02/2025 07:35:21,Open Position,USD/JPY," 150,00 ",4500," 0,00 "," 5.922,56 "," 775,18 ",2940021408,CFD," 0,00 "
12/02/2025 07:39:05,Open Position,USD/JPY," 100,00 ",3000," 0,00 "," 5.922,56 "," 675,18 ",2940021754,CFD," 0,00 "
12/02/2025 07:48:26,Position closed,USD/JPY," 100,63 ",3000," 0,63 "," 5.923,19 "," 775,81 ",2940021754,CFD," 0,00 "
12/02/2025 07:59:31,Position closed,USD/JPY," 153,16 ",4500," 3,16 "," 5.926,35 "," 928,97 ",2940021408,CFD," 0,00 "
12/02/2025 07:59:45,Open Position,USD/JPY," 249,99 ",7500," 0,00 "," 5.926,35 "," 678,98 ",2940024212,CFD," 0,00 "
12/02/2025 08:02:43,Position closed,USD/JPY," 406,94 ",12000," 6,94 "," 5.933,29 "," 1.085,92 ",2940015163,CFD," 0,00 "
12/02/2025 08:02:47,Position closed,USD/JPY," 255,60 ",7500," 5,61 "," 5.938,90 "," 1.341,52 ",2940024212,CFD," 0,00 "
12/02/2025 08:02:55,Open Position,USD/JPY," 499,99 ",15000," 0,00 "," 5.938,90 "," 841,53 ",2940042177,CFD," 0,00 "
12/02/2025 08:05:06,Position closed,NSDQ100/USD," 202,61 ",0.184319," 2,62 "," 5.941,52 "," 1.044,14 ",2940015126,CFD," 0,00 "
12/02/2025 08:05:16,Open Position,NSDQ100/USD," 199,99 ",0.184163," 0,00 "," 5.941,52 "," 844,15 ",2940044880,CFD," 0,00 "
12/02/2025 08:12:20,Open Position,USD/JPY," 100,00 ",3000," 0,00 "," 5.941,52 "," 744,15 ",2940047387,CFD," 0,00 "
12/02/2025 09:12:36,Open Position,USD/JPY," 150,00 ",4500," 0,00 "," 5.941,52 "," 594,15 ",2940072439,CFD," 0,00 "
12/02/2025 09:46:20,Position closed,USD/JPY," 152,11 ",4500," 2,11 "," 5.943,63 "," 746,26 ",2940072439,CFD," 0,00 "
12/02/2025 09:46:33,Open Position,USD/JPY," 199,99 ",6000," 0,00 "," 5.943,63 "," 546,27 ",2940079183,CFD," 0,00 "
12/02/2025 10:11:22,Position closed,USD/JPY," 201,36 ",6000," 1,37 "," 5.945,00 "," 747,63 ",2940079183,CFD," 0,00 "
12/02/2025 10:11:33,Open Position,USD/JPY," 150,00 ",4500," 0,00 "," 5.945,00 "," 597,63 ",2940084825,CFD," 0,00 "
12/02/2025 10:27:42,Position closed,USD/JPY," 151,05 ",4500," 1,05 "," 5.946,05 "," 748,68 ",2940084825,CFD," 0,00 "
12/02/2025 11:03:47,Open Position,USD/JPY," 199,99 ",6000," 0,00 "," 5.946,05 "," 548,69 ",2940095705,CFD," 0,00 "
12/02/2025 12:12:47,Position closed,USD/JPY," 201,59 ",6000," 1,60 "," 5.947,65 "," 750,28 ",2940095705,CFD," 0,00 "
12/02/2025 12:34:37,Open Position,USD/JPY," 100,00 ",3000," 0,00 "," 5.947,65 "," 650,28 ",2940115048,CFD," 0,00 "
12/02/2025 12:40:25,Position closed,NSDQ100/USD," 200,81 ",0.184163," 0,82 "," 5.948,47 "," 851,09 ",2940044880,CFD," 0,00 "
12/02/2025 12:56:50,Position closed,USD/JPY," 100,92 ",3000," 0,92 "," 5.949,39 "," 952,01 ",2940115048,CFD," 0,00 "
12/02/2025 13:01:00,Open Position,USD/JPY," 199,99 ",6000," 0,00 "," 5.949,39 "," 752,02 ",2940121076,CFD," 0,00 "
12/02/2025 13:32:42,Position closed,USD/JPY," 229,92 ",6000," 29,93 "," 5.979,32 "," 981,94 ",2940121076,CFD," 0,00 "
12/02/2025 13:32:46,Position closed,USD/JPY," 548,39 ",15000," 48,40 "," 6.027,72 "," 1.530,33 ",2940042177,CFD," 0,00 "
12/02/2025 13:33:07,Position closed,USD/JPY," 113,10 ",3000," 13,10 "," 6.040,82 "," 1.643,43 ",2940047387,CFD," 0,00 "
12/02/2025 13:34:27,Open Position,USD/JPY," 199,99 ",6000," 0,00 "," 6.040,82 "," 1.443,44 ",2940137986,CFD," 0,00 "
12/02/2025 13:38:37,Position closed,USD/JPY," 201,86 ",6000," 1,87 "," 6.042,69 "," 1.645,30 ",2940137986,CFD," 0,00 "
12/02/2025 13:38:44,Open Position,USD/JPY," 599,99 ",18000," 0,00 "," 6.042,69 "," 1.045,31 ",2940142086,CFD," 0,00 "
12/02/2025 13:39:01,Position closed,USD/JPY," 601,97 ",18000," 1,98 "," 6.044,67 "," 1.647,28 ",2940142086,CFD," 0,00 "
12/02/2025 13:39:09,Open Position,USD/JPY," 1.000,00 ",30000," 0,00 "," 6.044,67 "," 647,28 ",2940142571,CFD," 0,00 "
12/02/2025 13:40:17,Position closed,USD/JPY," 1.001,36 ",30000," 1,36 "," 6.046,03 "," 1.648,64 ",2940142571,CFD," 0,00 "
12/02/2025 13:40:27,Open Position,USD/JPY," 1.000,00 ",30000," 0,00 "," 6.046,03 "," 648,64 ",2940143549,CFD," 0,00 "
12/02/2025 13:40:54,Edit Stop Loss,-,"(56,63)",-," 0,00 "," 6.046,03 "," 592,01 ",2938586783,-," 0,00 "
12/02/2025 13:54:12,Position closed,USD/JPY," 999,22 ",30000,"(0,78)"," 6.045,25 "," 1.591,23 ",2940143549,CFD," 0,00 "
12/02/2025 13:54:24,Open Position,USD/JPY," 249,99 ",7500," 0,00 "," 6.045,25 "," 1.341,24 ",2940153099,CFD," 0,00 "
12/02/2025 14:10:47,Open Position,USD/JPY," 199,99 ",6000," 0,00 "," 6.045,25 "," 1.141,25 ",2940160993,CFD," 0,00 "
12/02/2025 14:18:23,Open Position,USD/JPY," 249,99 ",7500," 0,00 "," 6.045,25 "," 891,26 ",2940168006,CFD," 0,00 "
12/02/2025 14:18:37,Open Position,USD/JPY," 249,99 ",7500," 0,00 "," 6.045,25 "," 641,27 ",2940168196,CFD," 0,00 "
12/02/2025 14:19:02,Position closed,USD/JPY," 250,33 ",7500," 0,34 "," 6.045,59 "," 891,60 ",2940168006,CFD," 0,00 "
12/02/2025 14:27:41,Open Position,USD/JPY," 100,00 ",3000," 0,00 "," 6.045,59 "," 791,60 ",2940175707,CFD," 0,00 "
12/02/2025 14:32:59,Open Position,NSDQ100/USD," 199,99 ",0.186202," 0,00 "," 6.045,59 "," 591,61 ",2940267491,CFD," 0,00 "
12/02/2025 14:35:04,Position closed,NSDQ100/USD," 203,59 ",0.186202," 3,60 "," 6.049,19 "," 795,20 ",2940267491,CFD," 0,00 "
12/02/2025 14:35:12,Open Position,NSDQ100/USD," 249,99 ",0.232461," 0,00 "," 6.049,19 "," 545,21 ",2940278204,CFD," 0,00 "
12/02/2025 14:39:44,Position closed,NSDQ100/USD," 252,91 ",0.232461," 2,92 "," 6.052,11 "," 798,12 ",2940278204,CFD," 0,00 "
12/02/2025 14:40:21,Open Position,NSDQ100/USD," 61,49 ",0.092954," 0,00 "," 6.052,11 "," 698,13 ",2940436584,CFD," 0,00 "
12/02/2025 14:41:02,Open Position,NSDQ100/USD," 199,99 ",0.185787," 0,00 "," 6.052,11 "," 498,14 ",2940455027,CFD," 0,00 "
12/02/2025 14:41:53,Position closed,NSDQ100/USD," 201,11 ",0.185787," 1,12 "," 6.053,23 "," 699,25 ",2940455027,CFD," 0,00 "
12/02/2025 14:47:11,Position closed,USD/JPY," 101,40 ",3000," 1,40 "," 6.054,63 "," 800,65 ",2940175707,CFD," 0,00 "
12/02/2025 14:47:26,Open Position,NSDQ100/USD," 150,00 ",0.138998," 0,00 "," 6.054,63 "," 650,65 ",2940547784,CFD," 0,00 "
12/02/2025 14:48:57,Open Position,USD/JPY," 150,00 ",4500," 0,00 "," 6.054,63 "," 500,65 ",2940550596,CFD," 0,00 "
12/02/2025 14:50:29,Position closed,USD/JPY," 253,63 ",7500," 3,64 "," 6.058,27 "," 754,28 ",2940168196,CFD," 0,00 "
12/02/2025 14:51:35,Open Position,USD/JPY," 199,99 ",6000," 0,00 "," 6.058,27 "," 554,29 ",2940619663,CFD," 0,00 "
12/02/2025 14:56:39,Position closed,USD/JPY," 201,19 ",6000," 1,20 "," 6.059,47 "," 755,48 ",2940619663,CFD," 0,00 "
12/02/2025 14:56:43,Position closed,USD/JPY," 151,60 ",4500," 1,60 "," 6.061,07 "," 907,08 ",2940550596,CFD," 0,00 "
12/02/2025 14:56:53,Open Position,USD/JPY," 249,99 ",7500," 0,00 "," 6.061,07 "," 657,09 ",2940631487,CFD," 0,00 "
12/02/2025 14:58:37,Position closed,NSDQ100/USD," 150,28 ",0.138998," 0,28 "," 6.061,35 "," 807,37 ",2940547784,CFD," 0,00 "
12/02/2025 15:00:24,Position closed,USD/JPY," 252,81 ",7500," 2,82 "," 6.064,17 "," 1.060,18 ",2940631487,CFD," 0,00 "
12/02/2025 15:00:30,Position closed,USD/JPY," 202,13 ",6000," 2,14 "," 6.066,31 "," 1.262,31 ",2940160993,CFD," 0,00 "
12/02/2025 15:00:34,Position closed,USD/JPY," 252,95 ",7500," 2,96 "," 6.069,27 "," 1.515,26 ",2940153099,CFD," 0,00 "
12/02/2025 15:00:38,Open Position,USD/JPY," 400,00 ",12000," 0,00 "," 6.069,27 "," 1.115,26 ",2940639308,CFD," 0,00 "
12/02/2025 15:00:49,Open Position,USD/JPY," 249,99 ",7500," 0,00 "," 6.069,27 "," 865,27 ",2940639577,CFD," 0,00 "
12/02/2025 15:13:17,Position closed,USD/JPY," 403,26 ",12000," 3,26 "," 6.072,53 "," 1.268,53 ",2940639308,CFD," 0,00 "
12/02/2025 15:13:21,Position closed,USD/JPY," 252,17 ",7500," 2,18 "," 6.074,71 "," 1.520,70 ",2940639577,CFD," 0,00 "
12/02/2025 15:13:57,Open Position,USD/JPY," 400,00 ",12000," 0,00 "," 6.074,71 "," 1.120,70 ",2940677891,CFD," 0,00 "
12/02/2025 15:16:39,Position closed,USD/JPY," 404,42 ",12000," 4,42 "," 6.079,13 "," 1.525,12 ",2940677891,CFD," 0,00 "
12/02/2025 15:16:45,Open Position,USD/JPY," 400,00 ",12000," 0,00 "," 6.079,13 "," 1.125,12 ",2940681669,CFD," 0,00 "
12/02/2025 15:17:05,Edit Stop Loss,-,"(18,83)",-," 0,00 "," 6.079,13 "," 1.106,29 ",2936693236,-," 0,00 "
12/02/2025 15:17:23,Edit Stop Loss,-,"(5,65)",-," 0,00 "," 6.079,13 "," 1.100,64 ",2937534559,-," 0,00 "
12/02/2025 15:17:31,Edit Stop Loss,-,"(9,45)",-," 0,00 "," 6.079,13 "," 1.091,19 ",2938476606,-," 0,00 "
12/02/2025 15:17:40,Edit Stop Loss,-,"(9,47)",-," 0,00 "," 6.079,13 "," 1.081,72 ",2939094941,-," 0,00 "
12/02/2025 15:17:55,Edit Stop Loss,-,"(15,18)",-," 0,00 "," 6.079,13 "," 1.066,54 ",2939122280,-," 0,00 "
12/02/2025 15:18:03,Edit Stop Loss,-,"(26,58)",-," 0,00 "," 6.079,13 "," 1.039,96 ",2939138544,-," 0,00 "
12/02/2025 15:18:28,Edit Stop Loss,-,"(7,60)",-," 0,00 "," 6.079,13 "," 1.032,36 ",2939684671,-," 0,00 "
12/02/2025 15:18:40,Edit Stop Loss,-,"(19,21)",-," 0,00 "," 6.079,13 "," 1.013,15 ",2939176899,-," 0,00 "
12/02/2025 15:18:56,Edit Stop Loss,-,"(4,74)",-," 0,00 "," 6.079,13 "," 1.008,41 ",2939910134,-," 0,00 "
12/02/2025 15:32:19,Open Position,NSDQ100/USD," 200,00 ",0.185068," 0,00 "," 6.079,13 "," 808,41 ",2940709119,CFD," 0,00 "
12/02/2025 15:43:06,Position closed,NSDQ100/USD," 204,10 ",0.185068," 4,10 "," 6.083,23 "," 1.012,51 ",2940709119,CFD," 0,00 "
12/02/2025 15:43:21,Open Position,NSDQ100/USD," 149,99 ",0.13863," 0,00 "," 6.083,23 "," 862,52 ",2940725749,CFD," 0,00 "
12/02/2025 15:45:39,Open Position,USD/JPY," 249,99 ",7500," 0,00 "," 6.083,23 "," 612,53 ",2940729644,CFD," 0,00 "
12/02/2025 15:58:25,Position closed,USD/JPY," 253,39 ",7500," 3,40 "," 6.086,63 "," 865,92 ",2940729644,CFD," 0,00 "
12/02/2025 15:58:50,Open Position,USD/JPY," 239,99 ",7200," 0,00 "," 6.086,63 "," 625,93 ",2940748856,CFD," 0,00 "
12/02/2025 16:04:43,Position closed,USD/JPY," 241,16 ",7200," 1,17 "," 6.087,80 "," 867,09 ",2940748856,CFD," 0,00 "
12/02/2025 16:05:37,Open Position,USD/JPY," 150,00 ",4500," 0,00 "," 6.087,80 "," 717,09 ",2940760367,CFD," 0,00 "
12/02/2025 16:15:05,Position closed,USD/JPY," 151,83 ",4500," 1,83 "," 6.089,63 "," 868,92 ",2940760367,CFD," 0,00 "
12/02/2025 16:15:22,Open Position,USD/JPY," 249,99 ",7500," 0,00 "," 6.089,63 "," 618,93 ",2940770110,CFD," 0,00 "
12/02/2025 16:19:42,Position closed,USD/JPY," 406,36 ",12000," 6,36 "," 6.095,99 "," 1.025,29 ",2940681669,CFD," 0,00 "
12/02/2025 16:19:50,Position closed,USD/JPY," 254,69 ",7500," 4,70 "," 6.100,69 "," 1.279,98 ",2940770110,CFD," 0,00 "
12/02/2025 16:19:59,Open Position,USD/JPY," 460,00 ",13800," 0,00 "," 6.100,69 "," 819,98 ",2940782255,CFD," 0,00 "
12/02/2025 16:25:49,Position closed,USD/JPY," 465,35 ",13800," 5,35 "," 6.106,04 "," 1.285,33 ",2940782255,CFD," 0,00 "
12/02/2025 16:26:10,Open Position,USD/JPY," 400,00 ",12000," 0,00 "," 6.106,04 "," 885,33 ",2940788628,CFD," 0,00 "
12/02/2025 16:26:17,Position closed,USD/JPY," 254,85 ",5260.174295," 0,61 "," 6.106,65 "," 1.140,18 ",2934171930,CFD," 0,00 "
12/02/2025 16:26:29,Open Position,USD/JPY," 199,99 ",6000," 0,00 "," 6.106,65 "," 940,19 ",2940789027,CFD," 0,00 "
12/02/2025 17:06:56,Position closed,NSDQ100/USD," 157,38 ",0.13863," 7,39 "," 6.114,04 "," 1.097,57 ",2940725749,CFD," 0,00 "
12/02/2025 17:07:21,Open Position,USD/JPY," 400,00 ",12000," 0,00 "," 6.114,04 "," 697,57 ",2940840131,CFD," 0,00 "
12/02/2025 17:08:38,Position closed,USD/JPY," 403,96 ",12000," 3,96 "," 6.118,00 "," 1.101,53 ",2940840131,CFD," 0,00 "
12/02/2025 17:09:30,Open Position,USD/JPY," 400,00 ",12000," 0,00 "," 6.118,00 "," 701,53 ",2940842464,CFD," 0,00 "
12/02/2025 17:21:18,Open Position,USD/JPY," 199,99 ",6000," 0,00 "," 6.118,00 "," 501,54 ",2940857167,CFD," 0,00 "
12/02/2025 17:22:26,Open Position,USD/JPY," 249,99 ",7500," 0,00 "," 6.118,00 "," 251,55 ",2940857973,CFD," 0,00 "
12/02/2025 17:35:34,Position closed,USD/JPY," 254,99 ",7500," 5,00 "," 6.123,00 "," 506,54 ",2940857973,CFD," 0,00 "
12/02/2025 17:35:43,Position closed,USD/JPY," 202,83 ",6000," 2,84 "," 6.125,84 "," 709,37 ",2940857167,CFD," 0,00 "
12/02/2025 17:36:24,Open Position,USD/JPY," 249,99 ",7500," 0,00 "," 6.125,84 "," 459,38 ",2940872465,CFD," 0,00 "
12/02/2025 18:44:00,Open Position,USD/JPY," 199,99 ",6000," 0,00 "," 6.125,84 "," 259,39 ",2940941556,CFD," 0,00 "
12/02/2025 19:17:38,Position closed,USD/JPY," 201,74 ",6000," 1,75 "," 6.127,59 "," 461,13 ",2940941556,CFD," 0,00 "
12/02/2025 19:18:01,Open Position,USD/JPY," 199,99 ",6000," 0,00 "," 6.127,59 "," 261,14 ",2940980709,CFD," 0,00 "
12/02/2025 19:44:47,Position closed,USD/JPY," 447,74 ",21000,"(305,35)"," 5.822,24 "," 708,88 ",2939138544,CFD," 0,00 "
12/02/2025 19:45:00,Open Position,USD/JPY," 499,99 ",15000," 0,00 "," 5.822,24 "," 208,89 ",2940997965,CFD," 0,00 "
12/02/2025 19:47:25,Position closed,USD/JPY," 201,00 ",6000," 1,01 "," 5.823,25 "," 409,89 ",2940980709,CFD," 0,00 "
12/02/2025 19:52:19,Position closed,USD/JPY," 320,84 ",15000,"(338,46)"," 5.484,79 "," 730,73 ",2936693236,CFD," 0,00 "
12/02/2025 19:53:05,Open Position,USD/JPY," 199,99 ",6000," 0,00 "," 5.484,79 "," 530,74 ",2941007284,CFD," 0,00 "
12/02/2025 20:14:25,Position closed,USD/JPY," 198,63 ",6000,"(1,36)"," 5.483,43 "," 729,37 ",2941007284,CFD," 0,00 "
12/02/2025 22:42:59,Position closed,USD/JPY," 487,55 ",15000,"(12,44)"," 5.470,99 "," 1.216,92 ",2940997965,CFD," 0,00 "
13/02/2025 00:09:17,Open Position,USD/JPY," 199,99 ",6000," 0,00 "," 5.470,99 "," 1.016,93 ",2941080391,CFD," 0,00 "
13/02/2025 00:47:55,Weekend refund,Weekend Fee," 3,50 ",-," 3,50 "," 5.474,49 "," 1.020,43 ",2940997965,CFD," 0,00 "
13/02/2025 00:47:55,Weekend refund,Weekend Fee," 2,80 ",-," 2,80 "," 5.477,29 "," 1.023,23 ",2940842464,CFD," 0,00 "
13/02/2025 00:47:55,Weekend refund,Weekend Fee," 2,80 ",-," 2,80 "," 5.480,09 "," 1.026,03 ",2940788628,CFD," 0,00 "
13/02/2025 00:47:55,Weekend refund,Weekend Fee," 1,75 ",-," 1,75 "," 5.481,84 "," 1.027,78 ",2940872465,CFD," 0,00 "
13/02/2025 00:47:55,Weekend refund,Weekend Fee," 1,40 ",-," 1,40 "," 5.483,24 "," 1.029,18 ",2940789027,CFD," 0,00 "
13/02/2025 00:47:55,Overnight fee,Daily,"(0,03)",-,"(0,03)"," 5.483,21 "," 1.029,15 ",2940436584,CFD," 0,00 "
13/02/2025 00:47:55,Overnight fee,Daily,"(1,20)",-,"(1,20)"," 5.482,01 "," 1.027,95 ",2938586783,CFD," 0,00 "
13/02/2025 00:47:55,Overnight fee,Weekend Fee,"(2,07)",-,"(2,07)"," 5.479,94 "," 1.025,88 ",2937534559,CFD," 0,00 "
13/02/2025 00:47:55,Overnight fee,Weekend Fee,"(2,07)",-,"(2,07)"," 5.477,87 "," 1.023,81 ",2939910134,CFD," 0,00 "
13/02/2025 00:47:55,Overnight fee,Weekend Fee,"(2,76)",-,"(2,76)"," 5.475,11 "," 1.021,05 ",2939961593,CFD," 0,00 "
13/02/2025 00:47:55,Overnight fee,Weekend Fee,"(2,76)",-,"(2,76)"," 5.472,35 "," 1.018,29 ",2939684671,CFD," 0,00 "
13/02/2025 00:47:55,Overnight fee,Weekend Fee,"(3,45)",-,"(3,45)"," 5.468,90 "," 1.014,84 ",2938476606,CFD," 0,00 "
13/02/2025 00:47:55,Overnight fee,Weekend Fee,"(3,45)",-,"(3,45)"," 5.465,45 "," 1.011,39 ",2939094941,CFD," 0,00 "
13/02/2025 00:47:55,Overnight fee,Weekend Fee,"(4,14)",-,"(4,14)"," 5.461,31 "," 1.007,25 ",2939176899,CFD," 0,00 "
13/02/2025 00:47:55,Overnight fee,Weekend Fee,"(5,52)",-,"(5,52)"," 5.455,79 "," 1.001,73 ",2939122280,CFD," 0,00 "
13/02/2025 07:14:17,Open Position,USD/JPY," 199,99 ",6000," 0,00 "," 5.455,79 "," 801,74 ",2941125103,CFD," 0,00 "
13/02/2025 07:58:24,Position closed,USD/JPY," 203,06 ",6000," 3,07 "," 5.458,86 "," 1.004,80 ",2941080391,CFD," 0,00 "
13/02/2025 07:58:31,Position closed,USD/JPY," 204,58 ",6000," 4,59 "," 5.463,45 "," 1.209,38 ",2941125103,CFD," 0,00 "
13/02/2025 07:59:18,Open Position,USD/JPY," 199,99 ",6000," 0,00 "," 5.463,45 "," 1.009,39 ",2941132308,CFD," 0,00 "
13/02/2025 08:47:58,Open Position,USD/JPY," 199,99 ",6000," 0,00 "," 5.463,45 "," 809,40 ",2941200534,CFD," 0,00 "
13/02/2025 08:48:56,Open Position,USD/JPY," 249,99 ",7500," 0,00 "," 5.463,45 "," 559,41 ",2941200833,CFD," 0,00 "
13/02/2025 09:09:52,Open Position,USD/JPY," 150,00 ",4500," 0,00 "," 5.463,45 "," 409,41 ",2941207648,CFD," 0,00 "
13/02/2025 09:20:40,Position closed,USD/JPY," 55,03 ",2252.979688,"(41,29)"," 5.422,16 "," 464,44 ",2941210550,CFD," 0,00 "
13/02/2025 09:21:16,Position closed,USD/JPY," 54,92 ",2247.020312,"(41,15)"," 5.381,01 "," 519,36 ",2937534559,CFD," 0,00 "
13/02/2025 09:42:39,Position closed,USD/JPY," 153,83 ",4500," 3,83 "," 5.384,84 "," 673,19 ",2941207648,CFD," 0,00 "
13/02/2025 10:05:21,Open Position,USD/JPY," 249,99 ",7500," 0,00 "," 5.384,84 "," 423,20 ",2941226215,CFD," 0,00 "
13/02/2025 10:32:19,Open Position,USD/JPY," 199,99 ",6000," 0,00 "," 5.384,84 "," 223,21 ",2941233312,CFD," 0,00 "
13/02/2025 12:48:57,Position closed,USD/JPY," 196,09 ",6000,"(3,90)"," 5.380,94 "," 419,30 ",2941233312,CFD," 0,00 "
13/02/2025 13:30:43,Position closed,USD/JPY," 251,50 ",7500," 1,51 "," 5.382,45 "," 670,80 ",2941226215,CFD," 0,00 "
13/02/2025 13:38:03,Position closed,NSDQ100/USD," 308,66 ",0.229433," 2,05 "," 5.384,50 "," 979,46 ",2938586783,CFD," 0,00 "
13/02/2025 13:46:41,Open Position,USD/JPY," 199,99 ",6000," 0,00 "," 5.384,50 "," 779,47 ",2941292796,CFD," 0,00 "
13/02/2025 13:52:33,Position closed,USD/JPY," 327,94 ",12000,"(109,50)"," 5.275,00 "," 1.107,41 ",2939122280,CFD," 0,00 "
13/02/2025 13:52:43,Open Position,USD/JPY," 249,99 ",7500," 0,00 "," 5.275,00 "," 857,42 ",2941300167,CFD," 0,00 "
13/02/2025 13:58:31,Open Position,USD/JPY," 200,00 ",6000," 0,00 "," 5.275,00 "," 657,42 ",2941301619,CFD," 0,00 "
13/02/2025 14:03:39,Position closed,USD/JPY," 251,11 ",7500," 1,12 "," 5.276,12 "," 908,53 ",2941300167,CFD," 0,00 "
13/02/2025 14:03:48,Open Position,USD/JPY," 199,99 ",6000," 0,00 "," 5.276,12 "," 708,54 ",2941303280,CFD," 0,00 "
13/02/2025 14:17:06,Position closed,USD/JPY," 201,76 ",6000," 1,76 "," 5.277,88 "," 910,30 ",2941301619,CFD," 0,00 "
13/02/2025 14:18:51,Open Position,USD/JPY," 150,00 ",4500," 0,00 "," 5.277,88 "," 760,30 ",2941307410,CFD," 0,00 "
13/02/2025 14:32:41,Edit Stop Loss,-,"(4,37)",-," 0,00 "," 5.277,88 "," 755,93 ",2940436584,-," 0,00 "
13/02/2025 14:32:51,Edit Stop Loss,-,"(9,29)",-," 0,00 "," 5.277,88 "," 746,64 ",2940436584,-," 0,00 "
13/02/2025 14:33:20,Position closed,USD/JPY," 152,11 ",4500," 2,11 "," 5.279,99 "," 898,75 ",2941307410,CFD," 0,00 "
13/02/2025 14:33:30,Open Position,USD/JPY," 150,00 ",4500," 0,00 "," 5.279,99 "," 748,75 ",2941413778,CFD," 0,00 "
13/02/2025 14:33:44,Open Position,NSDQ100/USD," 99,98 ",0.091539," 0,00 "," 5.279,99 "," 648,77 ",2941414443,CFD," 0,00 "
13/02/2025 14:44:18,Open Position,USD/JPY," 250,00 ",7500," 0,00 "," 5.279,99 "," 398,77 ",2941445319,CFD," 0,00 "
13/02/2025 14:51:44,Position closed,USD/JPY," 252,25 ",7500," 2,25 "," 5.282,24 "," 651,02 ",2941445319,CFD," 0,00 "
13/02/2025 14:55:07,Open Position,USD/JPY," 250,00 ",7500," 0,00 "," 5.282,24 "," 401,02 ",2941547351,CFD," 0,00 "
13/02/2025 15:23:37,Position closed,NSDQ100/USD," 104,58 ",0.091539," 4,60 "," 5.286,84 "," 505,60 ",2941414443,CFD," 0,00 "
13/02/2025 15:24:01,Open Position,NSDQ100/USD," 149,99 ",0.136966," 0,00 "," 5.286,84 "," 355,61 ",2941623090,CFD," 0,00 "
13/02/2025 15:24:37,Position closed,USD/JPY," 254,79 ",7500," 4,79 "," 5.291,63 "," 610,40 ",2941547351,CFD," 0,00 "
13/02/2025 15:25:18,Open Position,USD/JPY," 200,00 ",6000," 0,00 "," 5.291,63 "," 410,40 ",2941627509,CFD," 0,00 "
13/02/2025 15:32:23,Position closed,NSDQ100/USD," 149,81 ",0.136966,"(0,18)"," 5.291,45 "," 560,21 ",2941623090,CFD," 0,00 "
13/02/2025 15:33:46,Position closed,USD/JPY," 287,78 ",12000,"(112,22)"," 5.179,23 "," 847,99 ",2940788628,CFD," 0,00 "
13/02/2025 15:40:33,Position closed,USD/JPY," 201,41 ",6000," 1,41 "," 5.180,64 "," 1.049,40 ",2941627509,CFD," 0,00 "
13/02/2025 15:45:09,Open Position,USD/JPY," 200,00 ",6000," 0,00 "," 5.180,64 "," 849,40 ",2941672985,CFD," 0,00 "
13/02/2025 15:46:20,Position closed,USD/JPY," 200,27 ",6000," 0,27 "," 5.180,91 "," 1.049,67 ",2941672985,CFD," 0,00 "
13/02/2025 15:51:33,Open Position,USD/JPY," 150,00 ",4500," 0,00 "," 5.180,91 "," 899,67 ",2941684615,CFD," 0,00 "
13/02/2025 15:52:11,Open Position,USD/JPY," 99,99 ",3000," 0,00 "," 5.180,91 "," 799,68 ",2941687006,CFD," 0,00 "
13/02/2025 16:12:08,Position closed,USD/JPY," 100,83 ",3000," 0,84 "," 5.181,75 "," 900,51 ",2941687006,CFD," 0,00 "
13/02/2025 16:12:25,Open Position,USD/JPY," 200,00 ",6000," 0,00 "," 5.181,75 "," 700,51 ",2941719135,CFD," 0,00 "
13/02/2025 16:13:47,Position closed,USD/JPY," 146,59 ",4500,"(3,41)"," 5.178,34 "," 847,10 ",2941684615,CFD," 0,00 "
13/02/2025 16:16:47,Position closed,USD/JPY," 228,24 ",7500,"(54,20)"," 5.124,14 "," 1.075,34 ",2939094941,CFD," 0,00 "
13/02/2025 16:16:47,Position closed,USD/JPY," 182,78 ",6000,"(29,68)"," 5.094,46 "," 1.258,12 ",2939684671,CFD," 0,00 "
13/02/2025 16:16:47,Position closed,USD/JPY," 274,17 ",9000,"(45,04)"," 5.049,42 "," 1.532,29 ",2939176899,CFD," 0,00 "
13/02/2025 16:16:47,Position closed,USD/JPY," 280,19 ",12000,"(119,81)"," 4.929,61 "," 1.812,48 ",2940842464,CFD," 0,00 "
13/02/2025 16:16:47,Position closed,USD/JPY," 228,11 ",7500,"(70,71)"," 4.858,90 "," 2.040,59 ",2938476606,CFD," 0,00 "
13/02/2025 16:16:47,Position closed,USD/JPY," 186,00 ",6000,"(14,00)"," 4.844,90 "," 2.226,59 ",2939961593,CFD," 0,00 "
13/02/2025 16:16:47,Position closed,USD/JPY," 137,21 ",4500,"(17,52)"," 4.827,38 "," 2.363,80 ",2939910134,CFD," 0,00 "
13/02/2025 16:16:47,Position closed,USD/JPY," 131,61 ",6000,"(68,38)"," 4.759,00 "," 2.495,41 ",2940789027,CFD," 0,00 "
13/02/2025 16:16:47,Position closed,USD/JPY," 198,38 ",7500,"(51,61)"," 4.707,39 "," 2.693,79 ",2941200833,CFD," 0,00 "
13/02/2025 16:16:47,Position closed,USD/JPY," 150,63 ",6000,"(49,36)"," 4.658,03 "," 2.844,42 ",2941132308,CFD," 0,00 "
13/02/2025 16:16:47,Position closed,USD/JPY," 158,59 ",6000,"(41,40)"," 4.616,63 "," 3.003,01 ",2941200534,CFD," 0,00 "
13/02/2025 16:16:47,Position closed,USD/JPY," 180,40 ",7500,"(69,59)"," 4.547,04 "," 3.183,41 ",2940872465,CFD," 0,00 "
13/02/2025 16:16:47,Position closed,USD/JPY," 178,19 ",6000,"(21,80)"," 4.525,24 "," 3.361,60 ",2941303280,CFD," 0,00 "
13/02/2025 16:16:48,Position closed,USD/JPY," 135,47 ",4500,"(14,53)"," 4.510,71 "," 3.497,07 ",2941413778,CFD," 0,00 "
13/02/2025 16:16:48,Position closed,USD/JPY," 176,82 ",6000,"(23,17)"," 4.487,54 "," 3.673,89 ",2941292796,CFD," 0,00 "
13/02/2025 16:16:48,Position closed,USD/JPY," 199,88 ",6000,"(0,12)"," 4.487,42 "," 3.873,77 ",2941719135,CFD," 0,00 "
13/02/2025 16:35:07,Open Position,USD/JPY," 149,99 ",4500," 0,00 "," 4.487,42 "," 3.723,78 ",2941749405,CFD," 0,00 "
13/02/2025 16:38:47,Open Position,USD/JPY," 150,00 ",4500," 0,00 "," 4.487,42 "," 3.573,78 ",2941752714,CFD," 0,00 "
13/02/2025 16:40:25,Open Position,NSDQ100/USD," 199,98 ",0.182556," 0,00 "," 4.487,42 "," 3.373,80 ",2941753998,CFD," 0,00 "
13/02/2025 16:44:50,Position closed,USD/JPY," 151,44 ",4500," 1,44 "," 4.488,86 "," 3.525,24 ",2941752714,CFD," 0,00 "
13/02/2025 16:45:04,Open Position,USD/JPY," 259,99 ",7800," 0,00 "," 4.488,86 "," 3.265,25 ",2941758221,CFD," 0,00 "
13/02/2025 16:53:08,Position closed,NSDQ100/USD," 202,10 ",0.182556," 2,12 "," 4.490,98 "," 3.467,35 ",2941753998,CFD," 0,00 "
13/02/2025 16:53:48,Open Position,NSDQ100/USD," 199,98 ",0.182749," 0,00 "," 4.490,98 "," 3.267,37 ",2941765454,CFD," 0,00 "
13/02/2025 16:57:18,Position closed,NSDQ100/USD," 205,45 ",0.182749," 5,47 "," 4.496,45 "," 3.472,82 ",2941765454,CFD," 0,00 "
13/02/2025 16:57:56,Open Position,NSDQ100/USD," 100,00 ",0.091474," 0,00 "," 4.496,45 "," 3.372,82 ",2941769321,CFD," 0,00 "
13/02/2025 17:49:56,Open Position,NSDQ100/USD," 299,99 ",0.273922," 0,00 "," 4.496,45 "," 3.072,83 ",2941815549,CFD," 0,00 "
13/02/2025 18:52:02,Position closed,NSDQ100/USD," 307,53 ",0.273922," 7,54 "," 4.503,99 "," 3.380,36 ",2941815549,CFD," 0,00 "
13/02/2025 18:52:14,Open Position,NSDQ100/USD," 199,98 ",0.182971," 0,00 "," 4.503,99 "," 3.180,38 ",2941867797,CFD," 0,00 "
13/02/2025 18:52:31,Position closed,USD/JPY," 266,40 ",7800," 6,41 "," 4.510,40 "," 3.446,78 ",2941758221,CFD," 0,00 "
13/02/2025 18:52:42,Open Position,USD/JPY," 50,31 ",6000," 0,00 "," 4.510,40 "," 3.246,79 ",2941868070,CFD," 0,00 "
13/02/2025 19:10:52,Open Position,NSDQ100/USD," 299,99 ",0.273567," 0,00 "," 4.510,40 "," 2.946,80 ",2941886745,CFD," 0,00 "
13/02/2025 19:11:08,Open Position,NSDQ100/USD," 149,99 ",0.136754," 0,00 "," 4.510,40 "," 2.796,81 ",2941886955,CFD," 0,00 "
13/02/2025 19:21:01,Position closed,USD/JPY," 153,76 ",4500," 3,77 "," 4.514,17 "," 2.950,57 ",2941749405,CFD," 0,00 "
13/02/2025 19:22:10,Open Position,USD/JPY," 99,99 ",3000," 0,00 "," 4.514,17 "," 2.850,58 ",2941896627,CFD," 0,00 "
13/02/2025 19:22:59,Open Position,USD/JPY," 200,00 ",6000," 0,00 "," 4.514,17 "," 2.650,58 ",2941897137,CFD," 0,00 "
13/02/2025 19:42:26,Position closed,NSDQ100/USD," 152,01 ",0.136754," 2,02 "," 4.516,19 "," 2.802,59 ",2941886955,CFD," 0,00 "
13/02/2025 19:43:53,Open Position,NSDQ100/USD," 75,20 ",0.136667," 0,00 "," 4.516,19 "," 2.652,60 ",2941917933,CFD," 0,00 "
13/02/2025 19:44:01,Open Position,NSDQ100/USD," 200,00 ",0.182202," 0,00 "," 4.516,19 "," 2.452,60 ",2941917968,CFD," 0,00 "
13/02/2025 20:14:58,Position closed,NSDQ100/USD," 206,32 ",0.182202," 6,32 "," 4.522,51 "," 2.658,92 ",2941917968,CFD," 0,00 "
13/02/2025 20:15:33,Open Position,NSDQ100/USD," 149,99 ",0.136412," 0,00 "," 4.522,51 "," 2.508,93 ",2941954472,CFD," 0,00 "
13/02/2025 20:15:43,Open Position,NSDQ100/USD," 149,99 ",0.136436," 0,00 "," 4.522,51 "," 2.358,94 ",2941954565,CFD," 0,00 "
13/02/2025 20:23:59,Position closed,USD/JPY," 101,05 ",3000," 1,06 "," 4.523,57 "," 2.459,99 ",2941896627,CFD," 0,00 "
13/02/2025 20:24:06,Position closed,USD/JPY," 202,32 ",6000," 2,32 "," 4.525,89 "," 2.662,31 ",2941897137,CFD," 0,00 "
13/02/2025 20:24:18,Open Position,USD/JPY," 300,00 ",9000," 0,00 "," 4.525,89 "," 2.362,31 ",2941971720,CFD," 0,00 "
13/02/2025 20:24:42,Position closed,NSDQ100/USD," 150,28 ",0.136412," 0,29 "," 4.526,18 "," 2.512,59 ",2941954472,CFD," 0,00 "
13/02/2025 20:25:35,Open Position,NSDQ100/USD," 99,99 ",0.090953," 0,00 "," 4.526,18 "," 2.412,60 ",2941972771,CFD," 0,00 "
13/02/2025 20:25:52,Position closed,USD/JPY," 303,01 ",9000," 3,01 "," 4.529,19 "," 2.715,61 ",2941971720,CFD," 0,00 "
13/02/2025 20:26:19,Open Position,USD/JPY," 260,00 ",7800," 0,00 "," 4.529,19 "," 2.455,61 ",2941973158,CFD," 0,00 "
13/02/2025 20:59:04,Position closed,NSDQ100/USD," 103,35 ",0.090953," 3,36 "," 4.532,55 "," 2.558,96 ",2941972771,CFD," 0,00 "
13/02/2025 21:00:48,Open Position,NSDQ100/USD," 149,97 ",0.13636," 0,00 "," 4.532,55 "," 2.408,99 ",2942009960,CFD," 0,00 "
13/02/2025 21:01:00,Open Position,NSDQ100/USD," 49,99 ",0.045447," 0,00 "," 4.532,55 "," 2.359,00 ",2942011196,CFD," 0,00 "
13/02/2025 21:37:50,Position closed,NSDQ100/USD," 150,99 ",0.13636," 1,02 "," 4.533,57 "," 2.509,99 ",2942009960,CFD," 0,00 "
13/02/2025 23:21:15,Open Position,NSDQ100/USD," 149,99 ",0.136301," 0,00 "," 4.533,57 "," 2.360,00 ",2942024305,CFD," 0,00 "
13/02/2025 23:21:30,Position closed,NSDQ100/USD," 50,11 ",0.045447," 0,12 "," 4.533,69 "," 2.410,11 ",2942011196,CFD," 0,00 "
14/02/2025 00:32:01,Index price adjustment,NSDQ100/USD,"(0,26)",-,"(0,26)"," 4.533,43 "," 2.409,85 ",2940436584,CFD," 0,00 "
14/02/2025 00:32:01,Index price adjustment,NSDQ100/USD,"(0,26)",-,"(0,26)"," 4.533,17 "," 2.409,59 ",2941769321,CFD," 0,00 "
14/02/2025 00:32:01,Index price adjustment,NSDQ100/USD,"(0,52)",-,"(0,52)"," 4.532,65 "," 2.409,07 ",2941867797,CFD," 0,00 "
14/02/2025 00:32:01,Index price adjustment,NSDQ100/USD,"(0,78)",-,"(0,78)"," 4.531,87 "," 2.408,29 ",2941886745,CFD," 0,00 "
14/02/2025 00:32:01,Index price adjustment,NSDQ100/USD,"(0,39)",-,"(0,39)"," 4.531,48 "," 2.407,90 ",2941917933,CFD," 0,00 "
14/02/2025 00:32:01,Index price adjustment,NSDQ100/USD,"(0,39)",-,"(0,39)"," 4.531,09 "," 2.407,51 ",2941954565,CFD," 0,00 "
14/02/2025 00:48:08,Overnight refund,Daily," 0,47 ",-," 0,47 "," 4.531,56 "," 2.407,98 ",2941868070,CFD," 0,00 "
14/02/2025 00:48:08,Overnight fee,Daily,"(0,03)",-,"(0,03)"," 4.531,53 "," 2.407,95 ",2940436584,CFD," 0,00 "
14/02/2025 00:48:08,Overnight fee,Daily,"(0,03)",-,"(0,03)"," 4.531,50 "," 2.407,92 ",2941769321,CFD," 0,00 "
14/02/2025 00:48:08,Overnight fee,Daily,"(0,05)",-,"(0,05)"," 4.531,45 "," 2.407,87 ",2941954565,CFD," 0,00 "
14/02/2025 00:48:08,Overnight fee,Daily,"(0,05)",-,"(0,05)"," 4.531,40 "," 2.407,82 ",2941917933,CFD," 0,00 "
14/02/2025 00:48:08,Overnight fee,Daily,"(0,06)",-,"(0,06)"," 4.531,34 "," 2.407,76 ",2941867797,CFD," 0,00 "
14/02/2025 00:48:08,Overnight fee,Daily,"(0,09)",-,"(0,09)"," 4.531,25 "," 2.407,67 ",2941886745,CFD," 0,00 "
14/02/2025 00:48:08,Overnight fee,Daily,"(0,24)",-,"(0,24)"," 4.531,01 "," 2.407,43 ",2942011196,CFD," 0,00 "
14/02/2025 00:48:08,Overnight fee,Daily,"(1,20)",-,"(1,20)"," 4.529,81 "," 2.406,23 ",2941973158,CFD," 0,00 "
14/02/2025 01:04:40,Position closed,USD/JPY," 270,07 ",7800," 10,07 "," 4.539,88 "," 2.676,30 ",2941973158,CFD," 0,00 "
14/02/2025 07:18:42,Position closed,NSDQ100/USD," 158,23 ",0.136301," 8,24 "," 4.548,12 "," 2.834,53 ",2942024305,CFD," 0,00 "
14/02/2025 07:29:37,Open Position,NSDQ100/USD," 149,99 ",0.135921," 0,00 "," 4.548,12 "," 2.684,54 ",2942069260,CFD," 0,00 "
14/02/2025 07:36:02,Position closed,USD/JPY," 86,59 ",3000.059462,"(13,41)"," 4.534,71 "," 2.771,13 ",2942070040,CFD," 0,00 "
14/02/2025 07:36:26,Open Position,USD/JPY," 119,99 ",3600," 0,00 "," 4.534,71 "," 2.651,14 ",2942070085,CFD," 0,00 "
14/02/2025 07:37:21,Open Position,NSDQ100/USD," 99,99 ",0.090643," 0,00 "," 4.534,71 "," 2.551,15 ",2942070166,CFD," 0,00 "
14/02/2025 08:02:50,Open Position,NSDQ100/USD," 149,99 ",0.135999," 0,00 "," 4.534,71 "," 2.401,16 ",2942100890,CFD," 0,00 "
14/02/2025 08:35:53,Position closed,NSDQ100/USD," 101,29 ",0.090643," 1,30 "," 4.536,01 "," 2.502,45 ",2942070166,CFD," 0,00 "
14/02/2025 08:36:06,Open Position,NSDQ100/USD," 150,00 ",0.136075," 0,00 "," 4.536,01 "," 2.352,45 ",2942137383,CFD," 0,00 "
14/02/2025 10:11:25,Position closed,USD/JPY," 122,09 ",3600," 2,10 "," 4.538,11 "," 2.474,54 ",2942070085,CFD," 0,00 "
14/02/2025 10:12:18,Open Position,USD/JPY," 149,99 ",4500," 0,00 "," 4.538,11 "," 2.324,55 ",2942176904,CFD," 0,00 "
14/02/2025 10:12:39,Position closed,NSDQ100/USD," 151,90 ",0.136075," 1,90 "," 4.540,01 "," 2.476,45 ",2942137383,CFD," 0,00 "
14/02/2025 10:13:03,Open Position,NSDQ100/USD," 149,99 ",0.136187," 0,00 "," 4.540,01 "," 2.326,46 ",2942178265,CFD," 0,00 "
14/02/2025 11:19:50,Position closed,NSDQ100/USD," 154,96 ",0.136187," 4,97 "," 4.544,98 "," 2.481,42 ",2942178265,CFD," 0,00 "
14/02/2025 12:07:12,Position closed,NSDQ100/USD," 151,32 ",0.136436," 1,33 "," 4.546,31 "," 2.632,74 ",2941954565,CFD," 0,00 "
14/02/2025 12:19:57,Open Position,NSDQ100/USD," 99,99 ",0.090912," 0,00 "," 4.546,31 "," 2.532,75 ",2942215587,CFD," 0,00 "
14/02/2025 13:23:00,Position closed,NSDQ100/USD," 100,03 ",0.090912," 0,04 "," 4.546,35 "," 2.632,78 ",2942215587,CFD," 0,00 "
14/02/2025 13:30:32,Open Position,NSDQ100/USD," 250,00 ",0.227251," 0,00 "," 4.546,35 "," 2.382,78 ",2942231438,CFD," 0,00 "
14/02/2025 13:45:59,Position closed,NSDQ100/USD," 253,77 ",0.227251," 3,77 "," 4.550,12 "," 2.636,55 ",2942231438,CFD," 0,00 "
14/02/2025 13:46:10,Open Position,NSDQ100/USD," 249,99 ",0.227032," 0,00 "," 4.550,12 "," 2.386,56 ",2942236637,CFD," 0,00 "
14/02/2025 13:48:01,Position closed,USD/JPY," 159,96 ",4500," 9,97 "," 4.560,09 "," 2.546,52 ",2942176904,CFD," 0,00 "
14/02/2025 13:52:20,Open Position,NSDQ100/USD," 99,99 ",0.090814," 0,00 "," 4.560,09 "," 2.446,53 ",2942238378,CFD," 0,00 "
14/02/2025 13:59:39,Open Position,USD/JPY," 200,00 ",6000," 0,00 "," 4.560,09 "," 2.246,53 ",2942240334,CFD," 0,00 "
14/02/2025 14:22:11,Position closed,NSDQ100/USD," 99,39 ",0.090814,"(0,60)"," 4.559,49 "," 2.345,92 ",2942238378,CFD," 0,00 "
14/02/2025 15:38:29,Position closed,NSDQ100/USD," 250,81 ",0.227032," 0,82 "," 4.560,31 "," 2.596,73 ",2942236637,CFD," 0,00 "
14/02/2025 16:12:18,Position closed,NSDQ100/USD," 152,12 ",0.135999," 2,13 "," 4.562,44 "," 2.748,85 ",2942100890,CFD," 0,00 "
14/02/2025 16:13:45,Position closed,USD/JPY," 201,54 ",6000," 1,54 "," 4.563,98 "," 2.950,39 ",2942240334,CFD," 0,00 "
14/02/2025 16:15:53,Open Position,USD/JPY," 200,00 ",6000," 0,00 "," 4.563,98 "," 2.750,39 ",2942712638,CFD," 0,00 "
14/02/2025 16:20:03,Open Position,NSDQ100/USD," 149,99 ",0.136084," 0,00 "," 4.563,98 "," 2.600,40 ",2942720636,CFD," 0,00 "
14/02/2025 16:21:27,Open Position,NSDQ100/USD," 149,99 ",0.136241," 0,00 "," 4.563,98 "," 2.450,41 ",2942722830,CFD," 0,00 "
14/02/2025 16:34:52,Withdraw Fee,-,"(5,00)",-,"(5,00)"," 4.558,98 "," 2.445,41 ",-,-," 0,00 "
14/02/2025 16:34:52,Withdrawal Conversion Fee,-," 0,00 ",-," 0,00 "," 4.458,98 "," 2.345,41 ",-,-," 0,00 "
14/02/2025 16:34:52,Withdraw Request,-,"(100,00)",-,"(100,00)"," 4.458,98 "," 2.345,41 ",-,-," 0,00 "
14/02/2025 18:03:21,Position closed,NSDQ100/USD," 154,34 ",0.136084," 4,35 "," 4.463,33 "," 2.499,75 ",2942720636,CFD," 0,00 "
14/02/2025 19:10:14,Position closed,NSDQ100/USD," 155,38 ",0.135921," 5,39 "," 4.468,72 "," 2.655,13 ",2942069260,CFD," 0,00 "
14/02/2025 19:11:16,Open Position,NSDQ100/USD," 249,99 ",0.226073," 0,00 "," 4.468,72 "," 2.405,14 ",2942905362,CFD," 0,00 "
14/02/2025 19:14:41,Open Position,NSDQ100/USD," 200,00 ",0.180823," 0,00 "," 4.468,72 "," 2.205,14 ",2942908291,CFD," 0,00 "
14/02/2025 19:33:29,Open Position,NSDQ100/USD," 149,99 ",0.135814," 0,00 "," 4.468,72 "," 2.055,15 ",2942923290,CFD," 0,00 "
14/02/2025 19:33:57,Open Position,NSDQ100/USD," 149,99 ",0.135845," 0,00 "," 4.468,72 "," 1.905,16 ",2942923786,CFD," 0,00 "
14/02/2025 20:15:32,Position closed,NSDQ100/USD," 151,26 ",0.135814," 1,27 "," 4.469,99 "," 2.056,42 ",2942923290,CFD," 0,00 "
14/02/2025 21:08:13,Position closed,NSDQ100/USD," 251,17 ",0.226073," 1,18 "," 4.471,17 "," 2.307,59 ",2942905362,CFD," 0,00 "
14/02/2025 21:08:46,Edit Stop Loss,-,"(9,30)",-," 0,00 "," 4.471,17 "," 2.298,29 ",2940436584,-," 0,00 "
15/02/2025 00:47:39,Overnight refund,Daily," 0,23 ",-," 0,23 "," 4.471,40 "," 2.298,52 ",2941868070,CFD," 0,00 "
15/02/2025 00:47:39,Overnight fee,Weekend Fee,"(0,09)",-,"(0,09)"," 4.471,31 "," 2.298,43 ",2941769321,CFD," 0,00 "
15/02/2025 00:47:39,Overnight fee,Weekend Fee,"(0,10)",-,"(0,10)"," 4.471,21 "," 2.298,33 ",2940436584,CFD," 0,00 "
15/02/2025 00:47:39,Overnight fee,Weekend Fee,"(0,14)",-,"(0,14)"," 4.471,07 "," 2.298,19 ",2942722830,CFD," 0,00 "
15/02/2025 00:47:39,Overnight fee,Weekend Fee,"(0,14)",-,"(0,14)"," 4.470,93 "," 2.298,05 ",2941917933,CFD," 0,00 "
15/02/2025 00:47:39,Overnight fee,Weekend Fee,"(0,14)",-,"(0,14)"," 4.470,79 "," 2.297,91 ",2942923786,CFD," 0,00 "
15/02/2025 00:47:39,Overnight fee,Weekend Fee,"(0,19)",-,"(0,19)"," 4.470,60 "," 2.297,72 ",2941867797,CFD," 0,00 "
15/02/2025 00:47:39,Overnight fee,Weekend Fee,"(0,28)",-,"(0,28)"," 4.470,32 "," 2.297,44 ",2941886745,CFD," 0,00 "
15/02/2025 00:47:39,Overnight fee,Daily,"(0,92)",-,"(0,92)"," 4.469,40 "," 2.296,52 ",2942712638,CFD," 0,00 "
15/02/2025 00:47:39,Overnight fee,Weekend Fee,"(2,83)",-,"(2,83)"," 4.466,57 "," 2.293,69 ",2942908291,CFD," 0,00 "
16/02/2025 23:02:59,Position closed,NSDQ100/USD," 200,78 ",0.180823," 0,78 "," 4.467,35 "," 2.494,47 ",2942908291,CFD," 0,00 "
16/02/2025 23:03:55,Open Position,NSDQ100/USD," 149,99 ",0.135575," 0,00 "," 4.467,35 "," 2.344,48 ",2943071669,CFD," 0,00 "
16/02/2025 23:05:14,Open Position,NSDQ100/USD," 74,99 ",0.067788," 0,00 "," 4.467,35 "," 2.269,49 ",2943072114,CFD," 0,00 "
17/02/2025 00:55:04,Position closed,USD/JPY," 210,08 ",6000," 10,08 "," 4.477,43 "," 2.479,57 ",2942712638,CFD," 0,00 "
17/02/2025 03:30:16,Position closed,NSDQ100/USD," 157,50 ",0.135575," 7,51 "," 4.484,94 "," 2.637,07 ",2943071669,CFD," 0,00 "
17/02/2025 03:35:04,Open Position,USD/JPY," 99,99 ",3000," 0,00 "," 4.484,94 "," 2.537,08 ",2943109198,CFD," 0,00 "
17/02/2025 03:37:21,Open Position,NSDQ100/USD," 249,99 ",0.22546," 0,00 "," 4.484,94 "," 2.287,09 ",2943109316,CFD," 0,00 "
17/02/2025 03:48:19,Open Position,NSDQ100/USD," 249,99 ",0.225462," 0,00 "," 4.484,94 "," 2.037,10 ",2943109805,CFD," 0,00 "
17/02/2025 03:48:31,Open Position,NSDQ100/USD," 99,99 ",0.090184," 0,00 "," 4.484,94 "," 1.937,11 ",2943109815,CFD," 0,00 "
17/02/2025 03:50:53,Position closed,NSDQ100/USD," 99,79 ",0.090184,"(0,20)"," 4.484,74 "," 2.036,90 ",2943109815,CFD," 0,00 "
17/02/2025 06:40:37,Position closed,NSDQ100/USD," 251,07 ",0.225462," 1,08 "," 4.485,82 "," 2.287,97 ",2943109805,CFD," 0,00 "
17/02/2025 06:40:50,Open Position,NSDQ100/USD," 270,00 ",0.24341," 0,00 "," 4.485,82 "," 2.017,97 ",2943122797,CFD," 0,00 "
17/02/2025 07:08:46,Position closed,NSDQ100/USD," 251,49 ",0.22546," 1,50 "," 4.487,32 "," 2.269,46 ",2943109316,CFD," 0,00 "
17/02/2025 07:09:16,Open Position,NSDQ100/USD," 299,99 ",0.270438," 0,00 "," 4.487,32 "," 1.969,47 ",2943125521,CFD," 0,00 "
17/02/2025 07:09:29,Open Position,NSDQ100/USD," 249,99 ",0.225369," 0,00 "," 4.487,32 "," 1.719,48 ",2943125543,CFD," 0,00 "
17/02/2025 10:49:44,Open Position,NSDQ100/USD," 99,99 ",0.090207," 0,00 "," 4.487,32 "," 1.619,49 ",2943245056,CFD," 0,00 "
17/02/2025 15:02:52,Position closed,NSDQ100/USD," 103,72 ",0.090207," 3,73 "," 4.491,05 "," 1.723,21 ",2943245056,CFD," 0,00 "
17/02/2025 15:03:05,Position closed,USD/JPY," 103,91 ",3000," 3,92 "," 4.494,97 "," 1.827,12 ",2943109198,CFD," 0,00 "
17/02/2025 15:03:18,Open Position,USD/JPY," 200,00 ",6000," 0,00 "," 4.494,97 "," 1.627,12 ",2943305918,CFD," 0,00 "
17/02/2025 17:25:15,Position closed,USD/JPY," 201,82 ",6000," 1,82 "," 4.496,79 "," 1.828,94 ",2943305918,CFD," 0,00 "
17/02/2025 17:36:57,Open Position,USD/JPY," 150,00 ",4500," 0,00 "," 4.496,79 "," 1.678,94 ",2943425334,CFD," 0,00 "
17/02/2025 18:51:07,Open Position,USD/JPY," 350,00 ",10500," 0,00 "," 4.496,79 "," 1.328,94 ",2943432343,CFD," 0,00 "
17/02/2025 18:51:13,Position closed,USD/JPY," 148,04 ",4500,"(1,96)"," 4.494,83 "," 1.476,98 ",2943425334,CFD," 0,00 "
17/02/2025 23:03:51,Open Position,NSDQ100/USD," 99,99 ",0.090327," 0,00 "," 4.494,83 "," 1.376,99 ",2943446603,CFD," 0,00 "
17/02/2025 23:40:20,Position closed,USD/JPY," 355,00 ",10500," 5,00 "," 4.499,83 "," 1.731,99 ",2943432343,CFD," 0,00 "
17/02/2025 23:51:23,Open Position,USD/JPY," 200,00 ",6000," 0,00 "," 4.499,83 "," 1.531,99 ",2943450179,CFD," 0,00 "
18/02/2025 00:47:54,Overnight refund,Daily," 0,23 ",-," 0,23 "," 4.500,06 "," 1.532,22 ",2941868070,CFD," 0,00 "
18/02/2025 00:47:54,Overnight fee,Daily,"(0,02)",-,"(0,02)"," 4.500,04 "," 1.532,20 ",2943072114,CFD," 0,00 "
18/02/2025 00:47:54,Overnight fee,Daily,"(0,03)",-,"(0,03)"," 4.500,01 "," 1.532,17 ",2940436584,CFD," 0,00 "
18/02/2025 00:47:54,Overnight fee,Daily,"(0,03)",-,"(0,03)"," 4.499,98 "," 1.532,14 ",2941769321,CFD," 0,00 "
18/02/2025 00:47:54,Overnight fee,Daily,"(0,05)",-,"(0,05)"," 4.499,93 "," 1.532,09 ",2942722830,CFD," 0,00 "
18/02/2025 00:47:54,Overnight fee,Daily,"(0,05)",-,"(0,05)"," 4.499,88 "," 1.532,04 ",2941917933,CFD," 0,00 "
18/02/2025 00:47:54,Overnight fee,Daily,"(0,05)",-,"(0,05)"," 4.499,83 "," 1.531,99 ",2942923786,CFD," 0,00 "
18/02/2025 00:47:54,Overnight fee,Daily,"(0,07)",-,"(0,07)"," 4.499,76 "," 1.531,92 ",2941867797,CFD," 0,00 "
18/02/2025 00:47:54,Overnight fee,Daily,"(0,10)",-,"(0,10)"," 4.499,66 "," 1.531,82 ",2941886745,CFD," 0,00 "
18/02/2025 00:47:54,Overnight fee,Daily,"(1,21)",-,"(1,21)"," 4.498,45 "," 1.530,61 ",2943125543,CFD," 0,00 "
18/02/2025 00:47:54,Overnight fee,Daily,"(1,30)",-,"(1,30)"," 4.497,15 "," 1.529,31 ",2943122797,CFD," 0,00 "
18/02/2025 00:47:54,Overnight fee,Daily,"(1,45)",-,"(1,45)"," 4.495,70 "," 1.527,86 ",2943125521,CFD," 0,00 "
18/02/2025 00:47:54,Overnight fee,Daily,"(1,61)",-,"(1,61)"," 4.494,09 "," 1.526,25 ",2943432343,CFD," 0,00 "
18/02/2025 00:53:41,Index price adjustment,NSDQ100/USD,"(0,02)",-,"(0,02)"," 4.494,07 "," 1.526,23 ",2940436584,CFD," 0,00 "
18/02/2025 00:53:41,Index price adjustment,NSDQ100/USD,"(0,02)",-,"(0,02)"," 4.494,05 "," 1.526,21 ",2941769321,CFD," 0,00 "
18/02/2025 00:53:41,Index price adjustment,NSDQ100/USD,"(0,04)",-,"(0,04)"," 4.494,01 "," 1.526,17 ",2941867797,CFD," 0,00 "
18/02/2025 00:53:41,Index price adjustment,NSDQ100/USD,"(0,06)",-,"(0,06)"," 4.493,95 "," 1.526,11 ",2941886745,CFD," 0,00 "
18/02/2025 00:53:41,Index price adjustment,NSDQ100/USD,"(0,03)",-,"(0,03)"," 4.493,92 "," 1.526,08 ",2941917933,CFD," 0,00 "
18/02/2025 00:53:41,Index price adjustment,NSDQ100/USD,"(0,03)",-,"(0,03)"," 4.493,89 "," 1.526,05 ",2942722830,CFD," 0,00 "
18/02/2025 00:53:41,Index price adjustment,NSDQ100/USD,"(0,03)",-,"(0,03)"," 4.493,86 "," 1.526,02 ",2942923786,CFD," 0,00 "
18/02/2025 00:53:41,Index price adjustment,NSDQ100/USD,"(0,01)",-,"(0,01)"," 4.493,85 "," 1.526,01 ",2943072114,CFD," 0,00 "
18/02/2025 00:53:41,Index price adjustment,NSDQ100/USD," 0,05 ",-," 0,05 "," 4.493,90 "," 1.526,06 ",2943122797,CFD," 0,00 "
18/02/2025 00:53:41,Index price adjustment,NSDQ100/USD," 0,06 ",-," 0,06 "," 4.493,96 "," 1.526,12 ",2943125521,CFD," 0,00 "
18/02/2025 00:53:41,Index price adjustment,NSDQ100/USD," 0,05 ",-," 0,05 "," 4.494,01 "," 1.526,17 ",2943125543,CFD," 0,00 "
18/02/2025 02:55:09,Position closed,NSDQ100/USD," 102,64 ",0.090327," 2,65 "," 4.496,66 "," 1.628,81 ",2943446603,CFD," 0,00 "
18/02/2025 06:39:59,Position closed,NSDQ100/USD," 274,70 ",0.24341," 4,70 "," 4.501,36 "," 1.903,51 ",2943122797,CFD," 0,00 "
18/02/2025 06:48:28,Position closed,NSDQ100/USD," 256,20 ",0.225369," 6,21 "," 4.507,57 "," 2.159,71 ",2943125543,CFD," 0,00 "
18/02/2025 06:48:35,Position closed,NSDQ100/USD," 307,42 ",0.270438," 7,43 "," 4.515,00 "," 2.467,13 ",2943125521,CFD," 0,00 "
18/02/2025 07:00:07,Open Position,NSDQ100/USD," 321,25 ",0.179929," 0,00 "," 4.515,00 "," 2.267,15 ",2943492705,CFD," 0,00 "
18/02/2025 07:02:51,Open Position,NSDQ100/USD," 199,99 ",0.179968," 0,00 "," 4.515,00 "," 2.067,16 ",2943493247,CFD," 0,00 "
18/02/2025 07:22:30,Position closed,NSDQ100/USD," 201,20 ",0.179968," 1,21 "," 4.516,21 "," 2.268,36 ",2943493247,CFD," 0,00 "
18/02/2025 07:36:27,Open Position,USD/JPY," 99,99 ",3000," 0,00 "," 4.516,21 "," 2.168,37 ",2943498410,CFD," 0,00 "
18/02/2025 07:36:58,Open Position,NSDQ100/USD," 321,03 ",0.17995," 0,00 "," 4.516,21 "," 1.968,38 ",2943498460,CFD," 0,00 "
18/02/2025 07:41:28,Open Position,NSDQ100/USD," 99,99 ",0.089968," 0,00 "," 4.516,21 "," 1.868,39 ",2943499098,CFD," 0,00 "
18/02/2025 07:48:07,Open Position,USD/JPY," 100,00 ",3000," 0,00 "," 4.516,21 "," 1.768,39 ",2943500189,CFD," 0,00 "
18/02/2025 08:05:21,Position closed,USD/JPY," 102,47 ",3000," 2,47 "," 4.518,68 "," 1.870,86 ",2943500189,CFD," 0,00 "
18/02/2025 08:09:53,Open Position,USD/JPY," 120,00 ",3600," 0,00 "," 4.518,68 "," 1.750,86 ",2943525464,CFD," 0,00 "
18/02/2025 08:15:52,Open Position,NSDQ100/USD," 150,00 ",0.135083," 0,00 "," 4.518,68 "," 1.600,86 ",2943527419,CFD," 0,00 "
18/02/2025 09:17:22,Position closed,NSDQ100/USD," 150,93 ",0.135083," 0,93 "," 4.519,61 "," 1.751,79 ",2943527419,CFD," 0,00 "
18/02/2025 10:45:16,Position closed,USD/JPY," 101,89 ",3000," 1,90 "," 4.521,51 "," 1.853,68 ",2943498410,CFD," 0,00 "
18/02/2025 13:44:42,Open Position,USD/JPY," 99,99 ",3000," 0,00 "," 4.521,51 "," 1.753,69 ",2943736299,CFD," 0,00 "
18/02/2025 13:45:41,Open Position,NSDQ100/USD," 149,99 ",0.135002," 0,00 "," 4.521,51 "," 1.603,70 ",2943736591,CFD," 0,00 "
18/02/2025 14:44:48,Position closed,NSDQ100/USD," 159,64 ",0.135002," 9,65 "," 4.531,16 "," 1.763,34 ",2943736591,CFD," 0,00 "
18/02/2025 14:46:56,Position closed,NSDQ100/USD," 75,68 ",0.067788," 0,69 "," 4.531,85 "," 1.839,02 ",2943072114,CFD," 0,00 "
18/02/2025 14:49:34,Open Position,NSDQ100/USD," 119,99 ",0.108563," 0,00 "," 4.531,85 "," 1.719,03 ",2944218140,CFD," 0,00 "
18/02/2025 15:00:27,Position closed,NSDQ100/USD," 121,31 ",0.108563," 1,32 "," 4.533,17 "," 1.840,34 ",2944218140,CFD," 0,00 "
18/02/2025 15:00:42,Open Position,NSDQ100/USD," 259,98 ",0.235089," 0,00 "," 4.533,17 "," 1.580,36 ",2944641274,CFD," 0,00 "
18/02/2025 15:29:47,Position closed,NSDQ100/USD," 152,76 ",0.135845," 2,77 "," 4.535,94 "," 1.733,12 ",2942923786,CFD," 0,00 "
18/02/2025 15:33:16,Open Position,NSDQ100/USD," 200,00 ",0.181251," 0,00 "," 4.535,94 "," 1.533,12 ",2944727424,CFD," 0,00 "
18/02/2025 15:37:08,Open Position,NSDQ100/USD," 99,98 ",0.090574," 0,00 "," 4.535,94 "," 1.433,14 ",2944736549,CFD," 0,00 "
18/02/2025 15:46:48,Position closed,USD/JPY," 102,15 ",3000," 2,16 "," 4.538,10 "," 1.535,29 ",2943736299,CFD," 0,00 "
18/02/2025 15:47:05,Open Position,USD/JPY," 149,99 ",4500," 0,00 "," 4.538,10 "," 1.385,30 ",2944762450,CFD," 0,00 "
18/02/2025 15:55:49,Position closed,NSDQ100/USD," 205,49 ",0.181251," 5,49 "," 4.543,59 "," 1.590,79 ",2944727424,CFD," 0,00 "
18/02/2025 15:55:54,Position closed,NSDQ100/USD," 102,12 ",0.090574," 2,14 "," 4.545,73 "," 1.692,91 ",2944736549,CFD," 0,00 "
18/02/2025 15:56:03,Open Position,NSDQ100/USD," 270,00 ",0.24429," 0,00 "," 4.545,73 "," 1.422,91 ",2944782034,CFD," 0,00 "
18/02/2025 17:12:52,Position closed,NSDQ100/USD," 269,63 ",0.24429,"(0,37)"," 4.545,36 "," 1.692,54 ",2944782034,CFD," 0,00 "
18/02/2025 17:15:33,Position closed,NSDQ100/USD," 255,88 ",0.235089,"(4,10)"," 4.541,26 "," 1.948,42 ",2944641274,CFD," 0,00 "
18/02/2025 17:15:48,Open Position,NSDQ100/USD," 149,99 ",0.135749," 0,00 "," 4.541,26 "," 1.798,43 ",2945365014,CFD," 0,00 "
18/02/2025 17:18:42,Position closed,NSDQ100/USD," 150,88 ",0.135749," 0,89 "," 4.542,15 "," 1.949,31 ",2945365014,CFD," 0,00 "
18/02/2025 17:19:22,Open Position,NSDQ100/USD," 250,00 ",0.226355," 0,00 "," 4.542,15 "," 1.699,31 ",2945369857,CFD," 0,00 "
18/02/2025 19:10:11,Position closed,NSDQ100/USD," 260,22 ",0.226355," 10,22 "," 4.552,37 "," 1.959,53 ",2945369857,CFD," 0,00 "
18/02/2025 19:14:03,Open Position,NSDQ100/USD," 99,99 ",0.090693," 0,00 "," 4.552,37 "," 1.859,54 ",2945519063,CFD," 0,00 "
18/02/2025 19:15:03,Open Position,NSDQ100/USD," 119,99 ",0.10886," 0,00 "," 4.552,37 "," 1.739,55 ",2945519865,CFD," 0,00 "
18/02/2025 20:13:04,Position closed,NSDQ100/USD," 125,03 ",0.10886," 5,04 "," 4.557,41 "," 1.864,58 ",2945519865,CFD," 0,00 "
18/02/2025 20:18:07,Open Position,NSDQ100/USD," 150,00 ",0.135796," 0,00 "," 4.557,41 "," 1.714,58 ",2945579892,CFD," 0,00 "
18/02/2025 20:18:16,Open Position,NSDQ100/USD," 149,99 ",0.135813," 0,00 "," 4.557,41 "," 1.564,59 ",2945580050,CFD," 0,00 "
18/02/2025 21:23:29,Position closed,NSDQ100/USD," 157,72 ",0.135796," 7,72 "," 4.565,13 "," 1.722,31 ",2945579892,CFD," 0,00 "
18/02/2025 21:24:06,Open Position,NSDQ100/USD," 149,99 ",0.135446," 0,00 "," 4.565,13 "," 1.572,32 ",2945621337,CFD," 0,00 "
18/02/2025 21:24:28,Open Position,NSDQ100/USD," 74,99 ",0.067712," 0,00 "," 4.565,13 "," 1.497,33 ",2945621379,CFD," 0,00 "
18/02/2025 21:24:51,Position closed,USD/JPY," 121,16 ",3600," 1,16 "," 4.566,29 "," 1.618,49 ",2943525464,CFD," 0,00 "
18/02/2025 21:25:28,Open Position,USD/JPY," 75,00 ",2250," 0,00 "," 4.566,29 "," 1.543,49 ",2945621761,CFD," 0,00 "
18/02/2025 21:40:15,Position closed,NSDQ100/USD," 74,23 ",0.067712,"(0,76)"," 4.565,53 "," 1.617,72 ",2945621379,CFD," 0,00 "
18/02/2025 21:40:20,Position closed,NSDQ100/USD," 150,62 ",0.135446," 0,63 "," 4.566,16 "," 1.768,34 ",2945621337,CFD," 0,00 "
18/02/2025 21:40:37,Open Position,NSDQ100/USD," 149,99 ",0.135504," 0,00 "," 4.566,16 "," 1.618,35 ",2945623038,CFD," 0,00 "
18/02/2025 23:08:02,Open Position,NSDQ100/USD," 100,00 ",0.090233," 0,00 "," 4.566,16 "," 1.518,35 ",2945628486,CFD," 0,00 "
18/02/2025 23:31:08,Open Position,NSDQ100/USD," 99,99 ",0.090236," 0,00 "," 4.566,16 "," 1.418,36 ",2945630254,CFD," 0,00 "
19/02/2025 00:47:39,Overnight fee,Daily,"(0,03)",-,"(0,03)"," 4.566,13 "," 1.418,33 ",2940436584,CFD," 0,00 "
19/02/2025 00:47:39,Overnight fee,Daily,"(0,05)",-,"(0,05)"," 4.566,08 "," 1.418,28 ",2945580050,CFD," 0,00 "
19/02/2025 00:47:39,Overnight fee,Daily,"(0,05)",-,"(0,05)"," 4.566,03 "," 1.418,23 ",2942722830,CFD," 0,00 "
19/02/2025 00:47:39,Overnight fee,Daily,"(0,05)",-,"(0,05)"," 4.565,98 "," 1.418,18 ",2941917933,CFD," 0,00 "
19/02/2025 00:47:39,Overnight fee,Daily,"(0,05)",-,"(0,05)"," 4.565,93 "," 1.418,13 ",2945623038,CFD," 0,00 "
19/02/2025 00:47:39,Overnight fee,Daily,"(0,07)",-,"(0,07)"," 4.565,86 "," 1.418,06 ",2941867797,CFD," 0,00 "
19/02/2025 00:47:39,Overnight fee,Daily,"(0,10)",-,"(0,10)"," 4.565,76 "," 1.417,96 ",2941886745,CFD," 0,00 "
19/02/2025 00:47:39,Overnight fee,Daily,"(0,48)",-,"(0,48)"," 4.565,28 "," 1.417,48 ",2943499098,CFD," 0,00 "
19/02/2025 00:47:39,Overnight fee,Daily,"(0,69)",-,"(0,69)"," 4.564,59 "," 1.416,79 ",2944762450,CFD," 0,00 "
19/02/2025 00:47:39,Overnight fee,Daily,"(0,92)",-,"(0,92)"," 4.563,67 "," 1.415,87 ",2943450179,CFD," 0,00 "
19/02/2025 00:47:39,Overnight fee,Daily,"(0,96)",-,"(0,96)"," 4.562,71 "," 1.414,91 ",2943498460,CFD," 0,00 "
19/02/2025 00:47:39,Overnight fee,Daily,"(0,96)",-,"(0,96)"," 4.561,75 "," 1.413,95 ",2943492705,CFD," 0,00 "
19/02/2025 00:47:39,Overnight refund,Daily," 0,23 ",-," 0,23 "," 4.561,98 "," 1.414,18 ",2941868070,CFD," 0,00 "
19/02/2025 00:47:39,Overnight refund,Daily," 0,17 ",-," 0,17 "," 4.562,15 "," 1.414,35 ",2945621761,CFD," 0,00 "
19/02/2025 00:47:39,Overnight fee,Daily,"(0,03)",-,"(0,03)"," 4.562,12 "," 1.414,32 ",2945519063,CFD," 0,00 "
19/02/2025 00:47:39,Overnight fee,Daily,"(0,03)",-,"(0,03)"," 4.562,09 "," 1.414,29 ",2941769321,CFD," 0,00 "
19/02/2025 06:09:42,Position closed,NSDQ100/USD," 102,09 ",0.090236," 2,10 "," 4.564,19 "," 1.516,38 ",2945630254,CFD," 0,00 "
19/02/2025 07:48:46,Open Position,NSDQ100/USD," 150,00 ",0.135232," 0,00 "," 4.564,19 "," 1.366,38 ",2945670258,CFD," 0,00 "
19/02/2025 10:47:17,Position closed,NSDQ100/USD," 102,57 ",0.090233," 2,57 "," 4.566,76 "," 1.468,95 ",2945628486,CFD," 0,00 "
19/02/2025 10:49:27,Open Position,NSDQ100/USD," 99,99 ",0.09033," 0,00 "," 4.566,76 "," 1.368,96 ",2945782405,CFD," 0,00 "
19/02/2025 10:51:33,Open Position,NSDQ100/USD," 149,99 ",0.135525," 0,00 "," 4.566,76 "," 1.218,97 ",2945782897,CFD," 0,00 "
19/02/2025 10:52:18,Open Position,USD/JPY," 100,00 ",3000," 0,00 "," 4.566,76 "," 1.118,97 ",2945783028,CFD," 0,00 "
19/02/2025 12:01:28,Position closed,USD/JPY," 102,13 ",3000," 2,13 "," 4.568,89 "," 1.221,10 ",2945783028,CFD," 0,00 "
19/02/2025 12:01:37,Open Position,USD/JPY," 100,00 ",3000," 0,00 "," 4.568,89 "," 1.121,10 ",2945808894,CFD," 0,00 "
19/02/2025 12:01:51,Position closed,NSDQ100/USD," 101,54 ",0.09033," 1,55 "," 4.570,44 "," 1.222,64 ",2945782405,CFD," 0,00 "
19/02/2025 12:02:11,Open Position,NSDQ100/USD," 149,99 ",0.135352," 0,00 "," 4.570,44 "," 1.072,65 ",2945809076,CFD," 0,00 "
19/02/2025 12:31:34,Position closed,NSDQ100/USD," 150,55 ",0.135352," 0,56 "," 4.571,00 "," 1.223,20 ",2945809076,CFD," 0,00 "
19/02/2025 13:43:01,Position closed,NSDQ100/USD," 152,34 ",0.135525," 2,35 "," 4.573,35 "," 1.375,54 ",2945782897,CFD," 0,00 "
19/02/2025 13:43:05,Position closed,NSDQ100/USD," 152,83 ",0.135504," 2,84 "," 4.576,19 "," 1.528,37 ",2945623038,CFD," 0,00 "
19/02/2025 13:43:15,Open Position,NSDQ100/USD," 249,99 ",0.22607," 0,00 "," 4.576,19 "," 1.278,38 ",2945841398,CFD," 0,00 "
19/02/2025 13:43:30,Open Position,NSDQ100/USD," 100,00 ",0.090423," 0,00 "," 4.576,19 "," 1.178,38 ",2945841492,CFD," 0,00 "
19/02/2025 13:46:58,Position closed,NSDQ100/USD," 99,30 ",0.090423,"(0,70)"," 4.575,49 "," 1.277,68 ",2945841492,CFD," 0,00 "
19/02/2025 14:05:38,Open Position,NSDQ100/USD," 150,00 ",0.135506," 0,00 "," 4.575,49 "," 1.127,68 ",2945848428,CFD," 0,00 "
19/02/2025 15:01:37,Position closed,NSDQ100/USD," 253,42 ",0.22607," 3,43 "," 4.578,92 "," 1.381,10 ",2945841398,CFD," 0,00 "
19/02/2025 15:03:04,Position closed,USD/JPY," 205,00 ",6000," 5,00 "," 4.583,92 "," 1.586,10 ",2943450179,CFD," 0,00 "
19/02/2025 15:03:16,Position closed,USD/JPY," 158,14 ",4500," 8,15 "," 4.592,07 "," 1.744,24 ",2944762450,CFD," 0,00 "
19/02/2025 15:04:40,Position closed,NSDQ100/USD," 152,96 ",0.135813," 2,97 "," 4.595,04 "," 1.897,20 ",2945580050,CFD," 0,00 "
19/02/2025 15:04:52,Open Position,NSDQ100/USD," 199,99 ",0.181318," 0,00 "," 4.595,04 "," 1.697,21 ",2946134162,CFD," 0,00 "
19/02/2025 15:08:02,Open Position,USD/JPY," 100,00 ",3000," 0,00 "," 4.595,04 "," 1.597,21 ",2946149111,CFD," 0,00 "
19/02/2025 15:09:21,Position closed,NSDQ100/USD," 100,29 ",0.090693," 0,30 "," 4.595,34 "," 1.697,50 ",2945519063,CFD," 0,00 "
19/02/2025 15:11:55,Position closed,NSDQ100/USD," 201,37 ",0.181318," 1,38 "," 4.596,72 "," 1.898,87 ",2946134162,CFD," 0,00 "
19/02/2025 15:12:54,Open Position,NSDQ100/USD," 174,99 ",0.158645," 0,00 "," 4.596,72 "," 1.723,88 ",2946197323,CFD," 0,00 "
19/02/2025 15:26:03,Position closed,NSDQ100/USD," 175,72 ",0.158645," 0,73 "," 4.597,45 "," 1.899,60 ",2946197323,CFD," 0,00 "
19/02/2025 15:26:11,Open Position,NSDQ100/USD," 150,00 ",0.135908," 0,00 "," 4.597,45 "," 1.749,60 ",2946335397,CFD," 0,00 "
19/02/2025 15:55:10,Position closed,USD/JPY," 101,70 ",3000," 1,70 "," 4.599,15 "," 1.851,30 ",2946149111,CFD," 0,00 "
19/02/2025 15:55:18,Open Position,USD/JPY," 100,00 ",3000," 0,00 "," 4.599,15 "," 1.751,30 ",2946388316,CFD," 0,00 "
19/02/2025 15:55:24,Position closed,NSDQ100/USD," 153,14 ",0.135908," 3,14 "," 4.602,29 "," 1.904,44 ",2946335397,CFD," 0,00 "
19/02/2025 15:56:11,Open Position,NSDQ100/USD," 149,98 ",0.1358," 0,00 "," 4.602,29 "," 1.754,46 ",2946389459,CFD," 0,00 "
19/02/2025 16:05:15,Position closed,USD/JPY," 101,88 ",3000," 1,88 "," 4.604,17 "," 1.856,34 ",2946388316,CFD," 0,00 "
19/02/2025 17:08:04,Position closed,NSDQ100/USD," 154,00 ",0.135506," 4,00 "," 4.608,17 "," 2.010,34 ",2945848428,CFD," 0,00 "
19/02/2025 17:08:29,Open Position,NSDQ100/USD," 100,00 ",0.090207," 0,00 "," 4.608,17 "," 1.910,34 ",2946474651,CFD," 0,00 "
19/02/2025 18:07:48,Position closed,NSDQ100/USD," 102,16 ",0.090207," 2,16 "," 4.610,33 "," 2.012,50 ",2946474651,CFD," 0,00 "
19/02/2025 18:08:04,Open Position,NSDQ100/USD," 149,99 ",0.135489," 0,00 "," 4.610,33 "," 1.862,51 ",2946527791,CFD," 0,00 "
19/02/2025 18:59:24,Position closed,USD/JPY," 33,34 ",1490.3898,"(16,34)"," 4.593,99 "," 1.895,85 ",2946575948,CFD," 0,00 "
19/02/2025 19:00:05,Open Position,USD/JPY," 99,99 ",3000," 0,00 "," 4.593,99 "," 1.795,86 ",2946576226,CFD," 0,00 "
19/02/2025 19:01:13,Open Position,NSDQ100/USD," 199,99 ",0.180519," 0,00 "," 4.593,99 "," 1.595,87 ",2946576830,CFD," 0,00 "
19/02/2025 19:32:52,Position closed,NSDQ100/USD," 151,06 ",0.135232," 1,06 "," 4.595,05 "," 1.746,93 ",2945670258,CFD," 0,00 "
19/02/2025 19:46:25,Open Position,NSDQ100/USD," 100,00 ",0.09007," 0,00 "," 4.595,05 "," 1.646,93 ",2946607777,CFD," 0,00 "
19/02/2025 21:32:01,Position closed,NSDQ100/USD," 105,28 ",0.09007," 5,28 "," 4.600,33 "," 1.752,21 ",2946607777,CFD," 0,00 "
19/02/2025 21:32:08,Position closed,NSDQ100/USD," 202,11 ",0.180519," 2,12 "," 4.602,45 "," 1.954,32 ",2946576830,CFD," 0,00 "
19/02/2025 21:32:18,Position closed,USD/JPY," 102,41 ",3000," 2,42 "," 4.604,87 "," 2.056,73 ",2946576226,CFD," 0,00 "
19/02/2025 21:32:56,Open Position,NSDQ100/USD," 99,98 ",0.090298," 0,00 "," 4.604,87 "," 1.956,75 ",2946687040,CFD," 0,00 "
20/02/2025 00:37:53,Index price adjustment,NSDQ100/USD,"(0,36)",-,"(0,36)"," 4.604,51 "," 1.956,39 ",2940436584,CFD," 0,00 "
20/02/2025 00:37:53,Index price adjustment,NSDQ100/USD,"(0,36)",-,"(0,36)"," 4.604,15 "," 1.956,03 ",2941769321,CFD," 0,00 "
20/02/2025 00:37:53,Index price adjustment,NSDQ100/USD,"(0,72)",-,"(0,72)"," 4.603,43 "," 1.955,31 ",2941867797,CFD," 0,00 "
20/02/2025 00:37:53,Index price adjustment,NSDQ100/USD,"(1,07)",-,"(1,07)"," 4.602,36 "," 1.954,24 ",2941886745,CFD," 0,00 "
20/02/2025 00:37:53,Index price adjustment,NSDQ100/USD,"(0,54)",-,"(0,54)"," 4.601,82 "," 1.953,70 ",2941917933,CFD," 0,00 "
20/02/2025 00:37:53,Index price adjustment,NSDQ100/USD,"(0,53)",-,"(0,53)"," 4.601,29 "," 1.953,17 ",2942722830,CFD," 0,00 "
20/02/2025 00:37:53,Index price adjustment,NSDQ100/USD," 0,70 ",-," 0,70 "," 4.601,99 "," 1.953,87 ",2943492705,CFD," 0,00 "
20/02/2025 00:37:53,Index price adjustment,NSDQ100/USD," 0,70 ",-," 0,70 "," 4.602,69 "," 1.954,57 ",2943498460,CFD," 0,00 "
20/02/2025 00:37:53,Index price adjustment,NSDQ100/USD," 0,35 ",-," 0,35 "," 4.603,04 "," 1.954,92 ",2943499098,CFD," 0,00 "
20/02/2025 00:37:53,Index price adjustment,NSDQ100/USD,"(0,53)",-,"(0,53)"," 4.602,51 "," 1.954,39 ",2946389459,CFD," 0,00 "
20/02/2025 00:37:53,Index price adjustment,NSDQ100/USD,"(0,53)",-,"(0,53)"," 4.601,98 "," 1.953,86 ",2946527791,CFD," 0,00 "
20/02/2025 00:37:53,Index price adjustment,NSDQ100/USD,"(0,71)",-,"(0,71)"," 4.601,27 "," 1.953,15 ",2946576830,CFD," 0,00 "
20/02/2025 00:37:53,Index price adjustment,NSDQ100/USD,"(0,35)",-,"(0,35)"," 4.600,92 "," 1.952,80 ",2946607777,CFD," 0,00 "
20/02/2025 00:48:01,Weekend refund,Weekend Fee," 0,70 ",-," 0,70 "," 4.601,62 "," 1.953,50 ",2945808894,CFD," 0,00 "
20/02/2025 00:48:01,Weekend refund,Weekend Fee," 0,52 ",-," 0,52 "," 4.602,14 "," 1.954,02 ",2945621761,CFD," 0,00 "
20/02/2025 00:48:01,Weekend refund,Weekend Fee," 0,35 ",-," 0,35 "," 4.602,49 "," 1.954,37 ",2941868070,CFD," 0,00 "
20/02/2025 00:48:01,Overnight fee,Daily,"(0,03)",-,"(0,03)"," 4.602,46 "," 1.954,34 ",2940436584,CFD," 0,00 "
20/02/2025 00:48:01,Overnight fee,Daily,"(0,03)",-,"(0,03)"," 4.602,43 "," 1.954,31 ",2941769321,CFD," 0,00 "
20/02/2025 00:48:01,Overnight fee,Daily,"(0,05)",-,"(0,05)"," 4.602,38 "," 1.954,26 ",2946389459,CFD," 0,00 "
20/02/2025 00:48:01,Overnight fee,Daily,"(0,05)",-,"(0,05)"," 4.602,33 "," 1.954,21 ",2942722830,CFD," 0,00 "
20/02/2025 00:48:01,Overnight fee,Daily,"(0,05)",-,"(0,05)"," 4.602,28 "," 1.954,16 ",2946527791,CFD," 0,00 "
20/02/2025 00:48:01,Overnight fee,Daily,"(0,05)",-,"(0,05)"," 4.602,23 "," 1.954,11 ",2941917933,CFD," 0,00 "
20/02/2025 00:48:01,Overnight fee,Daily,"(0,07)",-,"(0,07)"," 4.602,16 "," 1.954,04 ",2941867797,CFD," 0,00 "
20/02/2025 00:48:01,Overnight fee,Daily,"(0,10)",-,"(0,10)"," 4.602,06 "," 1.953,94 ",2941886745,CFD," 0,00 "
20/02/2025 00:48:01,Overnight fee,Daily,"(0,48)",-,"(0,48)"," 4.601,58 "," 1.953,46 ",2946687040,CFD," 0,00 "
20/02/2025 00:48:01,Overnight fee,Daily,"(0,48)",-,"(0,48)"," 4.601,10 "," 1.952,98 ",2943499098,CFD," 0,00 "
20/02/2025 00:48:01,Overnight fee,Daily,"(0,96)",-,"(0,96)"," 4.600,14 "," 1.952,02 ",2943498460,CFD," 0,00 "
20/02/2025 00:48:01,Overnight fee,Daily,"(0,96)",-,"(0,96)"," 4.599,18 "," 1.951,06 ",2943492705,CFD," 0,00 "
20/02/2025 01:05:43,Position closed,USD/JPY," 25,13 ",1509.550738,"(25,18)"," 4.574,00 "," 1.976,19 ",2941868070,CFD," 0,00 "
20/02/2025 01:20:08,Open Position,USD/JPY," 199,99 ",6000," 0,00 "," 4.574,00 "," 1.776,20 ",2946699031,CFD," 0,00 "
20/02/2025 01:20:22,Position closed,NSDQ100/USD," 151,02 ",0.135489," 1,03 "," 4.575,03 "," 1.927,22 ",2946527791,CFD," 0,00 "
20/02/2025 01:20:40,Open Position,NSDQ100/USD," 150,00 ",0.135558," 0,00 "," 4.575,03 "," 1.777,22 ",2946699051,CFD," 0,00 "
20/02/2025 01:32:40,Position closed,NSDQ100/USD," 152,15 ",0.135558," 2,15 "," 4.577,18 "," 1.929,37 ",2946699051,CFD," 0,00 "
20/02/2025 07:07:49,Position closed,NSDQ100/USD," 152,43 ",0.1358," 2,45 "," 4.579,63 "," 2.081,80 ",2946389459,CFD," 0,00 "
20/02/2025 07:28:23,Open Position,NSDQ100/USD," 150,00 ",0.135837," 0,00 "," 4.579,63 "," 1.931,80 ",2946740624,CFD," 0,00 "
20/02/2025 07:28:36,Open Position,NSDQ100/USD," 149,99 ",0.135856," 0,00 "," 4.579,63 "," 1.781,81 ",2946740646,CFD," 0,00 "
20/02/2025 08:36:11,Position closed,NSDQ100/USD," 151,54 ",0.135837," 1,54 "," 4.581,17 "," 1.933,35 ",2946740624,CFD," 0,00 "
20/02/2025 08:39:15,Open Position,USD/JPY," 200,00 ",6000," 0,00 "," 4.581,17 "," 1.733,35 ",2946883446,CFD," 0,00 "
20/02/2025 08:39:43,Open Position,NSDQ100/USD," 150,00 ",0.135728," 0,00 "," 4.581,17 "," 1.583,35 ",2946883546,CFD," 0,00 "
20/02/2025 10:37:55,Position closed,USD/JPY," 205,20 ",6000," 5,20 "," 4.586,37 "," 1.788,55 ",2946883446,CFD," 0,00 "
20/02/2025 10:38:18,Open Position,USD/JPY," 149,99 ",4500," 0,00 "," 4.586,37 "," 1.638,56 ",2946948926,CFD," 0,00 "
20/02/2025 10:38:25,Open Position,USD/JPY," 75,00 ",2250," 0,00 "," 4.586,37 "," 1.563,56 ",2946948955,CFD," 0,00 "
20/02/2025 10:38:36,Position closed,NSDQ100/USD," 153,96 ",0.135728," 3,96 "," 4.590,33 "," 1.717,52 ",2946883546,CFD," 0,00 "
20/02/2025 10:39:07,Open Position,NSDQ100/USD," 100,00 ",0.090365," 0,00 "," 4.590,33 "," 1.617,52 ",2946949140,CFD," 0,00 "
20/02/2025 10:39:15,Open Position,NSDQ100/USD," 150,00 ",0.135523," 0,00 "," 4.590,33 "," 1.467,52 ",2946949156,CFD," 0,00 "
20/02/2025 12:33:03,Position closed,USD/JPY," 74,22 ",2250,"(0,78)"," 4.589,55 "," 1.541,74 ",2946948955,CFD," 0,00 "
20/02/2025 12:33:10,Position closed,USD/JPY," 150,83 ",4500," 0,84 "," 4.590,39 "," 1.692,57 ",2946948926,CFD," 0,00 "
20/02/2025 12:33:26,Position closed,NSDQ100/USD," 101,43 ",0.090365," 1,43 "," 4.591,82 "," 1.794,00 ",2946949140,CFD," 0,00 "
20/02/2025 12:33:42,Open Position,NSDQ100/USD," 199,99 ",0.180873," 0,00 "," 4.591,82 "," 1.594,01 ",2946974857,CFD," 0,00 "
20/02/2025 13:30:42,Open Position,USD/JPY," 99,99 ",3000," 0,00 "," 4.591,82 "," 1.494,02 ",2946996451,CFD," 0,00 "
20/02/2025 13:31:41,Open Position,USD/JPY," 99,99 ",3000," 0,00 "," 4.591,82 "," 1.394,03 ",2946996640,CFD," 0,00 "
20/02/2025 13:38:51,Position closed,USD/JPY," 97,61 ",3000,"(2,38)"," 4.589,44 "," 1.491,64 ",2946996451,CFD," 0,00 "
20/02/2025 13:38:52,Position closed,USD/JPY," 62,22 ",3000,"(37,78)"," 4.551,66 "," 1.553,86 ",2945808894,CFD," 0,00 "
20/02/2025 13:38:52,Position closed,USD/JPY," 170,27 ",6000,"(29,72)"," 4.521,94 "," 1.724,13 ",2946699031,CFD," 0,00 "
20/02/2025 13:38:52,Position closed,USD/JPY," 43,60 ",2250,"(31,40)"," 4.490,54 "," 1.767,73 ",2945621761,CFD," 0,00 "
20/02/2025 13:38:52,Position closed,USD/JPY," 96,81 ",3000,"(3,18)"," 4.487,36 "," 1.864,54 ",2946996640,CFD," 0,00 "
20/02/2025 13:39:32,Open Position,NSDQ100/USD," 300,00 ",0.271295," 0,00 "," 4.487,36 "," 1.564,54 ",2946998752,CFD," 0,00 "
20/02/2025 14:02:28,Position closed,NSDQ100/USD," 304,01 ",0.271295," 4,01 "," 4.491,37 "," 1.868,55 ",2946998752,CFD," 0,00 "
20/02/2025 14:02:38,Open Position,NSDQ100/USD," 249,99 ",0.225892," 0,00 "," 4.491,37 "," 1.618,56 ",2947005388,CFD," 0,00 "
20/02/2025 14:31:40,Position closed,NSDQ100/USD," 250,56 ",0.225892," 0,57 "," 4.491,94 "," 1.869,12 ",2947005388,CFD," 0,00 "
20/02/2025 14:33:42,Position closed,NSDQ100/USD," 201,01 ",0.180873," 1,02 "," 4.492,96 "," 2.070,13 ",2946974857,CFD," 0,00 "
20/02/2025 14:34:14,Open Position,NSDQ100/USD," 250,00 ",0.226138," 0,00 "," 4.492,96 "," 1.820,13 ",2947162074,CFD," 0,00 "
20/02/2025 14:37:24,Position closed,NSDQ100/USD," 251,10 ",0.226138," 1,10 "," 4.494,06 "," 2.071,23 ",2947162074,CFD," 0,00 "
20/02/2025 14:37:34,Open Position,NSDQ100/USD," 249,99 ",0.22609," 0,00 "," 4.494,06 "," 1.821,24 ",2947199642,CFD," 0,00 "
20/02/2025 14:40:30,Position closed,NSDQ100/USD," 251,68 ",0.22609," 1,69 "," 4.495,75 "," 2.072,92 ",2947199642,CFD," 0,00 "
20/02/2025 14:40:39,Open Position,NSDQ100/USD," 175,00 ",0.158179," 0,00 "," 4.495,75 "," 1.897,92 ",2947212018,CFD," 0,00 "
20/02/2025 14:52:13,Position closed,NSDQ100/USD," 155,80 ",0.135856," 5,81 "," 4.501,56 "," 2.053,72 ",2946740646,CFD," 0,00 "
20/02/2025 14:52:59,Position closed,NSDQ100/USD," 150,14 ",0.136241," 0,15 "," 4.501,71 "," 2.203,86 ",2942722830,CFD," 0,00 "
20/02/2025 14:54:06,Open Position,NSDQ100/USD," 249,98 ",0.227384," 0,00 "," 4.501,71 "," 1.953,88 ",2947357064,CFD," 0,00 "
20/02/2025 14:56:08,Position closed,NSDQ100/USD," 72,60 ",0.068144,"(2,19)"," 4.499,52 "," 2.026,48 ",2947365305,CFD," 0,00 "
20/02/2025 15:00:32,Position closed,NSDQ100/USD," 77,00 ",0.068523," 1,80 "," 4.501,32 "," 2.103,48 ",2941917933,CFD," 0,00 "
20/02/2025 15:01:07,Position closed,NSDQ100/USD," 305,42 ",0.273567," 5,43 "," 4.506,75 "," 2.408,90 ",2941886745,CFD," 0,00 "
20/02/2025 15:02:06,Open Position,NSDQ100/USD," 99,98 ",0.091301," 0,00 "," 4.506,75 "," 2.308,92 ",2947386892,CFD," 0,00 "
20/02/2025 15:03:27,Position closed,NSDQ100/USD," 101,50 ",0.091301," 1,52 "," 4.508,27 "," 2.410,42 ",2947386892,CFD," 0,00 "
20/02/2025 15:03:50,Open Position,NSDQ100/USD," 249,97 ",0.227899," 0,00 "," 4.508,27 "," 2.160,45 ",2947397884,CFD," 0,00 "
20/02/2025 15:04:41,Position closed,NSDQ100/USD," 252,69 ",0.227899," 2,72 "," 4.510,99 "," 2.413,14 ",2947397884,CFD," 0,00 "
20/02/2025 15:04:55,Open Position,NSDQ100/USD," 199,98 ",0.182137," 0,00 "," 4.510,99 "," 2.213,16 ",2947410378,CFD," 0,00 "
20/02/2025 15:06:37,Position closed,NSDQ100/USD," 200,20 ",0.182137," 0,22 "," 4.511,21 "," 2.413,36 ",2947410378,CFD," 0,00 "
20/02/2025 15:06:45,Open Position,NSDQ100/USD," 249,99 ",0.227625," 0,00 "," 4.511,21 "," 2.163,37 ",2947418014,CFD," 0,00 "
20/02/2025 15:09:20,Open Position,NSDQ100/USD," 99,99 ",0.091201," 0,00 "," 4.511,21 "," 2.063,38 ",2947430894,CFD," 0,00 "
20/02/2025 15:31:32,Position closed,NSDQ100/USD," 256,21 ",0.227384," 6,23 "," 4.517,44 "," 2.319,59 ",2947357064,CFD," 0,00 "
20/02/2025 15:31:53,Position closed,NSDQ100/USD," 260,84 ",0.227625," 10,85 "," 4.528,29 "," 2.580,43 ",2947418014,CFD," 0,00 "
20/02/2025 15:32:09,Position closed,NSDQ100/USD," 108,21 ",0.091201," 8,22 "," 4.536,51 "," 2.688,64 ",2947430894,CFD," 0,00 "
20/02/2025 15:32:39,Open Position,NSDQ100/USD," 199,99 ",0.181603," 0,00 "," 4.536,51 "," 2.488,65 ",2947548405,CFD," 0,00 "
20/02/2025 15:36:00,Open Position,NSDQ100/USD," 149,97 ",0.136362," 0,00 "," 4.536,51 "," 2.338,68 ",2947554758,CFD," 0,00 "
20/02/2025 15:45:39,Position closed,NSDQ100/USD," 150,72 ",0.136362," 0,75 "," 4.537,26 "," 2.489,40 ",2947554758,CFD," 0,00 "
20/02/2025 15:45:56,Open Position,NSDQ100/USD," 100,00 ",0.09099," 0,00 "," 4.537,26 "," 2.389,40 ",2947570607,CFD," 0,00 "
20/02/2025 16:08:33,Position closed,NSDQ100/USD," 102,35 ",0.09099," 2,35 "," 4.539,61 "," 2.491,75 ",2947570607,CFD," 0,00 "
20/02/2025 16:11:28,Open Position,NSDQ100/USD," 199,98 ",0.18198," 0,00 "," 4.539,61 "," 2.291,77 ",2947614072,CFD," 0,00 "
20/02/2025 16:36:51,Position closed,NSDQ100/USD," 203,44 ",0.18198," 3,46 "," 4.543,07 "," 2.495,21 ",2947614072,CFD," 0,00 "
20/02/2025 16:37:09,Open Position,NSDQ100/USD," 149,98 ",0.136637," 0,00 "," 4.543,07 "," 2.345,23 ",2947684060,CFD," 0,00 "
20/02/2025 16:38:22,Position closed,NSDQ100/USD," 150,57 ",0.136637," 0,59 "," 4.543,66 "," 2.495,80 ",2947684060,CFD," 0,00 "
20/02/2025 16:38:35,Open Position,NSDQ100/USD," 150,00 ",0.136648," 0,00 "," 4.543,66 "," 2.345,80 ",2947687481,CFD," 0,00 "
20/02/2025 16:42:05,Position closed,NSDQ100/USD," 151,12 ",0.136648," 1,12 "," 4.544,78 "," 2.496,92 ",2947687481,CFD," 0,00 "
20/02/2025 16:42:30,Open Position,NSDQ100/USD," 150,00 ",0.136572," 0,00 "," 4.544,78 "," 2.346,92 ",2947746661,CFD," 0,00 "
20/02/2025 16:44:39,Position closed,NSDQ100/USD," 151,41 ",0.136572," 1,41 "," 4.546,19 "," 2.498,33 ",2947746661,CFD," 0,00 "
20/02/2025 16:44:47,Open Position,NSDQ100/USD," 199,99 ",0.18199," 0,00 "," 4.546,19 "," 2.298,34 ",2947829156,CFD," 0,00 "
20/02/2025 19:26:18,Position closed,NSDQ100/USD," 206,78 ",0.18199," 6,79 "," 4.552,98 "," 2.505,12 ",2947829156,CFD," 0,00 "
20/02/2025 19:26:40,Open Position,NSDQ100/USD," 99,99 ",0.090849," 0,00 "," 4.552,98 "," 2.405,13 ",2948212327,CFD," 0,00 "
20/02/2025 20:23:18,Position closed,NSDQ100/USD," 202,60 ",0.181603," 2,61 "," 4.555,59 "," 2.607,73 ",2947548405,CFD," 0,00 "
20/02/2025 20:23:27,Open Position,NSDQ100/USD," 249,99 ",0.226826," 0,00 "," 4.555,59 "," 2.357,74 ",2948259473,CFD," 0,00 "
20/02/2025 20:53:10,Position closed,NSDQ100/USD," 250,48 ",0.226826," 0,49 "," 4.556,08 "," 2.608,22 ",2948259473,CFD," 0,00 "
20/02/2025 20:54:23,Open Position,NSDQ100/USD," 209,99 ",0.190485," 0,00 "," 4.556,08 "," 2.398,23 ",2948292442,CFD," 0,00 "
20/02/2025 20:57:48,Position closed,NSDQ100/USD," 212,70 ",0.190485," 2,71 "," 4.558,79 "," 2.610,93 ",2948292442,CFD," 0,00 "
20/02/2025 20:57:58,Open Position,NSDQ100/USD," 259,98 ",0.235666," 0,00 "," 4.558,79 "," 2.350,95 ",2948297158,CFD," 0,00 "
20/02/2025 23:11:05,Position closed,NSDQ100/USD," 264,05 ",0.235666," 4,07 "," 4.562,86 "," 2.615,00 ",2948297158,CFD," 0,00 "
20/02/2025 23:11:23,Open Position,NSDQ100/USD," 200,00 ",0.181088," 0,00 "," 4.562,86 "," 2.415,00 ",2948310289,CFD," 0,00 "
21/02/2025 00:14:09,Index price adjustment,NSDQ100/USD,"(0,08)",-,"(0,08)"," 4.562,78 "," 2.414,92 ",2940436584,CFD," 0,00 "
21/02/2025 00:14:09,Index price adjustment,NSDQ100/USD,"(0,07)",-,"(0,07)"," 4.562,71 "," 2.414,85 ",2941769321,CFD," 0,00 "
21/02/2025 00:14:09,Index price adjustment,NSDQ100/USD,"(0,15)",-,"(0,15)"," 4.562,56 "," 2.414,70 ",2941867797,CFD," 0,00 "
21/02/2025 00:14:09,Index price adjustment,NSDQ100/USD," 0,15 ",-," 0,15 "," 4.562,71 "," 2.414,85 ",2943492705,CFD," 0,00 "
21/02/2025 00:14:09,Index price adjustment,NSDQ100/USD," 0,15 ",-," 0,15 "," 4.562,86 "," 2.415,00 ",2943498460,CFD," 0,00 "
21/02/2025 00:14:09,Index price adjustment,NSDQ100/USD," 0,07 ",-," 0,07 "," 4.562,93 "," 2.415,07 ",2943499098,CFD," 0,00 "
21/02/2025 00:14:09,Index price adjustment,NSDQ100/USD," 0,07 ",-," 0,07 "," 4.563,00 "," 2.415,14 ",2946687040,CFD," 0,00 "
21/02/2025 00:14:09,Index price adjustment,NSDQ100/USD," 0,11 ",-," 0,11 "," 4.563,11 "," 2.415,25 ",2946949156,CFD," 0,00 "
21/02/2025 00:14:09,Index price adjustment,NSDQ100/USD," 0,13 ",-," 0,13 "," 4.563,24 "," 2.415,38 ",2947212018,CFD," 0,00 "
21/02/2025 00:14:09,Index price adjustment,NSDQ100/USD,"(0,07)",-,"(0,07)"," 4.563,17 "," 2.415,31 ",2948212327,CFD," 0,00 "
21/02/2025 00:14:09,Index price adjustment,NSDQ100/USD," 0,19 ",-," 0,19 "," 4.563,36 "," 2.415,50 ",2948297158,CFD," 0,00 "
21/02/2025 00:47:58,Overnight fee,Daily,"(0,03)",-,"(0,03)"," 4.563,33 "," 2.415,47 ",2948212327,CFD," 0,00 "
21/02/2025 00:47:58,Overnight fee,Daily,"(0,03)",-,"(0,03)"," 4.563,30 "," 2.415,44 ",2941769321,CFD," 0,00 "
21/02/2025 00:47:58,Overnight fee,Daily,"(0,03)",-,"(0,03)"," 4.563,27 "," 2.415,41 ",2940436584,CFD," 0,00 "
21/02/2025 00:47:58,Overnight fee,Daily,"(0,07)",-,"(0,07)"," 4.563,20 "," 2.415,34 ",2941867797,CFD," 0,00 "
21/02/2025 00:47:58,Overnight fee,Daily,"(0,48)",-,"(0,48)"," 4.562,72 "," 2.414,86 ",2943499098,CFD," 0,00 "
21/02/2025 00:47:58,Overnight fee,Daily,"(0,48)",-,"(0,48)"," 4.562,24 "," 2.414,38 ",2946687040,CFD," 0,00 "
21/02/2025 00:47:58,Overnight fee,Daily,"(0,72)",-,"(0,72)"," 4.561,52 "," 2.413,66 ",2946949156,CFD," 0,00 "
21/02/2025 00:47:58,Overnight fee,Daily,"(0,85)",-,"(0,85)"," 4.560,67 "," 2.412,81 ",2947212018,CFD," 0,00 "
21/02/2025 00:47:58,Overnight fee,Daily,"(0,96)",-,"(0,96)"," 4.559,71 "," 2.411,85 ",2943498460,CFD," 0,00 "
21/02/2025 00:47:58,Overnight fee,Daily,"(0,96)",-,"(0,96)"," 4.558,75 "," 2.410,89 ",2943492705,CFD," 0,00 "
21/02/2025 00:47:58,Overnight fee,Daily,"(1,26)",-,"(1,26)"," 4.557,49 "," 2.409,63 ",2948297158,CFD," 0,00 "
21/02/2025 08:17:58,Open Position,NSDQ100/USD," 100,00 ",0.090673," 0,00 "," 4.557,49 "," 2.309,63 ",2948394651,CFD," 0,00 "
21/02/2025 08:18:10,Open Position,NSDQ100/USD," 99,99 ",0.09066," 0,00 "," 4.557,49 "," 2.209,64 ",2948394702,CFD," 0,00 "
21/02/2025 08:36:58,Position closed,NSDQ100/USD," 100,99 ",0.09066," 1,00 "," 4.558,49 "," 2.310,63 ",2948394702,CFD," 0,00 "
21/02/2025 08:37:09,Open Position,NSDQ100/USD," 150,00 ",0.135905," 0,00 "," 4.558,49 "," 2.160,63 ",2948420499,CFD," 0,00 "
21/02/2025 10:46:01,Position closed,NSDQ100/USD," 152,52 ",0.135905," 2,52 "," 4.561,01 "," 2.313,15 ",2948420499,CFD," 0,00 "
21/02/2025 10:46:13,Open Position,NSDQ100/USD," 99,99 ",0.090512," 0,00 "," 4.561,01 "," 2.213,16 ",2948451452,CFD," 0,00 "
21/02/2025 12:38:23,Position closed,NSDQ100/USD," 208,18 ",0.181088," 8,18 "," 4.569,19 "," 2.421,34 ",2948310289,CFD," 0,00 "
21/02/2025 12:38:46,Position closed,NSDQ100/USD," 103,46 ",0.090512," 3,47 "," 4.572,66 "," 2.524,80 ",2948451452,CFD," 0,00 "
21/02/2025 12:39:20,Position closed,NSDQ100/USD," 176,13 ",0.158179," 1,13 "," 4.573,79 "," 2.700,93 ",2947212018,CFD," 0,00 "
21/02/2025 12:39:54,Open Position,NSDQ100/USD," 149,99 ",0.135493," 0,00 "," 4.573,79 "," 2.550,94 ",2948475662,CFD," 0,00 "
21/02/2025 12:47:02,Position closed,NSDQ100/USD," 151,60 ",0.135523," 1,60 "," 4.575,39 "," 2.702,54 ",2946949156,CFD," 0,00 "
21/02/2025 12:47:09,Position closed,NSDQ100/USD," 151,15 ",0.135493," 1,16 "," 4.576,55 "," 2.853,69 ",2948475662,CFD," 0,00 "
21/02/2025 12:47:32,Open Position,NSDQ100/USD," 307,75 ",0.180575," 0,00 "," 4.576,55 "," 2.653,70 ",2948477088,CFD," 0,00 "
21/02/2025 12:47:51,Open Position,NSDQ100/USD," 250,00 ",0.225758," 0,00 "," 4.576,55 "," 2.403,70 ",2948477164,CFD," 0,00 "
21/02/2025 12:59:10,Position closed,NSDQ100/USD," 99,87 ",0.090298,"(0,11)"," 4.576,44 "," 2.503,57 ",2946687040,CFD," 0,00 "
21/02/2025 14:54:54,Position closed,NSDQ100/USD," 274,11 ",0.225758," 24,11 "," 4.600,55 "," 2.777,68 ",2948477164,CFD," 0,00 "
21/02/2025 14:56:16,Position closed,NSDQ100/USD," 101,84 ",0.090673," 1,84 "," 4.602,39 "," 2.879,52 ",2948394651,CFD," 0,00 "
21/02/2025 14:56:33,Open Position,NSDQ100/USD," 288,39 ",0.181504," 0,00 "," 4.602,39 "," 2.679,52 ",2948761327,CFD," 0,00 "
21/02/2025 14:56:42,Open Position,NSDQ100/USD," 100,00 ",0.090774," 0,00 "," 4.602,39 "," 2.579,52 ",2948761570,CFD," 0,00 "
21/02/2025 15:18:12,Position closed,NSDQ100/USD," 101,72 ",0.090774," 1,72 "," 4.604,11 "," 2.681,24 ",2948761570,CFD," 0,00 "
21/02/2025 15:18:35,Open Position,NSDQ100/USD," 424,06 ",0.272656," 0,00 "," 4.604,11 "," 2.381,24 ",2948821653,CFD," 0,00 "
21/02/2025 15:18:49,Open Position,NSDQ100/USD," 149,99 ",0.136333," 0,00 "," 4.604,11 "," 2.231,25 ",2948821922,CFD," 0,00 "
21/02/2025 15:18:54,Position closed,NSDQ100/USD," 100,47 ",0.090849," 0,48 "," 4.604,59 "," 2.331,72 ",2948212327,CFD," 0,00 "
21/02/2025 15:29:41,Position closed,NSDQ100/USD," 159,34 ",0.136333," 9,35 "," 4.613,94 "," 2.491,06 ",2948821922,CFD," 0,00 "
21/02/2025 15:30:20,Open Position,NSDQ100/USD," 199,98 ",0.182386," 0,00 "," 4.613,94 "," 2.291,08 ",2948843590,CFD," 0,00 "
21/02/2025 15:30:36,Open Position,NSDQ100/USD," 99,99 ",0.091195," 0,00 "," 4.613,94 "," 2.191,09 ",2948844277,CFD," 0,00 "
21/02/2025 15:42:33,Position closed,NSDQ100/USD," 100,20 ",0.091195," 0,21 "," 4.614,15 "," 2.291,29 ",2948844277,CFD," 0,00 "
21/02/2025 15:43:03,Position closed,NSDQ100/USD," 94,15 ",0.091474,"(5,85)"," 4.608,30 "," 2.385,44 ",2941769321,CFD," 0,00 "
21/02/2025 15:43:19,Open Position,NSDQ100/USD," 199,99 ",0.182467," 0,00 "," 4.608,30 "," 2.185,45 ",2948867245,CFD," 0,00 "
21/02/2025 15:43:27,Open Position,NSDQ100/USD," 49,99 ",0.04562," 0,00 "," 4.608,30 "," 2.135,46 ",2948867332,CFD," 0,00 "
21/02/2025 16:25:29,Position closed,NSDQ100/USD," 204,88 ",0.182467," 4,89 "," 4.613,19 "," 2.340,34 ",2948867245,CFD," 0,00 "
21/02/2025 16:25:36,Position closed,NSDQ100/USD," 48,45 ",0.04562,"(1,54)"," 4.611,65 "," 2.388,79 ",2948867332,CFD," 0,00 "
21/02/2025 16:25:43,Position closed,NSDQ100/USD," 202,31 ",0.182386," 2,33 "," 4.613,98 "," 2.591,10 ",2948843590,CFD," 0,00 "
21/02/2025 16:25:59,Open Position,NSDQ100/USD," 340,65 ",0.227819," 0,00 "," 4.613,98 "," 2.341,12 ",2948943861,CFD," 0,00 "
21/02/2025 16:46:25,Open Position,NSDQ100/USD," 149,97 ",0.136908," 0,00 "," 4.613,98 "," 2.191,15 ",2948963887,CFD," 0,00 "
21/02/2025 17:19:39,Position closed,NSDQ100/USD," 202,93 ",0.182971," 2,95 "," 4.616,93 "," 2.394,08 ",2941867797,CFD," 0,00 "
21/02/2025 17:20:18,Position closed,NSDQ100/USD," 160,69 ",0.136908," 10,72 "," 4.627,65 "," 2.554,77 ",2948963887,CFD," 0,00 "
21/02/2025 17:21:17,Open Position,NSDQ100/USD," 149,97 ",0.137438," 0,00 "," 4.627,65 "," 2.404,80 ",2949024353,CFD," 0,00 "
21/02/2025 17:21:26,Open Position,NSDQ100/USD," 200,00 ",0.183177," 0,00 "," 4.627,65 "," 2.204,80 ",2949024553,CFD," 0,00 "
21/02/2025 17:22:39,Open Position,NSDQ100/USD," 99,98 ",0.091551," 0,00 "," 4.627,65 "," 2.104,82 ",2949025616,CFD," 0,00 "
21/02/2025 17:23:35,Position closed,NSDQ100/USD," 203,10 ",0.183177," 3,10 "," 4.630,75 "," 2.307,92 ",2949024553,CFD," 0,00 "
21/02/2025 17:23:41,Position closed,NSDQ100/USD," 100,46 ",0.091551," 0,48 "," 4.631,23 "," 2.408,38 ",2949025616,CFD," 0,00 "
21/02/2025 17:23:53,Open Position,NSDQ100/USD," 300,00 ",0.274561," 0,00 "," 4.631,23 "," 2.108,38 ",2949026617,CFD," 0,00 "
21/02/2025 17:27:21,Position closed,NSDQ100/USD," 300,11 ",0.274561," 0,11 "," 4.631,34 "," 2.408,49 ",2949026617,CFD," 0,00 "
21/02/2025 17:28:10,Open Position,NSDQ100/USD," 386,18 ",0.274454," 0,00 "," 4.631,34 "," 2.108,49 ",2949031361,CFD," 0,00 "
21/02/2025 17:33:44,Open Position,NSDQ100/USD," 250,00 ",0.228907," 0,00 "," 4.631,34 "," 1.858,49 ",2949037594,CFD," 0,00 "
21/02/2025 17:34:06,Edit Stop Loss,-,"(49,30)",-," 0,00 "," 4.631,34 "," 1.809,19 ",2943492705,-," 0,00 "
21/02/2025 17:34:16,Edit Stop Loss,-,"(48,94)",-," 0,00 "," 4.631,34 "," 1.760,25 ",2943498460,-," 0,00 "
21/02/2025 17:34:31,Edit Stop Loss,-,"(35,57)",-," 0,00 "," 4.631,34 "," 1.724,68 ",2948477088,-," 0,00 "
21/02/2025 17:34:39,Edit Stop Loss,-,"(15,79)",-," 0,00 "," 4.631,34 "," 1.708,89 ",2948761327,-," 0,00 "
21/02/2025 17:34:49,Edit Stop Loss,-,"(15,00)",-," 0,00 "," 4.631,34 "," 1.693,89 ",2948821653,-," 0,00 "
21/02/2025 17:41:04,Position closed,NSDQ100/USD," 256,48 ",0.228907," 6,48 "," 4.637,82 "," 1.950,37 ",2949037594,CFD," 0,00 "
21/02/2025 17:41:19,Position closed,NSDQ100/USD," 151,72 ",0.137438," 1,75 "," 4.639,57 "," 2.102,09 ",2949024353,CFD," 0,00 "
21/02/2025 17:41:33,Open Position,NSDQ100/USD," 199,98 ",0.183399," 0,00 "," 4.639,57 "," 1.902,11 ",2949047938,CFD," 0,00 "
21/02/2025 17:43:15,Open Position,NSDQ100/USD," 125,18 ",0.091646," 0,00 "," 4.639,57 "," 1.802,13 ",2949049790,CFD," 0,00 "
21/02/2025 17:58:36,Position closed,NSDQ100/USD," 204,30 ",0.183399," 4,32 "," 4.643,89 "," 2.006,43 ",2949047938,CFD," 0,00 "
21/02/2025 17:59:08,Open Position,NSDQ100/USD," 149,99 ",0.137733," 0,00 "," 4.643,89 "," 1.856,44 ",2949069179,CFD," 0,00 "
21/02/2025 18:04:03,Position closed,NSDQ100/USD," 153,21 ",0.137733," 3,22 "," 4.647,11 "," 2.009,65 ",2949069179,CFD," 0,00 "
21/02/2025 18:04:35,Open Position,NSDQ100/USD," 259,97 ",0.239014," 0,00 "," 4.647,11 "," 1.749,68 ",2949076379,CFD," 0,00 "
21/02/2025 18:07:49,Position closed,NSDQ100/USD," 260,10 ",0.239014," 0,13 "," 4.647,24 "," 2.009,78 ",2949076379,CFD," 0,00 "
21/02/2025 18:08:01,Open Position,NSDQ100/USD," 250,00 ",0.229828," 0,00 "," 4.647,24 "," 1.759,78 ",2949083152,CFD," 0,00 "
21/02/2025 18:13:54,Position closed,NSDQ100/USD," 256,05 ",0.229828," 6,05 "," 4.653,29 "," 2.015,83 ",2949083152,CFD," 0,00 "
21/02/2025 18:14:13,Open Position,NSDQ100/USD," 199,98 ",0.184084," 0,00 "," 4.653,29 "," 1.815,85 ",2949097956,CFD," 0,00 "
21/02/2025 18:15:09,Open Position,NSDQ100/USD," 100,00 ",0.091953," 0,00 "," 4.653,29 "," 1.715,85 ",2949100546,CFD," 0,00 "
21/02/2025 18:19:16,Position closed,NSDQ100/USD," 100,53 ",0.091953," 0,53 "," 4.653,82 "," 1.816,38 ",2949100546,CFD," 0,00 "
21/02/2025 18:20:31,Position closed,NSDQ100/USD," 50,31 ",0.046464,"(11,15)"," 4.642,67 "," 1.866,69 ",2949108840,CFD," 0,00 "
21/02/2025 18:20:55,Open Position,NSDQ100/USD," 100,00 ",0.09196," 0,00 "," 4.642,67 "," 1.766,69 ",2949109151,CFD," 0,00 "
21/02/2025 18:28:47,Position closed,NSDQ100/USD," 100,75 ",0.09196," 0,75 "," 4.643,42 "," 1.867,44 ",2949109151,CFD," 0,00 "
21/02/2025 18:30:05,Open Position,NSDQ100/USD," 149,99 ",0.138076," 0,00 "," 4.643,42 "," 1.717,45 ",2949134371,CFD," 0,00 "
21/02/2025 18:50:48,Position closed,NSDQ100/USD," 201,72 ",0.184084," 1,74 "," 4.645,16 "," 1.919,17 ",2949097956,CFD," 0,00 "
21/02/2025 18:52:17,Position closed,NSDQ100/USD," 151,03 ",0.138076," 1,04 "," 4.646,20 "," 2.070,20 ",2949134371,CFD," 0,00 "
21/02/2025 18:52:32,Open Position,NSDQ100/USD," 149,98 ",0.138157," 0,00 "," 4.646,20 "," 1.920,22 ",2949181632,CFD," 0,00 "
21/02/2025 18:52:39,Open Position,NSDQ100/USD," 150,00 ",0.138142," 0,00 "," 4.646,20 "," 1.770,22 ",2949181721,CFD," 0,00 "
21/02/2025 18:59:05,Position closed,NSDQ100/USD," 151,53 ",0.138157," 1,55 "," 4.647,75 "," 1.921,75 ",2949181632,CFD," 0,00 "
21/02/2025 18:59:42,Open Position,NSDQ100/USD," 199,98 ",0.184343," 0,00 "," 4.647,75 "," 1.721,77 ",2949189796,CFD," 0,00 "
21/02/2025 19:05:31,Position closed,NSDQ100/USD," 201,05 ",0.184343," 1,07 "," 4.648,82 "," 1.922,82 ",2949189796,CFD," 0,00 "
21/02/2025 19:05:42,Open Position,NSDQ100/USD," 350,00 ",0.322786," 0,00 "," 4.648,82 "," 1.572,82 ",2949206464,CFD," 0,00 "
21/02/2025 19:19:24,Position closed,NSDQ100/USD," 49,86 ",0.089968,"(50,13)"," 4.598,69 "," 1.622,68 ",2943499098,CFD," 0,00 "
21/02/2025 19:20:02,Position closed,NSDQ100/USD," 356,16 ",0.322786," 6,16 "," 4.604,85 "," 1.978,84 ",2949206464,CFD," 0,00 "
21/02/2025 19:20:35,Open Position,NSDQ100/USD," 250,00 ",0.230774," 0,00 "," 4.604,85 "," 1.728,84 ",2949228723,CFD," 0,00 "
21/02/2025 19:21:43,Position closed,NSDQ100/USD," 252,18 ",0.230774," 2,18 "," 4.607,03 "," 1.981,02 ",2949228723,CFD," 0,00 "
21/02/2025 19:22:00,Open Position,NSDQ100/USD," 299,95 ",0.277099," 0,00 "," 4.607,03 "," 1.681,07 ",2949231017,CFD," 0,00 "
21/02/2025 19:22:14,Open Position,NSDQ100/USD," 200,00 ",0.184742," 0,00 "," 4.607,03 "," 1.481,07 ",2949231250,CFD," 0,00 "
21/02/2025 19:26:33,Position closed,NSDQ100/USD," 302,85 ",0.277099," 2,90 "," 4.609,93 "," 1.783,92 ",2949231017,CFD," 0,00 "
21/02/2025 19:26:49,Open Position,NSDQ100/USD," 299,97 ",0.277319," 0,00 "," 4.609,93 "," 1.483,95 ",2949237029,CFD," 0,00 "
21/02/2025 19:27:04,Position closed,NSDQ100/USD," 299,58 ",0.277319,"(0,39)"," 4.609,54 "," 1.783,53 ",2949237029,CFD," 0,00 "
21/02/2025 19:27:13,Open Position,NSDQ100/USD," 349,99 ",0.323584," 0,00 "," 4.609,54 "," 1.433,54 ",2949237531,CFD," 0,00 "
21/02/2025 19:41:05,Position closed,NSDQ100/USD," 355,77 ",0.323584," 5,78 "," 4.615,32 "," 1.789,31 ",2949237531,CFD," 0,00 "
21/02/2025 19:41:29,Open Position,NSDQ100/USD," 100,13 ",0.370185," 0,00 "," 4.615,32 "," 1.389,32 ",2949256473,CFD," 0,00 "
21/02/2025 19:44:15,Edit Stop Loss,-,"(6,87)",-," 0,00 "," 4.615,32 "," 1.382,45 ",2949049790,-," 0,00 "
21/02/2025 20:10:01,Edit Stop Loss,-,"(17,99)",-," 0,00 "," 4.615,32 "," 1.364,46 ",2943492705,-," 0,00 "
21/02/2025 20:10:15,Edit Stop Loss,-,"(18,00)",-," 0,00 "," 4.615,32 "," 1.346,46 ",2943498460,-," 0,00 "
21/02/2025 20:10:20,Edit Stop Loss,-,"(18,06)",-," 0,00 "," 4.615,32 "," 1.328,40 ",2948477088,-," 0,00 "
21/02/2025 20:10:32,Edit Stop Loss,-,"(18,15)",-," 0,00 "," 4.615,32 "," 1.310,25 ",2948761327,-," 0,00 "
21/02/2025 20:10:44,Edit Stop Loss,-,"(27,26)",-," 0,00 "," 4.615,32 "," 1.282,99 ",2948821653,-," 0,00 "
21/02/2025 20:10:49,Edit Stop Loss,-,"(22,32)",-," 0,00 "," 4.615,32 "," 1.260,67 ",2948943861,-," 0,00 "
21/02/2025 20:11:04,Edit Stop Loss,-,"(3,84)",-," 0,00 "," 4.615,32 "," 1.256,83 ",2949031361,-," 0,00 "
21/02/2025 20:37:18,Position closed,NSDQ100/USD," 197,21 ",0.184797,"(2,47)"," 4.612,85 "," 1.454,04 ",2949348511,CFD," 0,00 "
22/02/2025 00:06:41,Index price adjustment,NSDQ100/USD,"(0,05)",-,"(0,05)"," 4.612,80 "," 1.453,99 ",2940436584,CFD," 0,00 "
22/02/2025 00:06:41,Index price adjustment,NSDQ100/USD," 0,21 ",-," 0,21 "," 4.613,01 "," 1.454,20 ",2943492705,CFD," 0,00 "
22/02/2025 00:06:41,Index price adjustment,NSDQ100/USD," 0,21 ",-," 0,21 "," 4.613,22 "," 1.454,41 ",2943498460,CFD," 0,00 "
22/02/2025 00:06:41,Index price adjustment,NSDQ100/USD," 0,21 ",-," 0,21 "," 4.613,43 "," 1.454,62 ",2948477088,CFD," 0,00 "
22/02/2025 00:06:41,Index price adjustment,NSDQ100/USD," 0,21 ",-," 0,21 "," 4.613,64 "," 1.454,83 ",2948761327,CFD," 0,00 "
22/02/2025 00:06:41,Index price adjustment,NSDQ100/USD," 0,32 ",-," 0,32 "," 4.613,96 "," 1.455,15 ",2948821653,CFD," 0,00 "
22/02/2025 00:06:41,Index price adjustment,NSDQ100/USD," 0,27 ",-," 0,27 "," 4.614,23 "," 1.455,42 ",2948943861,CFD," 0,00 "
22/02/2025 00:06:41,Index price adjustment,NSDQ100/USD," 0,32 ",-," 0,32 "," 4.614,55 "," 1.455,74 ",2949031361,CFD," 0,00 "
22/02/2025 00:06:41,Index price adjustment,NSDQ100/USD," 0,11 ",-," 0,11 "," 4.614,66 "," 1.455,85 ",2949049790,CFD," 0,00 "
22/02/2025 00:06:41,Index price adjustment,NSDQ100/USD," 0,16 ",-," 0,16 "," 4.614,82 "," 1.456,01 ",2949181721,CFD," 0,00 "
22/02/2025 00:06:41,Index price adjustment,NSDQ100/USD," 0,22 ",-," 0,22 "," 4.615,04 "," 1.456,23 ",2949231250,CFD," 0,00 "
22/02/2025 00:06:41,Index price adjustment,NSDQ100/USD,"(0,22)",-,"(0,22)"," 4.614,82 "," 1.456,01 ",2949256473,CFD," 0,00 "
22/02/2025 00:47:55,Overnight fee,Weekend Fee,"(0,05)",-,"(0,05)"," 4.614,77 "," 1.455,96 ",2940436584,CFD," 0,00 "
22/02/2025 00:47:55,Overnight fee,Weekend Fee,"(0,20)",-,"(0,20)"," 4.614,57 "," 1.455,76 ",2949256473,CFD," 0,00 "
22/02/2025 00:47:55,Overnight fee,Weekend Fee,"(1,47)",-,"(1,47)"," 4.613,10 "," 1.454,29 ",2949049790,CFD," 0,00 "
22/02/2025 00:47:55,Overnight fee,Weekend Fee,"(2,22)",-,"(2,22)"," 4.610,88 "," 1.452,07 ",2949181721,CFD," 0,00 "
22/02/2025 00:47:55,Overnight fee,Weekend Fee,"(2,89)",-,"(2,89)"," 4.607,99 "," 1.449,18 ",2943498460,CFD," 0,00 "
22/02/2025 00:47:55,Overnight fee,Weekend Fee,"(2,89)",-,"(2,89)"," 4.605,10 "," 1.446,29 ",2943492705,CFD," 0,00 "
22/02/2025 00:47:55,Overnight fee,Weekend Fee,"(2,90)",-,"(2,90)"," 4.602,20 "," 1.443,39 ",2948477088,CFD," 0,00 "
22/02/2025 00:47:55,Overnight fee,Weekend Fee,"(2,91)",-,"(2,91)"," 4.599,29 "," 1.440,48 ",2948761327,CFD," 0,00 "
22/02/2025 00:47:55,Overnight fee,Weekend Fee,"(2,96)",-,"(2,96)"," 4.596,33 "," 1.437,52 ",2949231250,CFD," 0,00 "
22/02/2025 00:47:55,Overnight fee,Weekend Fee,"(3,65)",-,"(3,65)"," 4.592,68 "," 1.433,87 ",2948943861,CFD," 0,00 "
22/02/2025 00:47:55,Overnight fee,Weekend Fee,"(4,37)",-,"(4,37)"," 4.588,31 "," 1.429,50 ",2948821653,CFD," 0,00 "
22/02/2025 00:47:55,Overnight fee,Weekend Fee,"(4,40)",-,"(4,40)"," 4.583,91 "," 1.425,10 ",2949031361,CFD," 0,00 "
24/02/2025 02:53:49,Position closed,NSDQ100/USD," 210,65 ",0.184742," 10,65 "," 4.594,56 "," 1.635,75 ",2949231250,CFD," 0,00 "
24/02/2025 02:54:00,Position closed,NSDQ100/USD," 90,63 ",0.092717,"(9,55)"," 4.585,01 "," 1.726,38 ",2950027451,CFD," 0,00 "
24/02/2025 07:40:50,Open Position,NSDQ100/USD," 150,00 ",0.138299," 0,00 "," 4.585,01 "," 1.576,38 ",2950055050,CFD," 0,00 "
24/02/2025 09:05:07,Position closed,NSDQ100/USD," 154,73 ",0.138299," 4,73 "," 4.589,74 "," 1.731,11 ",2950055050,CFD," 0,00 "
24/02/2025 09:05:36,Position closed,NSDQ100/USD," 150,80 ",0.138142," 0,80 "," 4.590,54 "," 1.881,91 ",2949181721,CFD," 0,00 "
24/02/2025 09:07:12,Open Position,NSDQ100/USD," 177,59 ",0.137974," 0,00 "," 4.590,54 "," 1.731,91 ",2950151876,CFD," 0,00 "
24/02/2025 09:44:52,Open Position,NSDQ100/USD," 100,00 ",0.092079," 0,00 "," 4.590,54 "," 1.631,91 ",2950161673,CFD," 0,00 "
24/02/2025 10:00:27,Position closed,NSDQ100/USD," 100,04 ",0.092079," 0,04 "," 4.590,58 "," 1.731,95 ",2950161673,CFD," 0,00 "
24/02/2025 10:08:17,Open Position,USD/JPY," 99,99 ",3000," 0,00 "," 4.590,58 "," 1.631,96 ",2950167769,CFD," 0,00 "
24/02/2025 11:31:37,Open Position,AAPL.EXT/USD," 99,99 ",2.056646," 0,00 "," 4.590,58 "," 1.531,97 ",2950189417,CFD," 0,00 "
24/02/2025 11:32:06,Open Position,NSDQ100/USD," 100,00 ",0.092094," 0,00 "," 4.590,58 "," 1.431,97 ",2950189499,CFD," 0,00 "
24/02/2025 12:12:51,Open Position,NSDQ100/USD," 149,99 ",0.138388," 0,00 "," 4.590,58 "," 1.281,98 ",2950198779,CFD," 0,00 "
24/02/2025 12:46:49,Position closed,NSDQ100/USD," 150,96 ",0.138388," 0,97 "," 4.591,55 "," 1.432,94 ",2950198779,CFD," 0,00 "
24/02/2025 12:48:00,Open Position,AAPL.EXT/USD," 99,99 ",2.046111," 0,00 "," 4.591,55 "," 1.332,95 ",2950206566,CFD," 0,00 "
24/02/2025 12:48:20,Open Position,NSDQ100/USD," 250,00 ",0.230618," 0,00 "," 4.591,55 "," 1.082,95 ",2950206615,CFD," 0,00 "
24/02/2025 13:46:12,Position closed,NSDQ100/USD," 259,07 ",0.230618," 9,07 "," 4.600,62 "," 1.342,02 ",2950206615,CFD," 0,00 "
24/02/2025 13:46:41,Position closed,NSDQ100/USD," 100,34 ",0.092094," 0,34 "," 4.600,96 "," 1.442,36 ",2950189499,CFD," 0,00 "
24/02/2025 13:47:22,Position closed,NSDQ100/USD," 51,96 ",0.04649,"(9,53)"," 4.591,43 "," 1.494,32 ",2940436584,CFD," 0,00 "
24/02/2025 13:47:41,Open Position,NSDQ100/USD," 116,28 ",0.092068," 0,00 "," 4.591,43 "," 1.394,34 ",2950219907,CFD," 0,00 "
24/02/2025 14:31:39,Open Position,NSDQ100/USD," 200,00 ",0.184509," 0,00 "," 4.591,43 "," 1.194,34 ",2950326181,CFD," 0,00 "
24/02/2025 14:31:45,Position closed,AAPL.EXT/USD," 104,84 ",2.056646," 4,85 "," 4.596,28 "," 1.299,18 ",2950189417,CFD," 0,00 "
24/02/2025 14:31:46,Position closed,AAPL.EXT/USD," 102,07 ",2.046111," 2,08 "," 4.598,36 "," 1.401,25 ",2950206566,CFD," 0,00 "
24/02/2025 14:32:34,Position closed,NSDQ100/USD," 204,42 ",0.184509," 4,42 "," 4.602,78 "," 1.605,67 ",2950326181,CFD," 0,00 "
24/02/2025 14:32:41,Open Position,NSDQ100/USD," 291,02 ",0.230189," 0,00 "," 4.602,78 "," 1.355,67 ",2950388087,CFD," 0,00 "
24/02/2025 14:34:11,Open Position,AAPL.EXT/USD," 99,99 ",2.022159," 0,00 "," 4.602,78 "," 1.255,68 ",2950400078,CFD," 0,00 "
24/02/2025 14:34:49,Open Position,NSDQ100/USD," 337,34 ",0.276779," 0,00 "," 4.602,78 "," 955,70 ",2950403246,CFD," 0,00 "
24/02/2025 14:45:49,Position closed,USD/JPY," 102,02 ",3000," 2,03 "," 4.604,81 "," 1.057,72 ",2950167769,CFD," 0,00 "
24/02/2025 14:46:14,Open Position,USD/JPY," 200,00 ",6000," 0,00 "," 4.604,81 "," 857,72 ",2950445647,CFD," 0,00 "
24/02/2025 14:47:19,Open Position,NSDQ100/USD," 109,87 ",0.092382," 0,00 "," 4.604,81 "," 757,73 ",2950447900,CFD," 0,00 "
24/02/2025 15:00:19,Position closed,NSDQ100/USD," 110,21 ",0.092671," 10,08 "," 4.614,89 "," 867,94 ",2949256473,CFD," 0,00 "
24/02/2025 15:01:00,Position closed,USD/JPY," 205,38 ",6000," 5,38 "," 4.620,27 "," 1.073,32 ",2950445647,CFD," 0,00 "
24/02/2025 15:02:35,Position closed,AAPL.EXT/USD," 100,31 ",2.022159," 0,32 "," 4.620,59 "," 1.173,63 ",2950400078,CFD," 0,00 "
24/02/2025 15:03:16,Edit Stop Loss,-,"(27,45)",-," 0,00 "," 4.620,59 "," 1.146,18 ",2949031361,-," 0,00 "
24/02/2025 15:03:26,Edit Stop Loss,-,"(22,79)",-," 0,00 "," 4.620,59 "," 1.123,39 ",2948943861,-," 0,00 "
24/02/2025 15:03:35,Edit Stop Loss,-,"(27,27)",-," 0,00 "," 4.620,59 "," 1.096,12 ",2948821653,-," 0,00 "
24/02/2025 15:03:45,Edit Stop Loss,-,"(18,15)",-," 0,00 "," 4.620,59 "," 1.077,97 ",2948761327,-," 0,00 "
24/02/2025 15:03:56,Edit Stop Loss,-,"(18,01)",-," 0,00 "," 4.620,59 "," 1.059,96 ",2948477088,-," 0,00 "
24/02/2025 15:04:05,Edit Stop Loss,-,"(17,99)",-," 0,00 "," 4.620,59 "," 1.041,97 ",2943498460,-," 0,00 "
24/02/2025 15:04:14,Edit Stop Loss,-,"(17,99)",-," 0,00 "," 4.620,59 "," 1.023,98 ",2943492705,-," 0,00 "
24/02/2025 15:05:05,Open Position,NSDQ100/USD," 249,98 ",0.233305," 0,00 "," 4.620,59 "," 774,00 ",2950634945,CFD," 0,00 "
24/02/2025 15:08:11,Open Position,NSDQ100/USD," 199,99 ",0.187017," 0,00 "," 4.620,59 "," 574,01 ",2950648428,CFD," 0,00 "
24/02/2025 15:08:42,Open Position,NSDQ100/USD," 99,99 ",0.093407," 0,00 "," 4.620,59 "," 474,02 ",2950650971,CFD," 0,00 "
24/02/2025 15:08:50,Position closed,NSDQ100/USD," 101,16 ",0.093407," 1,17 "," 4.621,76 "," 575,18 ",2950650971,CFD," 0,00 "
24/02/2025 15:09:06,Position closed,NSDQ100/USD," 250,26 ",0.233305," 0,28 "," 4.622,04 "," 825,44 ",2950634945,CFD," 0,00 "
24/02/2025 15:09:15,Open Position,NSDQ100/USD," 149,98 ",0.139886," 0,00 "," 4.622,04 "," 675,46 ",2950653257,CFD," 0,00 "
24/02/2025 15:11:03,Position closed,NSDQ100/USD," 153,19 ",0.139886," 3,21 "," 4.625,25 "," 828,65 ",2950653257,CFD," 0,00 "
24/02/2025 15:11:16,Open Position,NSDQ100/USD," 149,99 ",0.1397," 0,00 "," 4.625,25 "," 678,66 ",2950664926,CFD," 0,00 "
24/02/2025 15:15:04,Position closed,NSDQ100/USD," 153,49 ",0.1397," 3,50 "," 4.628,75 "," 832,15 ",2950664926,CFD," 0,00 "
24/02/2025 15:15:21,Open Position,NSDQ100/USD," 99,99 ",0.093035," 0,00 "," 4.628,75 "," 732,16 ",2950681751,CFD," 0,00 "
24/02/2025 15:15:41,Open Position,NSDQ100/USD," 100,00 ",0.092995," 0,00 "," 4.628,75 "," 632,16 ",2950683366,CFD," 0,00 "
24/02/2025 15:15:48,Position closed,NSDQ100/USD," 100,73 ",0.093035," 0,74 "," 4.629,49 "," 732,89 ",2950681751,CFD," 0,00 "
24/02/2025 15:15:58,Open Position,NSDQ100/USD," 149,99 ",0.139494," 0,00 "," 4.629,49 "," 582,90 ",2950684340,CFD," 0,00 "
24/02/2025 15:23:33,Position closed,NSDQ100/USD," 101,37 ",0.092995," 1,37 "," 4.630,86 "," 684,27 ",2950683366,CFD," 0,00 "
24/02/2025 15:23:44,Open Position,NSDQ100/USD," 199,97 ",0.18619," 0,00 "," 4.630,86 "," 484,30 ",2950717625,CFD," 0,00 "
24/02/2025 15:23:58,Position closed,NSDQ100/USD," 201,25 ",0.18619," 1,28 "," 4.632,14 "," 685,55 ",2950717625,CFD," 0,00 "
24/02/2025 15:24:09,Open Position,NSDQ100/USD," 99,99 ",0.093121," 0,00 "," 4.632,14 "," 585,56 ",2950718230,CFD," 0,00 "
24/02/2025 15:27:35,Position closed,NSDQ100/USD," 102,48 ",0.093121," 2,49 "," 4.634,63 "," 688,04 ",2950718230,CFD," 0,00 "
24/02/2025 15:27:46,Open Position,NSDQ100/USD," 199,99 ",0.18652," 0,00 "," 4.634,63 "," 488,05 ",2950727273,CFD," 0,00 "
24/02/2025 15:28:24,Open Position,NSDQ100/USD," 99,99 ",0.093256," 0,00 "," 4.634,63 "," 388,06 ",2950731448,CFD," 0,00 "
24/02/2025 15:39:54,Position closed,NSDQ100/USD," 201,40 ",0.18652," 1,41 "," 4.636,04 "," 589,46 ",2950727273,CFD," 0,00 "
24/02/2025 15:40:02,Open Position,NSDQ100/USD," 199,99 ",0.186612," 0,00 "," 4.636,04 "," 389,47 ",2950766819,CFD," 0,00 "
24/02/2025 15:44:24,Position closed,NSDQ100/USD," 202,90 ",0.186612," 2,91 "," 4.638,95 "," 592,37 ",2950766819,CFD," 0,00 "
24/02/2025 15:44:35,Open Position,NSDQ100/USD," 150,00 ",0.140092," 0,00 "," 4.638,95 "," 442,37 ",2950790080,CFD," 0,00 "
24/02/2025 15:59:08,Position closed,NSDQ100/USD," 150,46 ",0.140092," 0,46 "," 4.639,41 "," 592,83 ",2950790080,CFD," 0,00 "
24/02/2025 15:59:25,Open Position,NSDQ100/USD," 199,99 ",0.186733," 0,00 "," 4.639,41 "," 392,84 ",2950839898,CFD," 0,00 "
24/02/2025 16:13:44,Position closed,NSDQ100/USD," 101,52 ",0.093256," 1,53 "," 4.640,94 "," 494,36 ",2950731448,CFD," 0,00 "
24/02/2025 16:29:31,Position closed,NSDQ100/USD," 152,22 ",0.139494," 2,23 "," 4.643,17 "," 646,58 ",2950684340,CFD," 0,00 "
24/02/2025 16:30:03,Open Position,NSDQ100/USD," 100,00 ",0.092883," 0,00 "," 4.643,17 "," 546,58 ",2950893993,CFD," 0,00 "
24/02/2025 16:30:12,Open Position,NSDQ100/USD," 99,99 ",0.092863," 0,00 "," 4.643,17 "," 446,59 ",2950894141,CFD," 0,00 "
24/02/2025 16:46:05,Position closed,NSDQ100/USD," 101,47 ",0.092863," 1,48 "," 4.644,65 "," 548,06 ",2950894141,CFD," 0,00 "
24/02/2025 16:46:12,Open Position,NSDQ100/USD," 99,99 ",0.092773," 0,00 "," 4.644,65 "," 448,07 ",2950916170,CFD," 0,00 "
24/02/2025 17:20:21,Position closed,NSDQ100/USD," 101,95 ",0.092773," 1,96 "," 4.646,61 "," 550,02 ",2950916170,CFD," 0,00 "
24/02/2025 17:20:45,Open Position,NSDQ100/USD," 104,21 ",0.092654," 0,00 "," 4.646,61 "," 450,03 ",2950959449,CFD," 0,00 "
24/02/2025 20:03:42,Position closed,NSDQ100/USD," 105,36 ",0.092883," 5,36 "," 4.651,97 "," 555,39 ",2950893993,CFD," 0,00 "
24/02/2025 20:04:39,Open Position,NSDQ100/USD," 149,99 ",0.139655," 0,00 "," 4.651,97 "," 405,40 ",2951105622,CFD," 0,00 "
24/02/2025 20:44:07,Open Position,USD/JPY," 99,99 ",3000," 0,00 "," 4.651,97 "," 305,41 ",2951131824,CFD," 0,00 "
24/02/2025 21:11:51,Position closed,NSDQ100/USD," 210,10 ",0.186733," 10,11 "," 4.662,08 "," 515,51 ",2950839898,CFD," 0,00 "
24/02/2025 21:11:59,Position closed,NSDQ100/USD," 203,98 ",0.187017," 3,99 "," 4.666,07 "," 719,49 ",2950648428,CFD," 0,00 "
24/02/2025 21:13:55,Open Position,NSDQ100/USD," 150,00 ",0.140329," 0,00 "," 4.666,07 "," 569,49 ",2951153447,CFD," 0,00 "
24/02/2025 21:16:04,Open Position,NSDQ100/USD," 149,99 ",0.140394," 0,00 "," 4.666,07 "," 419,50 ",2951153748,CFD," 0,00 "
24/02/2025 21:16:18,Open Position,NSDQ100/USD," 149,99 ",0.140388," 0,00 "," 4.666,07 "," 269,51 ",2951153784,CFD," 0,00 "
24/02/2025 21:39:55,Position closed,NSDQ100/USD," 151,29 ",0.140394," 1,30 "," 4.667,37 "," 420,80 ",2951153748,CFD," 0,00 "
24/02/2025 21:40:00,Position closed,NSDQ100/USD," 151,38 ",0.140388," 1,39 "," 4.668,76 "," 572,18 ",2951153784,CFD," 0,00 "
24/02/2025 21:40:10,Open Position,NSDQ100/USD," 199,98 ",0.187288," 0,00 "," 4.668,76 "," 372,20 ",2951156271,CFD," 0,00 "
24/02/2025 21:53:34,Edit Stop Loss,-,"(18,00)",-," 0,00 "," 4.668,76 "," 354,20 ",2943492705,-," 0,00 "
24/02/2025 21:53:47,Edit Stop Loss,-,"(18,11)",-," 0,00 "," 4.668,76 "," 336,09 ",2943498460,-," 0,00 "
24/02/2025 21:53:55,Edit Stop Loss,-,"(18,06)",-," 0,00 "," 4.668,76 "," 318,03 ",2948477088,-," 0,00 "
24/02/2025 21:54:04,Edit Stop Loss,-,"(18,15)",-," 0,00 "," 4.668,76 "," 299,88 ",2948761327,-," 0,00 "
24/02/2025 21:54:13,Edit Stop Loss,-,"(27,26)",-," 0,00 "," 4.668,76 "," 272,62 ",2948821653,-," 0,00 "
24/02/2025 21:54:22,Edit Stop Loss,-,"(22,78)",-," 0,00 "," 4.668,76 "," 249,84 ",2948943861,-," 0,00 "
24/02/2025 21:54:32,Edit Stop Loss,-,"(27,44)",-," 0,00 "," 4.668,76 "," 222,40 ",2949031361,-," 0,00 "
24/02/2025 21:54:39,Edit Stop Loss,-,"(9,17)",-," 0,00 "," 4.668,76 "," 213,23 ",2949049790,-," 0,00 "
24/02/2025 21:54:47,Edit Stop Loss,-,"(13,80)",-," 0,00 "," 4.668,76 "," 199,43 ",2950151876,-," 0,00 "
24/02/2025 21:54:54,Edit Stop Loss,-,"(7,09)",-," 0,00 "," 4.668,76 "," 192,34 ",2950219907,-," 0,00 "
24/02/2025 21:55:02,Edit Stop Loss,-,"(18,00)",-," 0,00 "," 4.668,76 "," 174,34 ",2950388087,-," 0,00 "
24/02/2025 23:17:13,Overnight fee,Daily,"(1,19)",-,"(1,19)"," 4.667,57 "," 173,15 ",2948943861,CFD," 0,00 "
24/02/2025 23:17:13,Overnight fee,Daily,"(1,21)",-,"(1,21)"," 4.666,36 "," 171,94 ",2950388087,CFD," 0,00 "
24/02/2025 23:17:13,Overnight fee,Daily,"(1,43)",-,"(1,43)"," 4.664,93 "," 170,51 ",2948821653,CFD," 0,00 "
24/02/2025 23:17:13,Overnight fee,Daily,"(1,44)",-,"(1,44)"," 4.663,49 "," 169,07 ",2949031361,CFD," 0,00 "
24/02/2025 23:17:13,Overnight fee,Daily,"(1,45)",-,"(1,45)"," 4.662,04 "," 167,62 ",2950403246,CFD," 0,00 "
24/02/2025 23:17:13,Overnight fee,Daily,"(0,48)",-,"(0,48)"," 4.661,56 "," 167,14 ",2950219907,CFD," 0,00 "
24/02/2025 23:17:13,Overnight fee,Daily,"(0,49)",-,"(0,49)"," 4.661,07 "," 166,65 ",2950959449,CFD," 0,00 "
24/02/2025 23:17:13,Overnight fee,Daily,"(0,72)",-,"(0,72)"," 4.660,35 "," 165,93 ",2950151876,CFD," 0,00 "
24/02/2025 23:17:13,Overnight fee,Daily,"(0,73)",-,"(0,73)"," 4.659,62 "," 165,20 ",2951153447,CFD," 0,00 "
24/02/2025 23:17:13,Overnight fee,Daily,"(0,73)",-,"(0,73)"," 4.658,89 "," 164,47 ",2951105622,CFD," 0,00 "
24/02/2025 23:17:13,Overnight fee,Daily,"(0,94)",-,"(0,94)"," 4.657,95 "," 163,53 ",2943498460,CFD," 0,00 "
24/02/2025 23:17:13,Overnight fee,Daily,"(0,94)",-,"(0,94)"," 4.657,01 "," 162,59 ",2943492705,CFD," 0,00 "
24/02/2025 23:17:13,Overnight fee,Daily,"(0,95)",-,"(0,95)"," 4.656,06 "," 161,64 ",2948761327,CFD," 0,00 "
24/02/2025 23:17:13,Overnight fee,Daily,"(0,95)",-,"(0,95)"," 4.655,11 "," 160,69 ",2948477088,CFD," 0,00 "
24/02/2025 23:17:13,Overnight fee,Daily,"(0,06)",-,"(0,06)"," 4.655,05 "," 160,63 ",2951156271,CFD," 0,00 "
24/02/2025 23:17:13,Overnight fee,Daily,"(0,46)",-,"(0,46)"," 4.654,59 "," 160,17 ",2951131824,CFD," 0,00 "
24/02/2025 23:17:13,Overnight fee,Daily,"(0,48)",-,"(0,48)"," 4.654,11 "," 159,69 ",2949049790,CFD," 0,00 "
24/02/2025 23:17:13,Overnight fee,Daily,"(0,48)",-,"(0,48)"," 4.653,63 "," 159,21 ",2950447900,CFD," 0,00 "
24/02/2025 23:36:52,Position closed,NSDQ100/USD," 201,68 ",0.187288," 1,70 "," 4.655,33 "," 360,89 ",2951156271,CFD," 0,00 "
24/02/2025 23:37:09,Edit Stop Loss,-,"(9,69)",-," 0,00 "," 4.655,33 "," 351,20 ",2950403246,-," 0,00 "
24/02/2025 23:37:22,Open Position,NSDQ100/USD," 149,99 ",0.140559," 0,00 "," 4.655,33 "," 201,21 ",2951180606,CFD," 0,00 "
24/02/2025 23:55:22,Position closed,NSDQ100/USD," 154,57 ",0.140559," 4,58 "," 4.659,91 "," 355,78 ",2951180606,CFD," 0,00 "
24/02/2025 23:55:41,Open Position,NSDQ100/USD," 100,00 ",0.093877," 0,00 "," 4.659,91 "," 255,78 ",2951183297,CFD," 0,00 "
25/02/2025 00:13:17,Index price adjustment,NSDQ100/USD," 0,02 ",-," 0,02 "," 4.659,93 "," 255,80 ",2943492705,CFD," 0,00 "
25/02/2025 00:13:17,Index price adjustment,NSDQ100/USD," 0,02 ",-," 0,02 "," 4.659,95 "," 255,82 ",2943498460,CFD," 0,00 "
25/02/2025 00:13:17,Index price adjustment,NSDQ100/USD," 0,02 ",-," 0,02 "," 4.659,97 "," 255,84 ",2948477088,CFD," 0,00 "
25/02/2025 00:13:17,Index price adjustment,NSDQ100/USD," 0,02 ",-," 0,02 "," 4.659,99 "," 255,86 ",2948761327,CFD," 0,00 "
25/02/2025 00:13:17,Index price adjustment,NSDQ100/USD," 0,03 ",-," 0,03 "," 4.660,02 "," 255,89 ",2948821653,CFD," 0,00 "
25/02/2025 00:13:17,Index price adjustment,NSDQ100/USD," 0,03 ",-," 0,03 "," 4.660,05 "," 255,92 ",2948943861,CFD," 0,00 "
25/02/2025 00:13:17,Index price adjustment,NSDQ100/USD," 0,03 ",-," 0,03 "," 4.660,08 "," 255,95 ",2949031361,CFD," 0,00 "
25/02/2025 00:13:17,Index price adjustment,NSDQ100/USD," 0,01 ",-," 0,01 "," 4.660,09 "," 255,96 ",2949049790,CFD," 0,00 "
25/02/2025 00:13:17,Index price adjustment,NSDQ100/USD," 0,02 ",-," 0,02 "," 4.660,11 "," 255,98 ",2950151876,CFD," 0,00 "
25/02/2025 00:13:17,Index price adjustment,NSDQ100/USD," 0,01 ",-," 0,01 "," 4.660,12 "," 255,99 ",2950219907,CFD," 0,00 "
25/02/2025 00:13:17,Index price adjustment,NSDQ100/USD," 0,03 ",-," 0,03 "," 4.660,15 "," 256,02 ",2950388087,CFD," 0,00 "
25/02/2025 00:13:17,Index price adjustment,NSDQ100/USD," 0,03 ",-," 0,03 "," 4.660,18 "," 256,05 ",2950403246,CFD," 0,00 "
25/02/2025 00:13:17,Index price adjustment,NSDQ100/USD," 0,01 ",-," 0,01 "," 4.660,19 "," 256,06 ",2950447900,CFD," 0,00 "
25/02/2025 00:13:17,Index price adjustment,NSDQ100/USD,"(0,02)",-,"(0,02)"," 4.660,17 "," 256,04 ",2950648428,CFD," 0,00 "
25/02/2025 00:13:17,Index price adjustment,NSDQ100/USD,"(0,02)",-,"(0,02)"," 4.660,15 "," 256,02 ",2950839898,CFD," 0,00 "
25/02/2025 00:13:17,Index price adjustment,NSDQ100/USD," 0,01 ",-," 0,01 "," 4.660,16 "," 256,03 ",2950959449,CFD," 0,00 "
25/02/2025 00:13:17,Index price adjustment,NSDQ100/USD," 0,02 ",-," 0,02 "," 4.660,18 "," 256,05 ",2951105622,CFD," 0,00 "
25/02/2025 00:37:51,Edit Stop Loss,-,"(17,99)",-," 0,00 "," 4.660,18 "," 238,06 ",2943492705,-," 0,00 "
25/02/2025 00:38:01,Edit Stop Loss,-,"(18,00)",-," 0,00 "," 4.660,18 "," 220,06 ",2943498460,-," 0,00 "
25/02/2025 00:38:09,Edit Stop Loss,-,"(18,06)",-," 0,00 "," 4.660,18 "," 202,00 ",2948477088,-," 0,00 "
25/02/2025 00:38:18,Edit Stop Loss,-,"(18,15)",-," 0,00 "," 4.660,18 "," 183,85 ",2948761327,-," 0,00 "
25/02/2025 00:38:28,Edit Stop Loss,-,"(27,27)",-," 0,00 "," 4.660,18 "," 156,58 ",2948821653,-," 0,00 "
25/02/2025 00:38:40,Edit Stop Loss,-,"(22,78)",-," 0,00 "," 4.660,18 "," 133,80 ",2948943861,-," 0,00 "
25/02/2025 00:38:50,Edit Stop Loss,-,"(9,16)",-," 0,00 "," 4.660,18 "," 124,64 ",2949049790,-," 0,00 "
25/02/2025 00:38:58,Edit Stop Loss,-,"(13,79)",-," 0,00 "," 4.660,18 "," 110,85 ",2950151876,-," 0,00 "
25/02/2025 00:39:09,Edit Stop Loss,-,"(23,02)",-," 0,00 "," 4.660,18 "," 87,83 ",2950388087,-," 0,00 "
25/02/2025 07:34:36,Position closed,NSDQ100/USD," 101,03 ",0.093877," 1,03 "," 4.661,21 "," 188,86 ",2951183297,CFD," 0,00 "
25/02/2025 07:36:27,Position closed,USD/JPY," 107,02 ",3000," 7,03 "," 4.668,24 "," 295,88 ",2951131824,CFD," 0,00 "
25/02/2025 07:39:25,Open Position,NSDQ100/USD," 149,99 ",0.140851," 0,00 "," 4.668,24 "," 145,89 ",2951261581,CFD," 0,00 "
25/02/2025 08:00:59,Position closed,NSDQ100/USD," 156,55 ",0.140851," 6,56 "," 4.674,80 "," 302,44 ",2951261581,CFD," 0,00 "
25/02/2025 08:01:12,Open Position,NSDQ100/USD," 250,00 ",0.235321," 0,00 "," 4.674,80 "," 52,44 ",2951288622,CFD," 0,00 "
25/02/2025 10:59:39,Position closed,NSDQ100/USD," 254,66 ",0.235321," 4,66 "," 4.679,46 "," 307,10 ",2951288622,CFD," 0,00 "
25/02/2025 11:04:25,Edit Stop Loss,-,"(4,22)",-," 0,00 "," 4.679,46 "," 302,88 ",2950959449,-," 0,00 "
25/02/2025 11:04:35,Edit Stop Loss,-,"(9,88)",-," 0,00 "," 4.679,46 "," 293,00 ",2950447900,-," 0,00 "
25/02/2025 11:04:43,Edit Stop Loss,-,"(27,67)",-," 0,00 "," 4.679,46 "," 265,33 ",2950403246,-," 0,00 "
25/02/2025 11:04:54,Edit Stop Loss,-,"(9,21)",-," 0,00 "," 4.679,46 "," 256,12 ",2950219907,-," 0,00 "
25/02/2025 11:05:03,Edit Stop Loss,-,"(27,45)",-," 0,00 "," 4.679,46 "," 228,67 ",2949031361,-," 0,00 "
25/02/2025 11:05:36,Open Position,NSDQ100/USD," 179,99 ",0.169442," 0,00 "," 4.679,46 "," 48,68 ",2951409744,CFD," 0,00 "
25/02/2025 13:03:27,Position closed,NSDQ100/USD," 147,98 ",0.140329,"(2,02)"," 4.677,44 "," 196,66 ",2951153447,CFD," 0,00 "
25/02/2025 13:03:38,Open Position,NSDQ100/USD," 100,00 ",0.093611," 0,00 "," 4.677,44 "," 96,66 ",2951460194,CFD," 0,00 "
25/02/2025 14:37:07,Position closed,NSDQ100/USD," 104,61 ",0.093611," 4,61 "," 4.682,05 "," 201,27 ",2951460194,CFD," 0,00 "
25/02/2025 14:37:25,Open Position,NSDQ100/USD," 149,98 ",0.140873," 0,00 "," 4.682,05 "," 51,29 ",2951583856,CFD," 0,00 "
25/02/2025 14:48:12,Position closed,NSDQ100/USD," 159,38 ",0.140873," 9,40 "," 4.691,45 "," 210,67 ",2951583856,CFD," 0,00 "
25/02/2025 14:48:18,Position closed,NSDQ100/USD," 181,08 ",0.169442," 1,09 "," 4.692,54 "," 391,75 ",2951409744,CFD," 0,00 "
25/02/2025 14:48:30,Open Position,NSDQ100/USD," 299,97 ",0.282625," 0,00 "," 4.692,54 "," 91,78 ",2951615989,CFD," 0,00 "
25/02/2025 15:10:24,Position closed,NSDQ100/USD," 325,39 ",0.282625," 25,42 "," 4.717,96 "," 417,17 ",2951615989,CFD," 0,00 "
25/02/2025 15:10:38,Open Position,NSDQ100/USD," 349,99 ",0.331229," 0,00 "," 4.717,96 "," 67,18 ",2951883684,CFD," 0,00 "
25/02/2025 15:20:13,Position closed,NSDQ100/USD," 147,98 ",0.272656,"(276,08)"," 4.441,88 "," 215,16 ",2948821653,CFD," 0,00 "
25/02/2025 15:20:13,Position closed,NSDQ100/USD," 123,28 ",0.230189,"(167,74)"," 4.274,14 "," 338,44 ",2950388087,CFD," 0,00 "
25/02/2025 15:20:13,Position closed,NSDQ100/USD," 98,86 ",0.179929,"(222,39)"," 4.051,75 "," 437,30 ",2943492705,CFD," 0,00 "
25/02/2025 15:20:13,Position closed,NSDQ100/USD," 147,69 ",0.276779,"(189,65)"," 3.862,10 "," 584,99 ",2950403246,CFD," 0,00 "
25/02/2025 15:20:13,Position closed,NSDQ100/USD," 73,70 ",0.137974,"(103,89)"," 3.758,21 "," 658,69 ",2950151876,CFD," 0,00 "
25/02/2025 15:20:14,Position closed,NSDQ100/USD," 49,08 ",0.092068,"(67,20)"," 3.691,01 "," 707,77 ",2950219907,CFD," 0,00 "
25/02/2025 15:20:14,Position closed,NSDQ100/USD," 49,03 ",0.092382,"(60,84)"," 3.630,17 "," 756,80 ",2950447900,CFD," 0,00 "
25/02/2025 15:20:14,Position closed,NSDQ100/USD," 98,50 ",0.181504,"(189,89)"," 3.440,28 "," 855,30 ",2948761327,CFD," 0,00 "
25/02/2025 15:20:14,Position closed,NSDQ100/USD," 98,50 ",0.180575,"(209,25)"," 3.231,03 "," 953,80 ",2948477088,CFD," 0,00 "
25/02/2025 15:20:14,Position closed,NSDQ100/USD," 98,46 ",0.17995,"(222,57)"," 3.008,46 "," 1.052,26 ",2943498460,CFD," 0,00 "
25/02/2025 15:20:14,Position closed,NSDQ100/USD," 123,00 ",0.227819,"(217,65)"," 2.790,81 "," 1.175,26 ",2948943861,CFD," 0,00 "
25/02/2025 15:20:15,Position closed,NSDQ100/USD," 49,35 ",0.091646,"(75,83)"," 2.714,98 "," 1.224,61 ",2949049790,CFD," 0,00 "
25/02/2025 15:20:15,Position closed,NSDQ100/USD," 147,74 ",0.274454,"(238,44)"," 2.476,54 "," 1.372,35 ",2949031361,CFD," 0,00 "
25/02/2025 15:20:15,Position closed,NSDQ100/USD," 49,28 ",0.092654,"(54,93)"," 2.421,61 "," 1.421,63 ",2950959449,CFD," 0,00 "
25/02/2025 15:24:26,Position closed,NSDQ100/USD," 394,67 ",0.331229," 44,68 "," 2.466,29 "," 1.816,30 ",2951883684,CFD," 0,00 "
25/02/2025 15:24:50,Open Position,NSDQ100/USD," 150,00 ",0.142875," 0,00 "," 2.466,29 "," 1.666,30 ",2951941632,CFD," 0,00 "
25/02/2025 15:25:00,Open Position,NSDQ100/USD," 74,35 ",0.14289," 0,00 "," 2.466,29 "," 1.516,32 ",2951942238,CFD," 0,00 "
25/02/2025 15:27:35,Position closed,NSDQ100/USD," 150,31 ",0.142875," 0,31 "," 2.466,60 "," 1.666,63 ",2951941632,CFD," 0,00 "
25/02/2025 15:30:11,Open Position,NSDQ100/USD," 99,99 ",0.095239," 0,00 "," 2.466,60 "," 1.566,64 ",2951967098,CFD," 0,00 "
25/02/2025 15:37:06,Position closed,NSDQ100/USD," 104,10 ",0.095239," 4,11 "," 2.470,71 "," 1.670,74 ",2951967098,CFD," 0,00 "
25/02/2025 15:37:16,Open Position,NSDQ100/USD," 199,98 ",0.190054," 0,00 "," 2.470,71 "," 1.470,76 ",2951989330,CFD," 0,00 "
25/02/2025 15:38:42,Position closed,NSDQ100/USD," 201,92 ",0.190054," 1,94 "," 2.472,65 "," 1.672,68 ",2951989330,CFD," 0,00 "
25/02/2025 15:38:56,Open Position,NSDQ100/USD," 300,00 ",0.285042," 0,00 "," 2.472,65 "," 1.372,68 ",2951999852,CFD," 0,00 "
25/02/2025 16:31:44,Position closed,NSDQ100/USD," 75,19 ",0.139655,"(74,80)"," 2.397,85 "," 1.447,87 ",2951105622,CFD," 0,00 "
25/02/2025 16:53:56,Position closed,NSDQ100/USD," 302,17 ",0.285042," 2,17 "," 2.400,02 "," 1.750,04 ",2951999852,CFD," 0,00 "
25/02/2025 16:54:10,Open Position,NSDQ100/USD," 199,98 ",0.189865," 0,00 "," 2.400,02 "," 1.550,06 ",2952175657,CFD," 0,00 "
25/02/2025 17:07:45,Position closed,NSDQ100/USD," 205,01 ",0.189865," 5,03 "," 2.405,05 "," 1.755,07 ",2952175657,CFD," 0,00 "
25/02/2025 17:07:57,Open Position,NSDQ100/USD," 349,98 ",0.331749," 0,00 "," 2.405,05 "," 1.405,09 ",2952198650,CFD," 0,00 "
25/02/2025 17:30:20,Position closed,NSDQ100/USD," 357,67 ",0.331749," 7,69 "," 2.412,74 "," 1.762,76 ",2952198650,CFD," 0,00 "
25/02/2025 17:32:34,Open Position,NSDQ100/USD," 199,99 ",0.189338," 0,00 "," 2.412,74 "," 1.562,77 ",2952229804,CFD," 0,00 "
25/02/2025 17:46:01,Position closed,NSDQ100/USD," 200,72 ",0.189338," 0,73 "," 2.413,47 "," 1.763,49 ",2952229804,CFD," 0,00 "
25/02/2025 17:46:37,Open Position,NSDQ100/USD," 299,99 ",0.283903," 0,00 "," 2.413,47 "," 1.463,50 ",2952244528,CFD," 0,00 "
25/02/2025 18:14:16,Position closed,NSDQ100/USD," 309,45 ",0.283903," 9,46 "," 2.422,93 "," 1.772,95 ",2952244528,CFD," 0,00 "
25/02/2025 18:15:10,Open Position,NSDQ100/USD," 300,00 ",0.283534," 0,00 "," 2.422,93 "," 1.472,95 ",2952274821,CFD," 0,00 "
25/02/2025 18:31:40,Open Position,NSDQ100/USD," 199,99 ",0.189414," 0,00 "," 2.422,93 "," 1.272,96 ",2952288695,CFD," 0,00 "
25/02/2025 18:32:02,Position closed,NSDQ100/USD," 201,99 ",0.189414," 2,00 "," 2.424,93 "," 1.474,95 ",2952288695,CFD," 0,00 "
25/02/2025 18:32:12,Open Position,NSDQ100/USD," 199,98 ",0.189311," 0,00 "," 2.424,93 "," 1.274,97 ",2952289293,CFD," 0,00 "
25/02/2025 19:56:35,Position closed,NSDQ100/USD," 203,83 ",0.189311," 3,85 "," 2.428,78 "," 1.478,80 ",2952289293,CFD," 0,00 "
25/02/2025 19:56:46,Open Position,NSDQ100/USD," 149,99 ",0.141831," 0,00 "," 2.428,78 "," 1.328,81 ",2952358285,CFD," 0,00 "
25/02/2025 20:24:04,Position closed,NSDQ100/USD," 306,37 ",0.283534," 6,37 "," 2.435,15 "," 1.635,18 ",2952274821,CFD," 0,00 "
25/02/2025 20:24:16,Position closed,NSDQ100/USD," 155,69 ",0.141831," 5,70 "," 2.440,85 "," 1.790,87 ",2952358285,CFD," 0,00 "
25/02/2025 20:24:33,Open Position,NSDQ100/USD," 299,99 ",0.283115," 0,00 "," 2.440,85 "," 1.490,88 ",2952387257,CFD," 0,00 "
25/02/2025 20:56:31,Open Position,NSDQ100/USD," 150,00 ",0.142354," 0,00 "," 2.440,85 "," 1.340,88 ",2952423201,CFD," 0,00 "
25/02/2025 21:03:07,Position closed,NSDQ100/USD," 154,79 ",0.142354," 4,79 "," 2.445,64 "," 1.495,67 ",2952423201,CFD," 0,00 "
25/02/2025 21:03:19,Open Position,NSDQ100/USD," 249,98 ",0.236852," 0,00 "," 2.445,64 "," 1.245,69 ",2952429459,CFD," 0,00 "
25/02/2025 21:07:39,Position closed,NSDQ100/USD," 253,54 ",0.236852," 3,56 "," 2.449,20 "," 1.499,23 ",2952429459,CFD," 0,00 "
25/02/2025 21:07:54,Open Position,NSDQ100/USD," 259,99 ",0.246129," 0,00 "," 2.449,20 "," 1.239,24 ",2952430401,CFD," 0,00 "
25/02/2025 21:13:03,Position closed,NSDQ100/USD," 260,37 ",0.246129," 0,38 "," 2.449,58 "," 1.499,61 ",2952430401,CFD," 0,00 "
25/02/2025 21:15:46,Open Position,NSDQ100/USD," 249,99 ",0.236683," 0,00 "," 2.449,58 "," 1.249,62 ",2952431742,CFD," 0,00 "
25/02/2025 23:01:42,Position closed,NSDQ100/USD," 260,50 ",0.236683," 10,51 "," 2.460,09 "," 1.510,12 ",2952431742,CFD," 0,00 "
25/02/2025 23:01:48,Open Position,NSDQ100/USD," 200,00 ",0.188931," 0,00 "," 2.460,09 "," 1.310,12 ",2952442430,CFD," 0,00 "
25/02/2025 23:17:02,Overnight fee,Daily,"(0,05)",-,"(0,05)"," 2.460,04 "," 1.310,07 ",2951942238,CFD," 0,00 "
25/02/2025 23:17:02,Overnight fee,Daily,"(1,24)",-,"(1,24)"," 2.458,80 "," 1.308,83 ",2952431742,CFD," 0,00 "
25/02/2025 23:17:02,Overnight fee,Daily,"(1,48)",-,"(1,48)"," 2.457,32 "," 1.307,35 ",2952387257,CFD," 0,00 "
26/02/2025 00:11:19,Index price adjustment,NSDQ100/USD,"(0,01)",-,"(0,01)"," 2.457,31 "," 1.307,34 ",2951942238,CFD," 0,00 "
26/02/2025 00:11:19,Index price adjustment,NSDQ100/USD," 0,02 ",-," 0,02 "," 2.457,33 "," 1.307,36 ",2952387257,CFD," 0,00 "
26/02/2025 00:11:19,Index price adjustment,NSDQ100/USD," 0,01 ",-," 0,01 "," 2.457,34 "," 1.307,37 ",2952423201,CFD," 0,00 "
26/02/2025 07:15:01,Position closed,NSDQ100/USD," 208,45 ",0.188931," 8,45 "," 2.465,79 "," 1.515,82 ",2952442430,CFD," 0,00 "
26/02/2025 07:15:47,Position closed,NSDQ100/USD," 306,52 ",0.283115," 6,53 "," 2.472,32 "," 1.822,34 ",2952387257,CFD," 0,00 "
26/02/2025 07:16:40,Open Position,NSDQ100/USD," 299,99 ",0.282766," 0,00 "," 2.472,32 "," 1.522,35 ",2952486987,CFD," 0,00 "
26/02/2025 07:17:02,Position closed,NSDQ100/USD," 58,90 ",0.072059,"(16,73)"," 2.455,59 "," 1.581,25 ",2952487056,CFD," 0,00 "
26/02/2025 07:17:20,Position closed,NSDQ100/USD," 301,21 ",0.282766," 1,22 "," 2.456,81 "," 1.882,46 ",2952486987,CFD," 0,00 "
26/02/2025 07:17:31,Open Position,NSDQ100/USD," 300,00 ",0.282652," 0,00 "," 2.456,81 "," 1.582,46 ",2952487097,CFD," 0,00 "
26/02/2025 09:18:05,Position closed,NSDQ100/USD," 309,19 ",0.282652," 9,19 "," 2.466,00 "," 1.891,65 ",2952487097,CFD," 0,00 "
26/02/2025 09:18:19,Open Position,NSDQ100/USD," 300,00 ",0.282159," 0,00 "," 2.466,00 "," 1.591,65 ",2952572794,CFD," 0,00 "
26/02/2025 11:06:30,Open Position,NSDQ100/USD," 150,00 ",0.141097," 0,00 "," 2.466,00 "," 1.441,65 ",2952634877,CFD," 0,00 "
26/02/2025 15:37:39,Position closed,NSDQ100/USD," 305,39 ",0.282159," 5,39 "," 2.471,39 "," 1.747,04 ",2952572794,CFD," 0,00 "
26/02/2025 15:37:47,Position closed,NSDQ100/USD," 152,93 ",0.141097," 2,93 "," 2.474,32 "," 1.899,97 ",2952634877,CFD," 0,00 "
26/02/2025 15:38:25,Open Position,NSDQ100/USD," 349,99 ",0.328849," 0,00 "," 2.474,32 "," 1.549,98 ",2953044462,CFD," 0,00 "
26/02/2025 16:35:02,Position closed,NSDQ100/USD," 357,48 ",0.328849," 7,49 "," 2.481,81 "," 1.907,46 ",2953044462,CFD," 0,00 "
26/02/2025 16:35:13,Open Position,NSDQ100/USD," 349,98 ",0.328341," 0,00 "," 2.481,81 "," 1.557,48 ",2953128416,CFD," 0,00 "
26/02/2025 16:44:33,Open Position,NVDA.EXT/USD," 150,00 ",5.651045," 0,00 "," 2.481,81 "," 1.407,48 ",2953137052,CFD," 0,00 "
26/02/2025 17:15:41,Position closed,NSDQ100/USD," 352,37 ",0.328341," 2,39 "," 2.484,20 "," 1.759,85 ",2953128416,CFD," 0,00 "
26/02/2025 17:15:54,Open Position,NSDQ100/USD," 413,06 ",0.23441," 0,00 "," 2.484,20 "," 1.509,87 ",2953185617,CFD," 0,00 "
26/02/2025 18:35:15,Open Position,NSDQ100/USD," 199,98 ",0.189304," 0,00 "," 2.484,20 "," 1.309,89 ",2953258471,CFD," 0,00 "
26/02/2025 21:04:46,Position closed,NSDQ100/USD," 202,28 ",0.189304," 2,30 "," 2.486,50 "," 1.512,17 ",2953258471,CFD," 0,00 "
26/02/2025 21:04:58,Open Position,NSDQ100/USD," 249,98 ",0.236425," 0,00 "," 2.486,50 "," 1.262,19 ",2953428362,CFD," 0,00 "
26/02/2025 23:02:31,Position closed,NSDQ100/USD," 258,09 ",0.236425," 8,11 "," 2.494,61 "," 1.520,28 ",2953428362,CFD," 0,00 "
26/02/2025 23:02:49,Open Position,NSDQ100/USD," 307,99 ",0.290804," 0,00 "," 2.494,61 "," 1.212,29 ",2953447734,CFD," 0,00 "
26/02/2025 23:17:17,Overnight fee,Daily,"(0,02)",-,"(0,02)"," 2.494,59 "," 1.212,27 ",2951942238,CFD," 0,00 "
26/02/2025 23:17:17,Overnight fee,Daily,"(0,21)",-,"(0,21)"," 2.494,38 "," 1.212,06 ",2953137052,CFD," 0,00 "
26/02/2025 23:17:17,Overnight fee,Daily,"(1,23)",-,"(1,23)"," 2.493,15 "," 1.210,83 ",2953185617,CFD," 0,00 "
26/02/2025 23:17:17,Overnight fee,Daily,"(1,24)",-,"(1,24)"," 2.491,91 "," 1.209,59 ",2953428362,CFD," 0,00 "
26/02/2025 23:46:50,Open Position,NSDQ100/USD," 50,00 ",0.047276," 0,00 "," 2.491,91 "," 1.159,59 ",2953451678,CFD," 0,00 "
27/02/2025 00:44:26,Index price adjustment,NSDQ100/USD,"(0,02)",-,"(0,02)"," 2.491,89 "," 1.159,57 ",2951942238,CFD," 0,00 "
27/02/2025 00:44:26,Index price adjustment,NSDQ100/USD," 0,05 ",-," 0,05 "," 2.491,94 "," 1.159,62 ",2953185617,CFD," 0,00 "
27/02/2025 00:44:26,Index price adjustment,NSDQ100/USD," 0,04 ",-," 0,04 "," 2.491,98 "," 1.159,66 ",2953258471,CFD," 0,00 "
27/02/2025 05:47:56,Position closed,NSDQ100/USD," 312,38 ",0.290804," 4,39 "," 2.496,37 "," 1.472,04 ",2953447734,CFD," 0,00 "
27/02/2025 05:48:06,Position closed,NSDQ100/USD," 52,15 ",0.047276," 2,15 "," 2.498,52 "," 1.524,19 ",2953451678,CFD," 0,00 "
27/02/2025 05:48:27,Open Position,NSDQ100/USD," 300,00 ",0.283012," 0,00 "," 2.498,52 "," 1.224,19 ",2953489564,CFD," 0,00 "
27/02/2025 08:32:02,Position closed,NSDQ100/USD," 307,01 ",0.283012," 7,01 "," 2.505,53 "," 1.531,20 ",2953489564,CFD," 0,00 "
27/02/2025 08:32:34,Open Position,NSDQ100/USD," 199,99 ",0.188454," 0,00 "," 2.505,53 "," 1.331,21 ",2953571922,CFD," 0,00 "
27/02/2025 09:09:43,Position closed,NSDQ100/USD," 203,99 ",0.188454," 4,00 "," 2.509,53 "," 1.535,20 ",2953571922,CFD," 0,00 "
27/02/2025 09:09:55,Open Position,NSDQ100/USD," 150,00 ",0.141193," 0,00 "," 2.509,53 "," 1.385,20 ",2953609083,CFD," 0,00 "
27/02/2025 09:28:43,Position closed,NSDQ100/USD," 152,01 ",0.141193," 2,01 "," 2.511,54 "," 1.537,21 ",2953609083,CFD," 0,00 "
27/02/2025 09:28:56,Open Position,NSDQ100/USD," 259,99 ",0.244534," 0,00 "," 2.511,54 "," 1.277,22 ",2953614423,CFD," 0,00 "
27/02/2025 10:21:44,Position closed,NSDQ100/USD," 261,44 ",0.244534," 1,45 "," 2.512,99 "," 1.538,66 ",2953614423,CFD," 0,00 "
27/02/2025 10:22:16,Open Position,NSDQ100/USD," 199,99 ",0.187983," 0,00 "," 2.512,99 "," 1.338,67 ",2953631291,CFD," 0,00 "
27/02/2025 10:22:46,Open Position,USD/JPY," 99,99 ",3000," 0,00 "," 2.512,99 "," 1.238,68 ",2953631406,CFD," 0,00 "
27/02/2025 12:09:30,Position closed,NSDQ100/USD," 204,69 ",0.187983," 4,70 "," 2.517,69 "," 1.443,37 ",2953631291,CFD," 0,00 "
27/02/2025 12:09:40,Open Position,NSDQ100/USD," 488,73 ",0.281653," 0,00 "," 2.517,69 "," 1.143,37 ",2953659689,CFD," 0,00 "
27/02/2025 12:10:35,Position closed,NVDA.EXT/USD," 156,84 ",5.651045," 6,84 "," 2.524,53 "," 1.300,21 ",2953137052,CFD," 0,00 "
27/02/2025 12:10:45,Position closed,USD/JPY," 103,30 ",3000," 3,31 "," 2.527,84 "," 1.403,51 ",2953631406,CFD," 0,00 "
27/02/2025 12:11:19,Open Position,USD/JPY," 149,99 ",4500," 0,00 "," 2.527,84 "," 1.253,52 ",2953660006,CFD," 0,00 "
27/02/2025 12:11:32,Open Position,NSDQ100/USD," 244,12 ",0.140839," 0,00 "," 2.527,84 "," 1.103,52 ",2953660033,CFD," 0,00 "
27/02/2025 12:54:02,Position closed,USD/JPY," 153,99 ",4500," 4,00 "," 2.531,84 "," 1.257,51 ",2953660006,CFD," 0,00 "
27/02/2025 12:54:22,Open Position,USD/JPY," 99,99 ",3000," 0,00 "," 2.531,84 "," 1.157,52 ",2953668922,CFD," 0,00 "
27/02/2025 14:48:26,Open Position,NSDQ100/USD," 231,95 ",0.189296," 0,00 "," 2.531,84 "," 957,52 ",2953826706,CFD," 0,00 "
27/02/2025 14:57:38,Position closed,NSDQ100/USD," 75,15 ",0.070831," 0,80 "," 2.532,64 "," 1.032,67 ",2951942238,CFD," 0,00 "
27/02/2025 14:59:37,Open Position,NSDQ100/USD," 199,99 ",0.190825," 0,00 "," 2.532,64 "," 832,68 ",2953948222,CFD," 0,00 "
27/02/2025 15:00:06,Edit Stop Loss,-,"(25,01)",-," 0,00 "," 2.532,64 "," 807,67 ",2953185617,-," 0,00 "
27/02/2025 15:00:21,Edit Stop Loss,-,"(33,85)",-," 0,00 "," 2.532,64 "," 773,82 ",2953659689,-," 0,00 "
27/02/2025 15:00:34,Edit Stop Loss,-,"(16,66)",-," 0,00 "," 2.532,64 "," 757,16 ",2953660033,-," 0,00 "
27/02/2025 15:01:03,Open Position,NSDQ100/USD," 100,00 ",0.095818," 0,00 "," 2.532,64 "," 657,16 ",2953955030,CFD," 0,00 "
27/02/2025 15:01:28,Position closed,NSDQ100/USD," 101,87 ",0.095818," 1,87 "," 2.534,51 "," 759,03 ",2953955030,CFD," 0,00 "
27/02/2025 15:01:40,Open Position,NSDQ100/USD," 99,99 ",0.095911," 0,00 "," 2.534,51 "," 659,04 ",2953957276,CFD," 0,00 "
27/02/2025 15:02:33,Open Position,NSDQ100/USD," 99,99 ",0.095789," 0,00 "," 2.534,51 "," 559,05 ",2953963709,CFD," 0,00 "
27/02/2025 15:10:36,Position closed,NSDQ100/USD," 106,19 ",0.095789," 6,20 "," 2.540,71 "," 665,24 ",2953963709,CFD," 0,00 "
27/02/2025 15:10:48,Open Position,NSDQ100/USD," 99,99 ",0.095446," 0,00 "," 2.540,71 "," 565,25 ",2953997730,CFD," 0,00 "
27/02/2025 15:15:53,Position closed,NSDQ100/USD," 211,01 ",0.190825," 11,02 "," 2.551,73 "," 776,26 ",2953948222,CFD," 0,00 "
27/02/2025 15:16:01,Position closed,NSDQ100/USD," 105,80 ",0.095446," 5,81 "," 2.557,54 "," 882,06 ",2953997730,CFD," 0,00 "
27/02/2025 15:16:19,Open Position,NSDQ100/USD," 126,28 ",0.142629," 0,00 "," 2.557,54 "," 732,06 ",2954013747,CFD," 0,00 "
27/02/2025 18:41:47,Open Position,NVDA.EXT/USD," 250,00 ",9.82546," 0,00 "," 2.557,54 "," 482,06 ",2954268275,CFD," 0,00 "
27/02/2025 19:32:41,Position closed,NSDQ100/USD," 105,74 ",0.095911," 5,75 "," 2.563,29 "," 587,80 ",2953957276,CFD," 0,00 "
27/02/2025 19:36:40,Open Position,NSDQ100/USD," 249,97 ",0.240548," 0,00 "," 2.563,29 "," 337,83 ",2954315290,CFD," 0,00 "
27/02/2025 19:38:30,Position closed,NSDQ100/USD," 250,34 ",0.240548," 0,37 "," 2.563,66 "," 588,17 ",2954315290,CFD," 0,00 "
27/02/2025 19:38:41,Open Position,NSDQ100/USD," 199,99 ",0.192403," 0,00 "," 2.563,66 "," 388,18 ",2954319037,CFD," 0,00 "
27/02/2025 19:39:03,Edit Stop Loss,-,"(28,17)",-," 0,00 "," 2.563,66 "," 360,01 ",2953659689,-," 0,00 "
27/02/2025 19:39:10,Edit Stop Loss,-,"(32,58)",-," 0,00 "," 2.563,66 "," 327,43 ",2953185617,-," 0,00 "
27/02/2025 19:39:22,Edit Stop Loss,-,"(14,08)",-," 0,00 "," 2.563,66 "," 313,35 ",2953660033,-," 0,00 "
27/02/2025 19:39:28,Edit Stop Loss,-,"(9,79)",-," 0,00 "," 2.563,66 "," 303,56 ",2953826706,-," 0,00 "
27/02/2025 20:12:32,Open Position,NSDQ100/USD," 49,99 ",0.048326," 0,00 "," 2.563,66 "," 253,57 ",2954373456,CFD," 0,00 "
27/02/2025 20:14:40,Position closed,NSDQ100/USD," 50,75 ",0.048326," 0,76 "," 2.564,42 "," 304,32 ",2954373456,CFD," 0,00 "
27/02/2025 20:18:03,Open Position,NSDQ100/USD," 149,99 ",0.145133," 0,00 "," 2.564,42 "," 154,33 ",2954380283,CFD," 0,00 "
27/02/2025 20:18:37,Edit Stop Loss,-,"(9,46)",-," 0,00 "," 2.564,42 "," 144,87 ",2953826706,-," 0,00 "
27/02/2025 20:18:50,Edit Stop Loss,-,"(7,05)",-," 0,00 "," 2.564,42 "," 137,82 ",2953660033,-," 0,00 "
27/02/2025 20:19:03,Edit Stop Loss,-,"(14,05)",-," 0,00 "," 2.564,42 "," 123,77 ",2953659689,-," 0,00 "
27/02/2025 20:19:13,Edit Stop Loss,-,"(11,72)",-," 0,00 "," 2.564,42 "," 112,05 ",2953185617,-," 0,00 "
27/02/2025 20:19:53,Open Position,NSDQ100/USD," 49,99 ",0.048413," 0,00 "," 2.564,42 "," 62,06 ",2954384921,CFD," 0,00 "
27/02/2025 20:56:07,Position closed,NSDQ100/USD," 54,12 ",0.048413," 4,13 "," 2.568,55 "," 116,18 ",2954384921,CFD," 0,00 "
27/02/2025 20:59:49,Edit Stop Loss,-,"(11,72)",-," 0,00 "," 2.568,55 "," 104,46 ",2953185617,-," 0,00 "
27/02/2025 20:59:55,Edit Stop Loss,-,"(14,08)",-," 0,00 "," 2.568,55 "," 90,38 ",2953659689,-," 0,00 "
27/02/2025 21:00:05,Edit Stop Loss,-,"(7,04)",-," 0,00 "," 2.568,55 "," 83,34 ",2953660033,-," 0,00 "
27/02/2025 21:00:16,Edit Stop Loss,-,"(9,47)",-," 0,00 "," 2.568,55 "," 73,87 ",2953826706,-," 0,00 "
27/02/2025 21:00:39,Open Position,NSDQ100/USD," 49,99 ",0.048713," 0,00 "," 2.568,55 "," 23,88 ",2954487734,CFD," 0,00 "
27/02/2025 21:31:56,Position closed,USD/JPY," 95,76 ",3000,"(4,23)"," 2.564,32 "," 119,64 ",2953668922,CFD," 0,00 "
27/02/2025 21:32:08,Edit Stop Loss,-,"(11,72)",-," 0,00 "," 2.564,32 "," 107,92 ",2953185617,-," 0,00 "
27/02/2025 21:32:16,Edit Stop Loss,-,"(14,08)",-," 0,00 "," 2.564,32 "," 93,84 ",2953659689,-," 0,00 "
27/02/2025 21:32:24,Edit Stop Loss,-,"(7,04)",-," 0,00 "," 2.564,32 "," 86,80 ",2953660033,-," 0,00 "
27/02/2025 21:32:33,Edit Stop Loss,-,"(9,46)",-," 0,00 "," 2.564,32 "," 77,34 ",2953826706,-," 0,00 "
27/02/2025 21:32:46,Edit Stop Loss,-,"(15,26)",-," 0,00 "," 2.564,32 "," 62,08 ",2954013747,-," 0,00 "
27/02/2025 21:33:19,Edit Stop Loss,-,"(7,13)",-," 0,00 "," 2.564,32 "," 54,95 ",2954013747,-," 0,00 "
27/02/2025 21:33:32,Edit Stop Loss,-,"(9,47)",-," 0,00 "," 2.564,32 "," 45,48 ",2953826706,-," 0,00 "
27/02/2025 21:33:39,Edit Stop Loss,-,"(7,04)",-," 0,00 "," 2.564,32 "," 38,44 ",2953660033,-," 0,00 "
27/02/2025 21:33:48,Edit Stop Loss,-,"(14,09)",-," 0,00 "," 2.564,32 "," 24,35 ",2953659689,-," 0,00 "
27/02/2025 21:33:56,Edit Stop Loss,-,"(11,72)",-," 0,00 "," 2.564,32 "," 12,63 ",2953185617,-," 0,00 "
27/02/2025 23:17:07,Overnight fee,Daily,"(0,74)",-,"(0,74)"," 2.563,58 "," 11,89 ",2953660033,CFD," 0,00 "
27/02/2025 23:17:07,Overnight fee,Daily,"(0,75)",-,"(0,75)"," 2.562,83 "," 11,14 ",2954013747,CFD," 0,00 "
27/02/2025 23:17:07,Overnight fee,Daily,"(0,76)",-,"(0,76)"," 2.562,07 "," 10,38 ",2954380283,CFD," 0,00 "
27/02/2025 23:17:07,Overnight fee,Daily,"(0,99)",-,"(0,99)"," 2.561,08 "," 9,39 ",2953826706,CFD," 0,00 "
27/02/2025 23:17:07,Overnight fee,Daily,"(1,01)",-,"(1,01)"," 2.560,07 "," 8,38 ",2954319037,CFD," 0,00 "
27/02/2025 23:17:07,Overnight fee,Daily,"(1,23)",-,"(1,23)"," 2.558,84 "," 7,15 ",2953185617,CFD," 0,00 "
27/02/2025 23:17:07,Overnight fee,Daily,"(1,48)",-,"(1,48)"," 2.557,36 "," 5,67 ",2953659689,CFD," 0,00 "
27/02/2025 23:17:07,Overnight fee,Daily,"(0,02)",-,"(0,02)"," 2.557,34 "," 5,65 ",2954487734,CFD," 0,00 "
27/02/2025 23:17:07,Overnight fee,Daily,"(0,38)",-,"(0,38)"," 2.556,96 "," 5,27 ",2954268275,CFD," 0,00 "
28/02/2025 00:41:29,Index price adjustment,NSDQ100/USD," 0,63 ",-," 0,63 "," 2.557,59 "," 5,90 ",2953185617,CFD," 0,00 "
28/02/2025 00:41:29,Index price adjustment,NSDQ100/USD," 0,75 ",-," 0,75 "," 2.558,34 "," 6,65 ",2953659689,CFD," 0,00 "
28/02/2025 00:41:29,Index price adjustment,NSDQ100/USD," 0,38 ",-," 0,38 "," 2.558,72 "," 7,03 ",2953660033,CFD," 0,00 "
28/02/2025 00:41:29,Index price adjustment,NSDQ100/USD," 0,51 ",-," 0,51 "," 2.559,23 "," 7,54 ",2953826706,CFD," 0,00 "
28/02/2025 00:41:29,Index price adjustment,NSDQ100/USD," 0,38 ",-," 0,38 "," 2.559,61 "," 7,92 ",2954013747,CFD," 0,00 "
28/02/2025 00:41:29,Index price adjustment,NSDQ100/USD," 0,52 ",-," 0,52 "," 2.560,13 "," 8,44 ",2954319037,CFD," 0,00 "
28/02/2025 00:41:29,Index price adjustment,NSDQ100/USD," 0,39 ",-," 0,39 "," 2.560,52 "," 8,83 ",2954380283,CFD," 0,00 "
28/02/2025 14:36:35,Position closed,NSDQ100/USD," 50,52 ",0.048713," 0,53 "," 2.561,05 "," 59,35 ",2954487734,CFD," 0,00 "
28/02/2025 14:36:56,Open Position,NSDQ100/USD," 49,99 ",0.048712," 0,00 "," 2.561,05 "," 9,36 ",2954904511,CFD," 0,00 "
28/02/2025 14:58:04,Position closed,NSDQ100/USD," 51,18 ",0.048712," 1,19 "," 2.562,24 "," 60,54 ",2954904511,CFD," 0,00 "
28/02/2025 15:02:51,Edit Stop Loss,-,"(9,46)",-," 0,00 "," 2.562,24 "," 51,08 ",2953826706,-," 0,00 "
28/02/2025 15:02:59,Edit Stop Loss,-,"(7,04)",-," 0,00 "," 2.562,24 "," 44,04 ",2953660033,-," 0,00 "
28/02/2025 15:03:06,Edit Stop Loss,-,"(7,13)",-," 0,00 "," 2.562,24 "," 36,91 ",2954013747,-," 0,00 "
28/02/2025 15:03:15,Edit Stop Loss,-,"(14,08)",-," 0,00 "," 2.562,24 "," 22,83 ",2953659689,-," 0,00 "
28/02/2025 15:03:24,Edit Stop Loss,-,"(11,72)",-," 0,00 "," 2.562,24 "," 11,11 ",2953185617,-," 0,00 "
28/02/2025 16:03:09,Position closed,NSDQ100/USD," 157,28 ",0.145133," 7,29 "," 2.569,53 "," 168,39 ",2954380283,CFD," 0,00 "
28/02/2025 19:25:25,Open Position,NSDQ100/USD," 99,98 ",0.097305," 0,00 "," 2.569,53 "," 68,41 ",2955581573,CFD," 0,00 "
28/02/2025 20:04:08,Position closed,NSDQ100/USD," 112,12 ",0.097305," 12,14 "," 2.581,67 "," 180,53 ",2955581573,CFD," 0,00 "
28/02/2025 21:04:33,Position closed,NSDQ100/USD," 208,86 ",0.192403," 8,87 "," 2.590,54 "," 389,39 ",2954319037,CFD," 0,00 "
28/02/2025 23:17:10,Overnight fee,Weekend Fee,"(1,05)",-,"(1,05)"," 2.589,49 "," 388,34 ",2954268275,CFD," 0,00 "
28/02/2025 23:17:10,Overnight fee,Weekend Fee,"(2,21)",-,"(2,21)"," 2.587,28 "," 386,13 ",2953660033,CFD," 0,00 "
28/02/2025 23:17:10,Overnight fee,Weekend Fee,"(2,24)",-,"(2,24)"," 2.585,04 "," 383,89 ",2954013747,CFD," 0,00 "
28/02/2025 23:17:10,Overnight fee,Weekend Fee,"(2,97)",-,"(2,97)"," 2.582,07 "," 380,92 ",2953826706,CFD," 0,00 "
28/02/2025 23:17:10,Overnight fee,Weekend Fee,"(3,68)",-,"(3,68)"," 2.578,39 "," 377,24 ",2953185617,CFD," 0,00 "
28/02/2025 23:17:10,Overnight fee,Weekend Fee,"(4,43)",-,"(4,43)"," 2.573,96 "," 372,81 ",2953659689,CFD," 0,00 "
03/03/2025 08:20:03,Open Position,NSDQ100/USD," 149,98 ",0.143628," 0,00 "," 2.573,96 "," 222,83 ",2956045741,CFD," 0,00 "
03/03/2025 08:46:00,Position closed,NSDQ100/USD," 153,08 ",0.143628," 3,10 "," 2.577,06 "," 375,91 ",2956045741,CFD," 0,00 "
03/03/2025 09:53:28,Position closed,NSDQ100/USD," 50,05 ",0.042296,"(3,19)"," 2.573,87 "," 425,96 ",2956124153,CFD," 0,00 "
03/03/2025 12:15:14,Position closed,NSDQ100/USD," 127,60 ",0.100333," 1,32 "," 2.575,19 "," 553,56 ",2954013747,CFD," 0,00 "
03/03/2025 13:22:44,Position closed,NSDQ100/USD," 50,03 ",0.040442,"(4,90)"," 2.570,29 "," 603,59 ",2956288490,CFD," 0,00 "
03/03/2025 15:01:26,Open Position,NSDQ100/USD," 50,00 ",0.048137," 0,00 "," 2.570,29 "," 553,59 ",2957033196,CFD," 0,00 "
03/03/2025 15:01:54,Open Position,NSDQ100/USD," 99,98 ",0.096204," 0,00 "," 2.570,29 "," 453,61 ",2957034165,CFD," 0,00 "
03/03/2025 15:04:24,Position closed,NSDQ100/USD," 50,70 ",0.048137," 0,70 "," 2.570,99 "," 504,31 ",2957033196,CFD," 0,00 "
03/03/2025 15:07:52,Position closed,NSDQ100/USD," 103,20 ",0.096204," 3,22 "," 2.574,21 "," 607,51 ",2957034165,CFD," 0,00 "
03/03/2025 15:08:07,Open Position,NSDQ100/USD," 150,00 ",0.144167," 0,00 "," 2.574,21 "," 457,51 ",2957067003,CFD," 0,00 "
03/03/2025 15:08:25,Position closed,NSDQ100/USD," 148,34 ",0.144167,"(1,66)"," 2.572,55 "," 605,85 ",2957067003,CFD," 0,00 "
03/03/2025 15:08:45,Open Position,NSDQ100/USD," 49,99 ",0.048079," 0,00 "," 2.572,55 "," 555,86 ",2957069685,CFD," 0,00 "
03/03/2025 15:49:04,Position closed,NSDQ100/USD," 52,33 ",0.048079," 2,34 "," 2.574,89 "," 608,19 ",2957069685,CFD," 0,00 "
03/03/2025 15:49:51,Open Position,NSDQ100/USD," 122,65 ",0.095876," 0,00 "," 2.574,89 "," 508,21 ",2957218309,CFD," 0,00 "
03/03/2025 18:13:44,Position closed,NVDA.EXT/USD," 124,60 ",9.82546,"(125,40)"," 2.449,49 "," 632,81 ",2954268275,CFD," 0,00 "
03/03/2025 18:26:52,Open Position,NSDQ100/USD," 160,28 ",0.144999," 0,00 "," 2.449,49 "," 482,82 ",2957626688,CFD," 0,00 "
03/03/2025 18:29:14,Edit Stop Loss,-,"(3,49)",-," 0,00 "," 2.449,49 "," 479,33 ",2957218309,-," 0,00 "
03/03/2025 20:14:04,Edit Stop Loss,-,"(23,45)",-," 0,00 "," 2.449,49 "," 455,88 ",2953185617,-," 0,00 "
03/03/2025 20:14:13,Edit Stop Loss,-,"(28,16)",-," 0,00 "," 2.449,49 "," 427,72 ",2953659689,-," 0,00 "
03/03/2025 20:14:19,Edit Stop Loss,-,"(14,09)",-," 0,00 "," 2.449,49 "," 413,63 ",2953660033,-," 0,00 "
03/03/2025 20:14:25,Edit Stop Loss,-,"(14,88)",-," 0,00 "," 2.449,49 "," 398,75 ",2953826706,-," 0,00 "
03/03/2025 20:14:32,Edit Stop Loss,-,"(9,59)",-," 0,00 "," 2.449,49 "," 389,16 ",2957218309,-," 0,00 "
03/03/2025 20:15:01,Open Position,NSDQ100/USD," 249,99 ",0.244825," 0,00 "," 2.449,49 "," 139,17 ",2957780223,CFD," 0,00 "
03/03/2025 20:18:06,Position closed,NSDQ100/USD," 253,23 ",0.244825," 3,24 "," 2.452,73 "," 392,40 ",2957780223,CFD," 0,00 "
03/03/2025 20:18:18,Open Position,NSDQ100/USD," 299,93 ",0.293647," 0,00 "," 2.452,73 "," 92,47 ",2957791892,CFD," 0,00 "
03/03/2025 21:17:24,Position closed,NSDQ100/USD," 312,52 ",0.293647," 12,59 "," 2.465,32 "," 404,99 ",2957791892,CFD," 0,00 "
03/03/2025 23:09:59,Open Position,NSDQ100/USD," 99,99 ",0.048867," 0,00 "," 2.465,32 "," 305,00 ",2958653226,CFD," 0,00 "
03/03/2025 23:17:36,Overnight fee,Daily,"(0,48)",-,"(0,48)"," 2.464,84 "," 304,52 ",2957218309,CFD," 0,00 "
03/03/2025 23:17:36,Overnight fee,Daily,"(0,71)",-,"(0,71)"," 2.464,13 "," 303,81 ",2953660033,CFD," 0,00 "
03/03/2025 23:17:36,Overnight fee,Daily,"(0,73)",-,"(0,73)"," 2.463,40 "," 303,08 ",2957626688,CFD," 0,00 "
03/03/2025 23:17:36,Overnight fee,Daily,"(0,75)",-,"(0,75)"," 2.462,65 "," 302,33 ",2953826706,CFD," 0,00 "
03/03/2025 23:17:36,Overnight fee,Daily,"(1,19)",-,"(1,19)"," 2.461,46 "," 301,14 ",2953185617,CFD," 0,00 "
03/03/2025 23:17:36,Overnight fee,Daily,"(1,42)",-,"(1,42)"," 2.460,04 "," 299,72 ",2953659689,CFD," 0,00 "
04/03/2025 00:41:28,Index price adjustment,NSDQ100/USD," 0,15 ",-," 0,15 "," 2.460,19 "," 299,87 ",2953185617,CFD," 0,00 "
04/03/2025 00:41:28,Index price adjustment,NSDQ100/USD," 0,18 ",-," 0,18 "," 2.460,37 "," 300,05 ",2953659689,CFD," 0,00 "
04/03/2025 00:41:28,Index price adjustment,NSDQ100/USD," 0,09 ",-," 0,09 "," 2.460,46 "," 300,14 ",2953660033,CFD," 0,00 "
04/03/2025 00:41:28,Index price adjustment,NSDQ100/USD," 0,10 ",-," 0,10 "," 2.460,56 "," 300,24 ",2953826706,CFD," 0,00 "
04/03/2025 00:41:28,Index price adjustment,NSDQ100/USD," 0,06 ",-," 0,06 "," 2.460,62 "," 300,30 ",2957218309,CFD," 0,00 "
04/03/2025 00:41:28,Index price adjustment,NSDQ100/USD," 0,10 ",-," 0,10 "," 2.460,72 "," 300,40 ",2957626688,CFD," 0,00 "
04/03/2025 00:41:28,Index price adjustment,NSDQ100/USD," 0,19 ",-," 0,19 "," 2.460,91 "," 300,59 ",2957791892,CFD," 0,00 "
04/03/2025 12:13:19,Open Position,NSDQ100/USD," 99,99 ",0.098137," 0,00 "," 2.460,91 "," 200,60 ",2959070561,CFD," 0,00 "
04/03/2025 13:28:41,Edit Stop Loss,-,"(23,44)",-," 0,00 "," 2.460,91 "," 177,16 ",2953185617,-," 0,00 "
04/03/2025 13:28:47,Edit Stop Loss,-,"(28,17)",-," 0,00 "," 2.460,91 "," 148,99 ",2953659689,-," 0,00 "
04/03/2025 13:29:00,Edit Stop Loss,-,"(14,08)",-," 0,00 "," 2.460,91 "," 134,91 ",2953660033,-," 0,00 "
04/03/2025 13:29:06,Edit Stop Loss,-,"(14,89)",-," 0,00 "," 2.460,91 "," 120,02 ",2953826706,-," 0,00 "
04/03/2025 13:29:14,Edit Stop Loss,-,"(9,59)",-," 0,00 "," 2.460,91 "," 110,43 ",2957218309,-," 0,00 "
04/03/2025 13:29:22,Edit Stop Loss,-,"(10,29)",-," 0,00 "," 2.460,91 "," 100,14 ",2957626688,-," 0,00 "
04/03/2025 13:52:34,Open Position,NSDQ100/USD," 79,99 ",0.0789," 0,00 "," 2.460,91 "," 20,15 ",2959130295,CFD," 0,00 "
04/03/2025 14:32:11,Position closed,NSDQ100/USD," 82,38 ",0.0789," 2,39 "," 2.463,30 "," 102,53 ",2959130295,CFD," 0,00 "
04/03/2025 14:35:30,Open Position,NSDQ100/USD," 99,98 ",0.098695," 0,00 "," 2.463,30 "," 2,55 ",2959301405,CFD," 0,00 "
04/03/2025 15:16:33,Position closed,NSDQ100/USD," 49,70 ",0.095876,"(72,95)"," 2.390,35 "," 52,25 ",2957218309,CFD," 0,00 "
04/03/2025 15:16:33,Position closed,NSDQ100/USD," 149,26 ",0.281653,"(339,47)"," 2.050,88 "," 201,51 ",2953659689,CFD," 0,00 "
04/03/2025 15:16:33,Position closed,NSDQ100/USD," 78,08 ",0.148854,"(153,87)"," 1.897,01 "," 279,59 ",2953826706,CFD," 0,00 "
04/03/2025 15:16:33,Position closed,NSDQ100/USD," 74,61 ",0.140839,"(169,51)"," 1.727,50 "," 354,20 ",2953660033,CFD," 0,00 "
04/03/2025 15:16:33,Position closed,NSDQ100/USD," 124,03 ",0.23441,"(289,03)"," 1.438,47 "," 478,23 ",2953185617,CFD," 0,00 "
04/03/2025 15:16:34,Position closed,NSDQ100/USD," 74,36 ",0.144999,"(85,92)"," 1.352,55 "," 552,59 ",2957626688,CFD," 0,00 "
04/03/2025 15:38:19,Position closed,NSDQ100/USD," 110,18 ",0.098695," 10,20 "," 1.362,75 "," 662,77 ",2959301405,CFD," 0,00 "
04/03/2025 15:41:00,Open Position,NSDQ100/USD," 300,00 ",0.14897," 0,00 "," 1.362,75 "," 362,77 ",2959776095,CFD," 0,00 "
04/03/2025 15:41:25,Open Position,NSDQ100/USD," 149,99 ",0.14866," 0,00 "," 1.362,75 "," 212,78 ",2959777520,CFD," 0,00 "
04/03/2025 16:32:51,Position closed,NSDQ100/USD," 154,03 ",0.14866," 4,04 "," 1.366,79 "," 366,81 ",2959777520,CFD," 0,00 "
04/03/2025 16:33:00,Position closed,NSDQ100/USD," 301,25 ",0.14897," 1,25 "," 1.368,04 "," 668,06 ",2959776095,CFD," 0,00 "
04/03/2025 16:33:45,Open Position,NSDQ100/USD," 299,99 ",0.14892," 0,00 "," 1.368,04 "," 368,07 ",2959885097,CFD," 0,00 "
04/03/2025 16:34:13,Open Position,NSDQ100/USD," 116,88 ",0.099361," 0,00 "," 1.368,04 "," 268,08 ",2959885697,CFD," 0,00 "
04/03/2025 16:48:41,Position closed,NSDQ100/USD," 306,95 ",0.14892," 6,96 "," 1.375,00 "," 575,03 ",2959885097,CFD," 0,00 "
04/03/2025 16:48:54,Open Position,NSDQ100/USD," 349,98 ",0.173226," 0,00 "," 1.375,00 "," 225,05 ",2959921042,CFD," 0,00 "
04/03/2025 17:42:40,Position closed,NSDQ100/USD," 365,39 ",0.173226," 15,41 "," 1.390,41 "," 590,44 ",2959921042,CFD," 0,00 "
04/03/2025 17:43:00,Open Position,NSDQ100/USD," 249,98 ",0.123126," 0,00 "," 1.390,41 "," 340,46 ",2960016466,CFD," 0,00 "
04/03/2025 17:48:57,Position closed,NSDQ100/USD," 254,10 ",0.123126," 4,12 "," 1.394,53 "," 594,56 ",2960016466,CFD," 0,00 "
04/03/2025 17:49:19,Open Position,NSDQ100/USD," 299,99 ",0.147583," 0,00 "," 1.394,53 "," 294,57 ",2960022755,CFD," 0,00 "
04/03/2025 19:31:47,Position closed,NSDQ100/USD," 102,27 ",0.048867," 2,28 "," 1.396,81 "," 396,84 ",2958653226,CFD," 0,00 "
04/03/2025 19:32:06,Position closed,NSDQ100/USD," 326,49 ",0.147583," 26,50 "," 1.423,31 "," 723,33 ",2960022755,CFD," 0,00 "
04/03/2025 19:32:14,Position closed,NSDQ100/USD," 113,03 ",0.098137," 13,04 "," 1.436,35 "," 836,36 ",2959070561,CFD," 0,00 "
04/03/2025 19:35:12,Open Position,NSDQ100/USD," 199,98 ",0.097519," 0,00 "," 1.436,35 "," 636,38 ",2960232264,CFD," 0,00 "
04/03/2025 19:58:51,Position closed,NSDQ100/USD," 205,97 ",0.097519," 5,99 "," 1.442,34 "," 842,35 ",2960232264,CFD," 0,00 "
04/03/2025 19:59:09,Edit Stop Loss,-,"(11,92)",-," 0,00 "," 1.442,34 "," 830,43 ",2959885697,-," 0,00 "
04/03/2025 19:59:26,Open Position,NSDQ100/USD," 299,98 ",0.145797," 0,00 "," 1.442,34 "," 530,45 ",2960255273,CFD," 0,00 "
04/03/2025 20:19:59,Position closed,NSDQ100/USD," 308,58 ",0.145797," 8,60 "," 1.450,94 "," 839,03 ",2960255273,CFD," 0,00 "
04/03/2025 20:20:23,Edit Stop Loss,-,"(4,97)",-," 0,00 "," 1.450,94 "," 834,06 ",2959885697,-," 0,00 "
04/03/2025 20:20:46,Open Position,NSDQ100/USD," 349,98 ",0.169605," 0,00 "," 1.450,94 "," 484,08 ",2960278437,CFD," 0,00 "
04/03/2025 20:26:03,Position closed,NSDQ100/USD," 353,30 ",0.169605," 3,32 "," 1.454,26 "," 837,38 ",2960278437,CFD," 0,00 "
04/03/2025 20:26:45,Open Position,NSDQ100/USD," 199,89 ",0.193526," 0,00 "," 1.454,26 "," 437,40 ",2960284737,CFD," 0,00 "
04/03/2025 20:40:56,Open Position,NSDQ100/USD," 99,99 ",0.048884," 0,00 "," 1.454,26 "," 337,41 ",2960313831,CFD," 0,00 "
04/03/2025 20:53:44,Open Position,NSDQ100/USD," 199,98 ",0.196881," 0,00 "," 1.454,26 "," 137,43 ",2960340878,CFD," 0,00 "
04/03/2025 21:04:55,Position closed,NSDQ100/USD," 213,08 ",0.196881," 13,10 "," 1.467,36 "," 350,51 ",2960340878,CFD," 0,00 "
04/03/2025 21:51:58,Position closed,NSDQ100/USD," 101,20 ",0.048884," 1,21 "," 1.468,57 "," 451,71 ",2960313831,CFD," 0,00 "
04/03/2025 21:52:13,Open Position,NSDQ100/USD," 249,99 ",0.12206," 0,00 "," 1.468,57 "," 201,72 ",2960365507,CFD," 0,00 "
04/03/2025 23:17:29,Overnight fee,Daily,"(0,03)",-,"(0,03)"," 1.468,54 "," 201,69 ",2959885697,CFD," 0,00 "
04/03/2025 23:17:29,Overnight fee,Daily,"(0,62)",-,"(0,62)"," 1.467,92 "," 201,07 ",2960365507,CFD," 0,00 "
04/03/2025 23:17:29,Overnight fee,Daily,"(0,98)",-,"(0,98)"," 1.466,94 "," 200,09 ",2960284737,CFD," 0,00 "
04/03/2025 23:53:35,Position closed,NSDQ100/USD," 254,46 ",0.12206," 4,47 "," 1.471,41 "," 454,55 ",2960365507,CFD," 0,00 "
04/03/2025 23:53:58,Open Position,NSDQ100/USD," 99,99 ",0.048722," 0,00 "," 1.471,41 "," 354,56 ",2960465954,CFD," 0,00 "
04/03/2025 23:56:18,Position closed,NSDQ100/USD," 99,79 ",0.048722,"(0,20)"," 1.471,21 "," 454,35 ",2960465954,CFD," 0,00 "
05/03/2025 00:39:57,Index price adjustment,NSDQ100/USD,"(0,05)",-,"(0,05)"," 1.471,16 "," 454,30 ",2959885697,CFD," 0,00 "
05/03/2025 00:39:57,Index price adjustment,NSDQ100/USD," 0,09 ",-," 0,09 "," 1.471,25 "," 454,39 ",2960284737,CFD," 0,00 "
05/03/2025 00:39:57,Index price adjustment,NSDQ100/USD," 0,02 ",-," 0,02 "," 1.471,27 "," 454,41 ",2960313831,CFD," 0,00 "
05/03/2025 00:39:57,Index price adjustment,NSDQ100/USD," 0,09 ",-," 0,09 "," 1.471,36 "," 454,50 ",2960340878,CFD," 0,00 "
05/03/2025 06:46:48,Open Position,NSDQ100/USD," 149,99 ",0.073167," 0,00 "," 1.471,36 "," 304,51 ",2960517958,CFD," 0,00 "
05/03/2025 14:33:53,Open Position,NSDQ100/USD," 199,98 ",0.196342," 0,00 "," 1.471,36 "," 104,53 ",2960870479,CFD," 0,00 "
05/03/2025 16:23:39,Open Position,NSDQ100/USD," 99,98 ",0.098829," 0,00 "," 1.471,36 "," 4,55 ",2961169381,CFD," 0,00 "
05/03/2025 17:10:21,Position closed,NSDQ100/USD," 109,54 ",0.098829," 9,56 "," 1.480,92 "," 114,09 ",2961169381,CFD," 0,00 "
05/03/2025 17:10:42,Position closed,NSDQ100/USD," 97,18 ",0.099361,"(19,70)"," 1.461,22 "," 211,27 ",2959885697,CFD," 0,00 "
05/03/2025 17:10:54,Open Position,NSDQ100/USD," 150,00 ",0.147635," 0,00 "," 1.461,22 "," 61,27 ",2961259798,CFD," 0,00 "
05/03/2025 17:43:13,Position closed,NSDQ100/USD," 170,64 ",0.147635," 20,64 "," 1.481,86 "," 231,91 ",2961259798,CFD," 0,00 "
05/03/2025 17:43:34,Position closed,NSDQ100/USD," 214,90 ",0.196342," 14,92 "," 1.496,78 "," 446,81 ",2960870479,CFD," 0,00 "
05/03/2025 17:58:09,Position closed,NSDQ100/USD," 150,79 ",0.073167," 0,80 "," 1.497,58 "," 597,60 ",2960517958,CFD," 0,00 "
05/03/2025 17:58:21,Open Position,NSDQ100/USD," 349,98 ",0.170587," 0,00 "," 1.497,58 "," 247,62 ",2961321941,CFD," 0,00 "
05/03/2025 18:59:09,Position closed,NSDQ100/USD," 354,26 ",0.170587," 4,28 "," 1.501,86 "," 601,88 ",2961321941,CFD," 0,00 "
05/03/2025 18:59:43,Open Position,NSDQ100/USD," 199,97 ",0.097318," 0,00 "," 1.501,86 "," 401,91 ",2961371370,CFD," 0,00 "
05/03/2025 19:21:36,Position closed,NSDQ100/USD," 207,51 ",0.097318," 7,54 "," 1.509,40 "," 609,42 ",2961371370,CFD," 0,00 "
05/03/2025 19:22:04,Position closed,NSDQ100/USD," 196,36 ",0.096812,"(3,73)"," 1.505,67 "," 805,78 ",2961393425,CFD," 0,00 "
05/03/2025 19:24:45,Position closed,NSDQ100/USD," 197,66 ",0.096714,"(2,23)"," 1.503,44 "," 1.003,44 ",2960284737,CFD," 0,00 "
05/03/2025 19:25:11,Open Position,NSDQ100/USD," 249,97 ",0.121123," 0,00 "," 1.503,44 "," 753,47 ",2961395864,CFD," 0,00 "
05/03/2025 23:17:00,Overnight fee,Daily,"(0,61)",-,"(0,61)"," 1.502,83 "," 752,86 ",2961395864,CFD," 0,00 "
06/03/2025 00:17:50,Index price adjustment,NSDQ100/USD," 0,20 ",-," 0,20 "," 1.503,03 "," 753,06 ",2961395864,CFD," 0,00 "
06/03/2025 08:38:34,Open Position,NSDQ100/USD," 114,55 ",0.09775," 0,00 "," 1.503,03 "," 653,07 ",2961639905,CFD," 0,00 "
06/03/2025 08:39:17,Open Position,NSDQ100/USD," 49,98 ",0.048865," 0,00 "," 1.503,03 "," 603,09 ",2961640296,CFD," 0,00 "
06/03/2025 08:48:44,Position closed,NSDQ100/USD," 50,67 ",0.048865," 0,69 "," 1.503,72 "," 653,76 ",2961640296,CFD," 0,00 "
06/03/2025 09:48:08,Open Position,NSDQ100/USD," 400,00 ",0.196249," 0,00 "," 1.503,72 "," 253,76 ",2961674273,CFD," 0,00 "
06/03/2025 14:09:34,Open Position,NSDQ100/USD," 49,99 ",0.049215," 0,00 "," 1.503,72 "," 203,77 ",2961781230,CFD," 0,00 "
06/03/2025 14:49:19,Open Position,NSDQ100/USD," 99,99 ",0.098776," 0,00 "," 1.503,72 "," 103,78 ",2961924549,CFD," 0,00 "
06/03/2025 16:19:37,Position closed,NSDQ100/USD," 115,41 ",0.098776," 15,42 "," 1.519,14 "," 219,19 ",2961924549,CFD," 0,00 "
06/03/2025 16:19:44,Position closed,NSDQ100/USD," 54,51 ",0.049215," 4,52 "," 1.523,66 "," 273,70 ",2961781230,CFD," 0,00 "
06/03/2025 16:19:53,Position closed,NSDQ100/USD," 403,32 ",0.196249," 3,32 "," 1.526,98 "," 677,02 ",2961674273,CFD," 0,00 "
06/03/2025 16:20:05,Open Position,NSDQ100/USD," 128,18 ",0.098043," 0,00 "," 1.526,98 "," 577,04 ",2962324179,CFD," 0,00 "
06/03/2025 17:08:03,Open Position,NSDQ100/USD," 399,97 ",0.396873," 0,00 "," 1.526,98 "," 177,07 ",2962371565,CFD," 0,00 "
06/03/2025 19:38:10,Edit Stop Loss,-,"(8,59)",-," 0,00 "," 1.526,98 "," 168,48 ",2962324179,-," 0,00 "
06/03/2025 19:38:18,Edit Stop Loss,-,"(14,56)",-," 0,00 "," 1.526,98 "," 153,92 ",2961639905,-," 0,00 "
06/03/2025 19:41:33,Open Position,NSDQ100/USD," 99,99 ",0.099995," 0,00 "," 1.526,98 "," 53,93 ",2963073298,CFD," 0,00 "
06/03/2025 20:05:12,Position closed,NSDQ100/USD," 104,53 ",0.099995," 4,54 "," 1.531,52 "," 158,46 ",2963073298,CFD," 0,00 "
06/03/2025 20:05:36,Open Position,NSDQ100/USD," 99,99 ",0.099727," 0,00 "," 1.531,52 "," 58,47 ",2963290183,CFD," 0,00 "
06/03/2025 21:12:10,Position closed,NSDQ100/USD," 103,37 ",0.099727," 3,38 "," 1.534,90 "," 161,84 ",2963290183,CFD," 0,00 "
06/03/2025 23:17:00,Overnight fee,Daily,"(0,49)",-,"(0,49)"," 1.534,41 "," 161,35 ",2961639905,CFD," 0,00 "
06/03/2025 23:17:00,Overnight fee,Daily,"(0,50)",-,"(0,50)"," 1.533,91 "," 160,85 ",2962324179,CFD," 0,00 "
06/03/2025 23:17:00,Overnight fee,Daily,"(0,61)",-,"(0,61)"," 1.533,30 "," 160,24 ",2961395864,CFD," 0,00 "
06/03/2025 23:17:00,Overnight fee,Daily,"(2,01)",-,"(2,01)"," 1.531,29 "," 158,23 ",2962371565,CFD," 0,00 "
07/03/2025 00:39:45,Index price adjustment,NSDQ100/USD," 0,45 ",-," 0,45 "," 1.531,74 "," 158,68 ",2961395864,CFD," 0,00 "
07/03/2025 00:39:45,Index price adjustment,NSDQ100/USD," 0,36 ",-," 0,36 "," 1.532,10 "," 159,04 ",2961639905,CFD," 0,00 "
07/03/2025 00:39:45,Index price adjustment,NSDQ100/USD," 0,36 ",-," 0,36 "," 1.532,46 "," 159,40 ",2962324179,CFD," 0,00 "
07/03/2025 00:39:45,Index price adjustment,NSDQ100/USD," 1,47 ",-," 1,47 "," 1.533,93 "," 160,87 ",2962371565,CFD," 0,00 "
07/03/2025 00:39:45,Index price adjustment,NSDQ100/USD," 0,37 ",-," 0,37 "," 1.534,30 "," 161,24 ",2963290183,CFD," 0,00 "
07/03/2025 01:16:04,Position closed,NSDQ100/USD," 403,90 ",0.396873," 3,93 "," 1.538,23 "," 565,14 ",2962371565,CFD," 0,00 "
07/03/2025 01:16:17,Open Position,NSDQ100/USD," 199,99 ",0.198321," 0,00 "," 1.538,23 "," 365,15 ",2963746500,CFD," 0,00 "
07/03/2025 09:14:03,Position closed,NSDQ100/USD," 200,62 ",0.198321," 0,63 "," 1.538,86 "," 565,77 ",2963746500,CFD," 0,00 "
07/03/2025 09:14:19,Open Position,NSDQ100/USD," 150,00 ",0.148601," 0,00 "," 1.538,86 "," 415,77 ",2963859629,CFD," 0,00 "
07/03/2025 12:24:11,Open Position,NSDQ100/USD," 149,99 ",0.149198," 0,00 "," 1.538,86 "," 265,78 ",2963934333,CFD," 0,00 "
07/03/2025 12:31:34,Open Position,NSDQ100/USD," 199,99 ",0.099561," 0,00 "," 1.538,86 "," 65,79 ",2963937337,CFD," 0,00 "
07/03/2025 13:45:52,Position closed,NSDQ100/USD," 203,32 ",0.099561," 3,33 "," 1.542,19 "," 269,11 ",2963937337,CFD," 0,00 "
07/03/2025 13:46:00,Position closed,NSDQ100/USD," 152,45 ",0.149198," 2,46 "," 1.544,65 "," 421,56 ",2963934333,CFD," 0,00 "
07/03/2025 13:46:15,Open Position,NSDQ100/USD," 300,00 ",0.149014," 0,00 "," 1.544,65 "," 121,56 ",2963966153,CFD," 0,00 "
07/03/2025 14:38:11,Open Position,NSDQ100/USD," 99,99 ",0.099924," 0,00 "," 1.544,65 "," 21,57 ",2964086769,CFD," 0,00 "
07/03/2025 14:57:36,Position closed,NSDQ100/USD," 111,49 ",0.099924," 11,50 "," 1.556,15 "," 133,06 ",2964086769,CFD," 0,00 "
07/03/2025 15:50:54,Edit Stop Loss,-,"(19,61)",-," 0,00 "," 1.556,15 "," 113,45 ",2962324179,-," 0,00 "
07/03/2025 15:51:30,Open Position,NSDQ100/USD," 99,97 ",0.100159," 0,00 "," 1.556,15 "," 13,48 ",2964403674,CFD," 0,00 "
07/03/2025 16:36:56,Position closed,NSDQ100/USD," 49,95 ",0.09775,"(64,60)"," 1.491,55 "," 63,43 ",2961639905,CFD," 0,00 "
07/03/2025 16:38:41,Open Position,NSDQ100/USD," 50,00 ",0.050521," 0,00 "," 1.491,55 "," 13,43 ",2964504399,CFD," 0,00 "
07/03/2025 17:03:52,Position closed,NSDQ100/USD," 51,67 ",0.050521," 1,67 "," 1.493,22 "," 65,10 ",2964504399,CFD," 0,00 "
07/03/2025 17:04:06,Open Position,NSDQ100/USD," 50,00 ",0.050382," 0,00 "," 1.493,22 "," 15,10 ",2964568701,CFD," 0,00 "
07/03/2025 17:45:02,Position closed,NSDQ100/USD," 55,72 ",0.050382," 5,72 "," 1.498,94 "," 70,82 ",2964568701,CFD," 0,00 "
07/03/2025 17:45:31,Position closed,NSDQ100/USD," 101,01 ",0.100159," 1,04 "," 1.499,98 "," 171,83 ",2964403674,CFD," 0,00 "
07/03/2025 17:45:46,Open Position,NSDQ100/USD," 99,98 ",0.100042," 0,00 "," 1.499,98 "," 71,85 ",2964615919,CFD," 0,00 "
07/03/2025 18:04:53,Position closed,NSDQ100/USD," 102,96 ",0.100042," 2,98 "," 1.502,96 "," 174,81 ",2964615919,CFD," 0,00 "
07/03/2025 18:05:05,Open Position,NSDQ100/USD," 99,99 ",0.099884," 0,00 "," 1.502,96 "," 74,82 ",2964633591,CFD," 0,00 "
07/03/2025 18:49:23,Position closed,NSDQ100/USD," 107,95 ",0.099884," 7,96 "," 1.510,92 "," 182,77 ",2964633591,CFD," 0,00 "
07/03/2025 19:04:04,Position closed,NSDQ100/USD," 301,13 ",0.149014," 1,13 "," 1.512,05 "," 483,90 ",2963966153,CFD," 0,00 "
07/03/2025 19:05:07,Open Position,NSDQ100/USD," 99,99 ",0.09929," 0,00 "," 1.512,05 "," 383,91 ",2964676530,CFD," 0,00 "
07/03/2025 19:45:05,Position closed,NSDQ100/USD," 100,73 ",0.09929," 0,74 "," 1.512,79 "," 484,64 ",2964676530,CFD," 0,00 "
07/03/2025 23:17:11,Overnight fee,Weekend Fee,"(1,49)",-,"(1,49)"," 1.511,30 "," 483,15 ",2962324179,CFD," 0,00 "
07/03/2025 23:17:11,Overnight fee,Weekend Fee,"(1,84)",-,"(1,84)"," 1.509,46 "," 481,31 ",2961395864,CFD," 0,00 "
07/03/2025 23:17:11,Overnight fee,Weekend Fee,"(2,25)",-,"(2,25)"," 1.507,21 "," 479,06 ",2963859629,CFD," 0,00 "